Sensational - Thick Marker (User: melons)
Henry Purcell - Dido's Lament (User: melons)
Daytime TV - ugly (User: melons)
Blue October - Into the Ocean (User: melons)
Millie Manders and The Shutup - Your Story (User: melons)
The Toasters - Night Train To Moscow (User: melons)
Skinny Lister - John Kanaka (User: melons)
ZHU - Hold Up, Wait a Minute (User: melons)
ETTA MARCUS - Hide & Seek (User: melons)
Tony Matterhorn - Dutty Wine (User: melons)
Stepson - Deeper Sleep (User: melons)
Gravemind - Lifelike (User: melons)
Alpha Wolf - Akudama (User: melons)
Polaris - Hypermania (User: melons)
Polaris - Hey Sandy (User: melons)
DDG - Moonwalking in Calabasas (feat. Blueface) - Remix (User: melons)
Eli Smart - No Destination (User: melons)
Stone - Let's Dance to the Real Thing (User: melons)
Dylan - Nineteen (User: melons)
Omah Lay - Bad Influence (User: melons)
Cordae - Super (User: melons)
Sea Girls - Do You Really Wanna Know? (User: melons)
L'Rain - Fly, Die (User: melons)
Gwynn Williams - Two Celtic Lovesongs, The flower maiden (User: melons)
Ches Smith and We All Break - Woule Pou Mwen (User: melons)
Berliner Philharmoniker - Noon Witch: Andante (User: melons)
Clive Dunn - Grandad - 2003 Remaster (User: melons)
Kishi Bashi - I Am the Antichrist to You (User: melons)
Andrew Kaffer - Why (Do You Doubt Me Baby?) (User: melons)
U-Roy - Dreamland Version (User: melons)
My Baby - Uprising (User: melons)
Kikagaku Moyo - Blanket Song (User: melons)
Ron Artis II - I Sat at Home (Original Music for Vela) (User: melons)
Skinshape - Take My Time (User: melons)
Kishi Bashi - Hahaha Pt. 2 (User: melons)
Snakadaktal - Fall Underneath (User: melons)
Causa Sui - Venice By The Sea (User: melons)
Babe Rainbow - California (User: melons)
Josh Harmony - Amazing Grace (User: melons)
Bassekou Kouyate - Miri (User: melons)
Scott Hirsch - No No (Video Edit) (User: melons)
Ron Artis II - We Have All Day (Original Music for Vela) (User: melons)
Delicate Steve - Peaches (User: melons)
slenderbodies - Opal Ocean (User: melons)
Dope Lemon - Home Soon (User: melons)
A Blaze Of Feather - Grace (User: melons)
slenderbodies - Opal Ocean, Pt. 2 (User: melons)
Relaxing Spa Music Universe - Delightful Coconut Massage (User: melons)
Music for Spas Retro - Delightful Coconut Scrubs (User: melons)
Massage Tribe Ambience - Delightful Coconut Oil Massages (User: melons)
João Erbetta - Ver o Mar (feat. Leandro Lima) - Versão Barco (User: melons)
Elis Regina - Só Tinha De Ser Com Você (User: melons)
Johnny Horton - Honky Tonk Man (User: melons)
Lefty Frizzell - If You've Got the Money I've Got the Time (User: melons)
New Zealand Symphony Orchestra - Fantasia on a Theme by Thomas Tallis (User: melons)
Job Roggeveen - Uma (User: melons)
Black Cobra - One Nine (User: melons)
Goatsnake - Innocent (User: melons)
Weedeater - Wizard Fight (User: melons)
Squid - Sludge (User: melons)
J-Live - Give It Up (User: melons)
Mike D - I Know (User: melons)
Miho Hatori - Formula X (User: melons)
Duster - Inside Out (User: melons)
The Garden - Thy Mission (User: melons)
Jack Stauber's Micropop - Coffee (User: melons)
Jack Stauber - Buttercup (User: melons)
Fritz - Die Happily (User: melons)
Ludus - Sightseeing (User: melons)
The Free Design - Kites Are Fun (User: melons)
Summer Camp - Love Of My Life (User: melons)
Slapp Happy - Casablanca Moon (User: melons)
No Age - Sleeper Hold (User: melons)
The End - Dreamworld (User: melons)
The Hobbits - Strawberry Children (User: melons)
Lime Garden - Marbles (User: melons)
The Wards Of Court - How Could You Say One Thing (User: melons)
Zita Swoon - Thinking About All The Time (User: melons)
Gorodisch - B.O.F. (User: melons)
Grady Tate - And I Love Her (User: melons)
Christopher Casson - My Mother Said (User: melons)
Coffee - Casanova - Single Version (User: melons)
Marcos Valle - Nova Bossa Nova (User: melons)
Fiamma Fumana - Check in (User: melons)
Frou Frou - Let Go (User: melons)
Kid Koala - Fender Bender (User: melons)
Nick Knowles - What A Wonderful World (User: melons)
The Abyssinians - Satta - Amassa - Gana (User: melons)
Freezepop - Get Ready 2 Rokk (User: melons)
Jupiter Apple - Um Lugar do Caralho (User: melons)
23 Skidoo - Vegas El Bandito (User: melons)
Al Campbell - GEE BABY (User: melons)
Dennis Alcapone - Cassius Clay (User: melons)
I-Roy - Sidewalk Killer (User: melons)
Juliette Gréco - Un petit poisson, un petit oiseau (User: melons)
Mimi Goese - Ocean Rain (User: melons)
Archer Prewitt - Good Man (User: melons)
Shellito - The Original You (User: melons)
The Sadies - The Most Despicable Man Alive (User: melons)
Kathleen Edwards - Options Open (User: melons)
Koralle - Keep It Stepping (User: melons)
The Mouse Outfit - Got Me Thinkin' (feat. Sparkz) (User: melons)
Enny - Keisha's & Brenda's (User: melons)
Miles Davis - Violets (feat. Phonte) (User: melons)
Fatlip - Stay (User: melons)
Bluestaeb - MOVIN' (User: melons)
Jay Farrar - California Zephyr (User: melons)
Busty and the Bass - Go So Far (User: melons)
2nd Exit - It's Alright (User: melons)
Paul Grant - Connection - Remix (User: melons)
Jazz Liberatorz - Ease My Mind - Feat. Tre Hardson, Fat Lip & Omni (User: melons)
Retrospective for Love - Let Me Know (User: melons)
flatpocket - One from the Tap (User: melons)
Juggaknots - Loosifa (User: melons)
Ivan Ave - Running Shoes (User: melons)
Sportique - Just friends (User: melons)
The Silhouettes Project - Eucalyptus (User: melons)
Ol' Burger Beats - Athens (User: melons)
Athletic Progression - Stepney Tale (User: melons)
Ivan Ave - Phone Won't Charge (User: melons)
Daedelus - Fair Weather Friends (User: melons)
Common Saints - Dreams (User: melons)
Noriel Vilela - 16 Toneladas (User: melons)
Bei Ru - Dream Blvd (User: melons)
Cyne - Elephant Rome (User: melons)
Reflection Eternal - Memories Live (User: melons)
Robert Glasper - Black Superhero [Feat. Killer Mike, BJ The Chicago Kid & Big K.R.I.T.] (User: melons)
Mick Jenkins - Scottie Pippen (User: melons)
Nujabes - Blessing It -remix (feat. Substantial & Pase Rock from Five Deez) (User: melons)
Dabrye - First Law of Nature Rock Day (feat. Denmark Vessey) (User: melons)
Jazz Spastiks - Super Fly Funk (User: melons)
Tom Misch - It Runs Through Me (User: melons)
Kassa Overall - Who's on the Playlist (User: melons)
Nujabes - Luv(sic.) Pt3 (feat. Shing02) (User: melons)
Myka 9 - Park Bench People - Alternate Version (User: melons)
Damu The Fudgemunk - Tulips (User: melons)
Hem - Half Acre (User: melons)
Graham Lindsey - No Way Out but Down (Alternate Version) (User: melons)
Handsome Boy Modeling School - The Truth (User: melons)
The Handsome Family - Far From Any Road (User: melons)
Candeia - Sou Mais O Samba (User: melons)
kosmonaut - Was It You? (User: melons)
LoveJoy - You Fell From Grace (User: melons)
The Pines - Leavin' On Your Mind (User: melons)
The Liberty Ship - Don't React (User: melons)
The Windmills - Walking Around the World (User: melons)
Melodie Group - I Do Not Not Love You (User: melons)
Slipslide - X Supplies the Answer (User: melons)
Airport Girl - When You Fall (User: melons)
Would-Be-Goods - Dilettante (User: melons)
Harper Lee - Fine Bones (User: melons)
South Ambulance - Die 5Times Times5 (User: melons)
Os Originais Do Samba - Tenha Fé, Pois Amanhã um Lindo Dia Vai Nascer (User: melons)
Belters Only - Make Me Feel Good (User: melons)
Mexicano 777 - Interlude (User: melons)
Bongwater - Chicken Pussy (User: melons)
Freakwater - My Old Drunk Friend (User: melons)
The Dust Brothers - This Is Your Life (feat. Tyler Durden) (User: melons)
Cowboy Junkies - Sweet Jane (User: melons)
John Jackson - The Devil He Wore a Hickory Shoe (User: melons)
Richard Buckner - Ariel Ramirez (User: melons)
Son Volt - Windfall - 2015 Remaster (User: melons)
Winifred Atwell - Black and White Rag (User: melons)
Jack Trombey - Underlay No.3 (User: melons)
Chris Morris - Push Off My Wire (User: melons)
The Golden Gate Quartet - God Almighty's Gonna Cut You Down (User: melons)
Edgar Broughton Band - Evening over Rooftops - 2004 Remaster (User: melons)
Second Hand - The World Will End Yesterday (User: melons)
Serendipity - I’m Flying (User: melons)
Mike Stuart Span - Children of Tomorrow (User: melons)
Mashmakhan - Days When We Are Free (User: melons)
Sharon Tandy - Daughter of the Moon (User: melons)
Dantalian's Chariot - The Madman Running Through the Fields (User: melons)
Jason Crest - A Place In The Sun (User: melons)
Norman Conquest - Upside Down (User: melons)
Methusalah - High In The Tower Of Coombe (User: melons)
Jigsaw - Tumblin’ (User: melons)
Rick Price - Lamp Lighter Man (User: melons)
Jason Crest - Here We Go ’Round The Lemon Tree (User: melons)
Eyes of Blue - Prodigal Son (User: melons)
Sharon Tandy - Hold On (User: melons)
Pipas - Cruel and Unusual (User: melons)
Bo Carter - All Around Man (User: melons)
Free Loan Investments - Kick His Balls Out (User: melons)
South Ambulance - Hangin In a Tie (User: melons)
South Ambulance - Hangin In a Tie (User: melons)
Les Big Byrd - Two Man Gang (User: melons)
Rouse the Boroughs - Towed Aurora (User: melons)
Rouse the Boroughs - Towed Aurora (User: melons)
Rickie Lee Jones - Woody and Dutch on the Slow Train to Peking (User: melons)
Manic Street Preachers - Life Becoming a Landslide (User: melons)
Evan Johns And The H-Bombs - Rollin' Through The Night (User: melons)
Camp Lo - Black Connection 3 (User: melons)
Anrial Skerry - Alice Molyngton (User: melons)
Сергей Курёхин - Колосок-голосок (User: melons)
Sergey Kurochkin - Украла (User: melons)
Alice Phoebe Lou - Me & the Moon (User: melons)
Love and Money - Halleluiah Man (User: melons)
Milla's Mirakel! - Rytmen av ett regn (User: melons)
Paul Rein - Lady-O (User: melons)
Lili & Susie - Oh Mama (User: melons)
Dead Scouts - Johnny Remember Me (User: melons)
Little Mike & The Sweet Soul Music Band - Sweet Soul Music (User: melons)
X-Models - Två av oss (User: melons)
Alice Phoebe Lou - Silly (User: melons)
The The - Love Is Stronger Than Death (User: melons)
Pugh Rogefeldt - Små lätta moln (User: melons)
Björn Skifs - Åsa Bodén (User: melons)
Lalla Hansson - Sin egen väg (User: melons)
Extra - Fri? (User: melons)
The Legends - Up! (User: melons)
Lasse Lindbom Band - Så nära nu (feat. Marie Fredriksson) (User: melons)
Liza Öhman - Hit men inte längre (User: melons)
Cymbals - Winter '98 (User: melons)
Visitors - All Of Your Attention (User: melons)
Cymbals - Highway Star, Speed Star (User: melons)
Cymbals Eat Guitars - Warning (User: melons)
Paris Match - Never Stop - Stalker Studio's Sunny House Treatment (User: melons)
Paris Match - Deep Inside (User: melons)
クレイジーケンバンド - あ、やるときゃやらなきゃだめなのよ。 (User: melons)
TOKYO No.1 SOUL SET - 止んだ雨のあと - 原田郁子 on vocal (User: melons)
clammbon - Fluttering (User: melons)
HALCALI - タンデム (User: melons)
m-flo loves Sik-K & eill & 向井太一 - tell me tell me (User: melons)
Barde - Julia Delaney (User: melons)
Organized Konfusion - Stress (User: melons)
Cory McAbee - I Was Once Like You (User: melons)
Dilettante - Single Serve (User: melons)
Blue System - Carry Me Oh Carrie (User: melons)
The Heights - Help Is On It's Way (User: melons)
SkandaU - Но! (User: melons)
Mastah Peabody - Араб (User: melons)
Polumyagkiye - Бригада Кругляшонка (User: melons)
Polumyagkiye - шипящая кобра (User: melons)
Lucidvox - Burn the Grief (User: melons)
badwill - We Are Who We Are (User: melons)
Pelicat - Ava (User: melons)
Gavin Bryars - Jesus' Blood Never Failed Me Yet: 5. Tramp and Tom Waits with full Orchestra (User: melons)
The Blue Nile - Let's Go Out Tonight (User: melons)
Craig Armstrong - Let's Go Out Tonight (User: melons)
Nick Shoulders - Snakes and Waterfalls (User: melons)
The Love Tones - A Witch for Love: I Dream of Jeannie - Love Theme Ringtone (User: melons)
Anders Glenmark - Kall Som Is (User: melons)
Git Persson - Du Förför Mig (User: melons)
Pernilla Wahlgren - Svindlande affärer (User: melons)
Perikles - Var ska vi sova i natt? (User: melons)
Paul Buchanan - After Dark (User: melons)
Clabbe - An Evening In Paris (Deca-Dancing) (User: melons)
Adolphson & Falk - Cinema (User: melons)
The Wrens - Napiers (User: melons)
Foster Sylvers - Misdemeanor (User: melons)
Asha Puthli - Space Talk (User: melons)
Side Effect - Always There - Special 12" Disco Mix (User: melons)
Latimore - Let Me Go (User: melons)
Parov Stelar - Keine Melodien...1,2,3,4,5 (User: melons)
Fat Digester - Funky Paella (User: melons)
2raumwohnung - 36grad (User: melons)
Unarmed Enemies - missing out (User: melons)
Acid House Kings - This Heart Is a Stone (User: melons)
Stereo Action Unlimited - Hi-Fi Trumpet (User: melons)
Orchid Mantis - the sky is empty (User: melons)
Justinas Jarutis - Tavęs (User: melons)
Bearsuit - Hey Charlie Hey Chuck (User: melons)
San E - FIESTA (User: melons)
Cosmic Girl - LIE YA (feat. Solar) (User: melons)
BE'O - COUNTING STARS (User: melons)
Crazy Ex-Girlfriend Cast - Let's Generalize About Men (feat. Rachel Bloom, Donna Lynne Champlin, Vella Lovell & Gabrielle Ruiz) (User: melons)
San E - Daydreaming (User: melons)
Girlfriend - sky & blue (User: melons)
Nation of Language - Gouge Away (User: melons)
Girlfriends - California (User: melons)
Girlfrend စ - Loverစ (Bonus) (User: melons)
Girlfriends - Patrick Ewing (User: melons)
Martin Denny - The Enchanted Sea (User: melons)
Buffalo Daughter - Socks, Drugs and Rock 'n' Roll (User: melons)
Duquende - Lo Bueno Y Lo Malo (User: melons)
MONDO GROSSO - ラビリンス (User: melons)
RIP SLYME - 楽園ベイベー (User: melons)
Syd Dale - Perfume from Panama (User: melons)
Cymbals - Higher than the Sun〔FPM contact MIX〕 (User: melons)
Alain Goraguer - Déshominisation (II) (User: melons)
The Presidents of the United States of America - Peaches (User: melons)
EMKR - Marina (User: melons)
Nadege - Syrah (User: melons)
vintage mika - Buddha Brand (User: melons)
Deaf by Hip-Hop - Buddha Brand (User: melons)
2 In A Room - Wiggle It - Radio Version (User: melons)
Chris Barber - O’reilly (User: melons)
Kinski - XXXVI (User: melons)
Love Tones - XXXV (User: melons)
The Braxtons - Only Love (User: melons)
The Green Pajamas - Katie Lied (User: melons)
Christian Kiefer - XXXIII (User: melons)
The Green Pajamas - XXXI (User: melons)
Tenebrous Liar - XXX (User: melons)
Sphyr - XXVIII (User: melons)
Mountain Men Anonymous - XXIX (User: melons)
Sphyr - XXVIII (User: melons)
Gerry Mitchell - Xxvi (User: melons)
Gerry Mitchell - Xxvi (User: melons)
Sweet Trip - XXV (User: melons)
Puerto Muerto - XXII (User: melons)
The Great Depression - XXI (User: melons)
Lori Scacco - XX (User: melons)
The Minus 5 - XIX (User: melons)
Coldharbourstores - XVIII (User: melons)
Abigail Hopkins - XVII (User: melons)
Ian Kearey - XVI (User: melons)
Noah John - XV (User: melons)
Mary Lorson - XIII (User: melons)
Text of Light - XII (User: melons)
Airport Studies - XI (User: melons)
Owen Tromans - X (User: melons)
Califone - VIII (User: melons)
Venture Lift - V (User: melons)
HTRK - VII (User: melons)
Venture Lift - V (User: melons)
Jessica Bailiff - IV (User: melons)
War Against Sleep - II (User: melons)
Monica Queen - I (User: melons)
Push - Universal Nation - Radio Edit (User: melons)
Puressence - This Feeling (User: melons)
Zound - Stealth Vision (User: melons)
Evergreen - Gemini (User: melons)
Magic Affair - Omen III - single edit (User: melons)
Bram Tchaikovsky - Let's Dance (User: melons)
Buffalo Springfield - For What It's Worth (User: melons)
Orleans - Still the One (User: melons)
J.D. Souther - How Long (User: melons)
Joe Fagin - That's Livin' Alright (User: melons)
The French Revolution - The Light From Fantasia (User: melons)
+1 - Nevermore (User: melons)
Brownsville Station - Smokin' in the Boy's Room (User: melons)
Carlene Carter - Every Little Thing (User: melons)
Lobo - I'd Love You to Want Me (User: melons)
Zac Brown Band - Toes (User: melons)
The Vogues - God Only Knows (User: melons)
River City People - Carry The Blame (User: melons)
The Crying Violets - Broken Dreams Club (User: melons)
His Name Is Alive - Lip (User: melons)
The Arrogants - No Time To Wait (User: melons)
The Arrogant Sons of Bitches - The Last Bell I Will Ever Hear (User: melons)
The Wrens - Propane (User: melons)
Ted Leo and the Pharmacists - Me and Mia (User: melons)
The Long Winters - Cinnamon (User: melons)
Tages - Sleep Little Girl (User: melons)
The Embassy - It pays to belong (User: melons)
Club 8 - Everlasting Love (User: melons)
Karen Peris - Lakes Of Canada (User: melons)
Professor Pez - Born Again (User: melons)
The Count Five - Psychotic Reaction - Rarities Version (User: melons)
Keith Barrow - You Know You Want To Be Loved (User: melons)
Leon Ware - Why I Came to California (User: melons)
Zulema - Wanna Be Where You Are (User: melons)
The New Birth - What'll I Do (User: melons)
Buddy Miles - Them Changes (User: melons)
The Friends of Distinction - Grazing In The Grass (User: melons)
Breakwater - Release the Beast (User: melons)
Aventuras De Kirlian - Un día gris (User: melons)
Stereo Total - Lunatique (User: melons)
bob hund - Tralala lilla molntuss, kom hit ska du få en Puss (User: melons)
Das Bierbeben - wenn deutschlands mauern fallen (User: melons)
Rykarda Parasol - Hannah Leah (User: melons)
April March - Garçon Glaçon (User: melons)
Annie - Heartbeat (User: melons)
Virgin Passages - VI (User: melons)
Bebe - Ella (User: melons)
Le Mans - Un Rayo De Sol (User: melons)
The Chemistry Set - This Day Will Never Happen Again (User: melons)
Chara - やさしい気持ち (User: melons)
Stars - Your Ex-Lover Is Dead (User: melons)
Olli Schulz - Wenn es gut ist (User: melons)
Olli Schulz - Dann schlägt Dein Herz (User: melons)
Comet Gain - A Million and Nine (User: melons)
Tahiti 80 - Heartbeat (User: melons)
Maxwell Implosion - Follow My Riddim (Ben Human Mix) (User: melons)
His Name Is Alive - Are We Still Married? (User: melons)
Sam Prekop - A Cloud to the Back (User: melons)
Monade - Étoile (User: melons)
Egg - Fugue in D minor - arr. Egg (User: melons)
Eggstone - Wrong Heaven (User: melons)
Eggstone - Birds In Cages (User: melons)
Yuksek - Icare (User: melons)
Willy Michl - Kapitel 12.3 - Isarflimmern (User: melons)
The Atomics - I Wanna Be Your Boy (User: melons)
Rara Avis - Footsteps (User: melons)
Mellow Candle - Silver Song (User: melons)
The Aislers Set - Friends Of The Heroes (User: melons)
Bis - Love Will Tear Us Apart (User: melons)
Frida Hyvönen - Terribly Dark (User: melons)
Uncle Tupelo - New Madrid (User: melons)
Hot Liquid Sex - My Vanity (User: melons)
Vanity - Can't Be Bothered (User: melons)
Vanity - Call Me (User: melons)
Moving Pictures - What About Me? (User: melons)
The Atomics - I Wanna Be Your Boy (User: melons)
The Atomics - Let's Live For Today (User: melons)
Cinerama - Lollobrigida (User: melons)
Pop Legends - A Billion Girls (User: melons)
Archie Bell & The Drells - Tighten Up, Pt. 1 (User: melons)
Frantique - Strut Your Funky Stuff - Single Version (User: melons)
Slift - Ummon (User: melons)
Faye Webster - In a Good Way (User: melons)
Elias - volcano (User: melons)
Luna Moor - Time to Dance - Damien N-Drix Remix (User: melons)
Midnight Beats - Inferno - The Riberaz Remix (User: melons)
Eyedentity - Dutchism (User: melons)
Lemon3 - Burp - SL Curtiz Remix (User: melons)
Quadro - Water Wall (User: melons)
Haxent - Explicit - Vocal Mix (User: melons)
NekliFF - True Way (User: melons)
Sebjak - Analog Stockholm (User: melons)
Frankox - Mygeeto (User: melons)
SL Curtiz - Party People 303 - A.C.N. & Double Amp Remix (User: melons)
Esquire - The Knife - Luke Tolosan Heavy Remix (User: melons)
Simon Sparks - Forty Seven (User: melons)
Masquerade - Massive - Norse Version (User: melons)
O.B - Token (User: melons)
Deniz Koyu - Hydra (User: melons)
A.C.N. - Reboot (User: melons)
Futuristic Polar Bears - Jetlag (User: melons)
John Ross - Bon Bon (User: melons)
Goodness - Superwise (User: melons)
The Sound - I Can't Escape Myself (User: melons)
Marie et les garçons - Rien à dire - Remastered (User: melons)
The Monks - I Ain't Gettin' Any (User: melons)
Blitz - Telecommunication (User: melons)
Teenage Cool Kids - Zealous Convert (User: melons)
Operator Music Band - Zed Logic (User: melons)
Wire - French Film Blurred - 2006 Remastered Version (User: melons)
The Proper Ornaments - Music of the Traffic (User: melons)
Protomartyr - Processed By The Boys (User: melons)
Surf Curse - Fire Walk With Me (User: melons)
Crack Cloud - Graph Of Desire (User: melons)
Institute - Exhibitionism (User: melons)
Country Teasers - Golden Apples (User: melons)
Deluxx Folk Implosion - I'm Just a Bill (User: melons)
Bill Miller - Every Mountain I Climb (User: melons)
Kinky Friedman - Sold American (User: melons)
Peter Case - Cold Trail Blues (User: melons)
Albert Lee - Til I Gain Control Again (User: melons)
Guy Clark - Fort Worth Blues (User: melons)
Rodney Crowell - Highway 17 (User: melons)
Tim O'Brien - Orphan Girl (User: melons)
Ramblin' Jack Elliott - 1913 Massacre (User: melons)
James McMurtry - No More Buffalo (User: melons)
Paul Kelly and The Stormwather Boys - Ghost Town (User: melons)
Alex Heffes - 1999 (User: melons)
David Bowie - Time - 2013 Remaster (User: melons)
David Bowie - Boss of Me (User: melons)
David Bowie - Ziggy Stardust - Live (User: melons)
David Bowie - Loving The Alien - Live (User: melons)
David Bowie - All the Madmen - 2015 Remaster (User: melons)
Hefner - Mary Lee (User: melons)
The Free Design - Bubbles (User: melons)
Jeff Simmons - Lucille Has Messed My Mind Up (User: melons)
The Tornados - Telstar (User: melons)
The Rentals - Friends of P. (User: melons)
Duncan Browne - Journey - 2002 Remaster (User: melons)
Sister Rosetta Tharpe - Didn't It Rain (User: melons)
Self - What a Fool Believes (User: melons)
Meatraffle - 'Ndrangheta Allotment (User: melons)
Meatraffle - 'Ndrangheta Allotment (User: melons)
Neon Neon - Dream Cars (User: melons)
JP Goulag - Let Me Know Now (User: melons)
Die Sterne - Universal Tellerwäscher (User: melons)
Komeda - It's Alright, Baby (User: melons)
Magnet - Corn Rigs (User: melons)
Magnet - Corn Rigs (User: melons)
Ella Fitzgerald - Two Little Men In A Flying Saucer - Single Version (User: melons)
Taj Mahal - Tomorrow May Not Be Your Day - 1970 Version (User: melons)
Perrey & Kingsley - The Unidentified Flying Object (User: melons)
The Tammys - Egyptian Shumba (User: melons)
Die Lassie Singers - Hamburg (User: melons)
Von Südenfed - The Rhinohead (User: melons)
Soul Coughing - Screenwriters Blues (User: melons)
I Am Kloot - To You - Remastered (User: melons)
The Bob Crewe Generation Orchestra - Barbarella (User: melons)
The Dream Syndicate - Tell Me When It's Over (User: melons)
Peter Gordon & Love of Life Orchestra - Beginning Of The Heartbreak / Don't Don't (User: melons)
Jane Weaver - Heartlow (User: melons)
Life - Friends Without Names (User: melons)
Ohtis - Schatze (User: melons)
Scott Walker - Jackie (User: melons)
Stumps - I've Had Enough (User: melons)
Freddie King - Stumble (User: melons)
R.E.M. - Can't Get There From Here (User: melons)
Andy Gibb - I Just Want to Be Your Everything (User: melons)
Goblin Cock - Stumped (User: melons)
Suzi Quatro - Stumblin' In (User: melons)
John Lennon - Woman - Remastered 2010 (User: melons)
J.C. Satàn - No Brain No Shame (User: melons)
Wild Fox - Numb Legs (User: melons)
HOORSEES - Week-end At Bernie's (User: melons)
The Lemonheads - Hey, That's No Way To Say Goodbye (User: melons)
JP Goulag - Let Me Know Now (User: melons)
Johnny Mafia - Trevor Philippe (User: melons)
Baston - Primates (User: melons)
Cathedrale - Gold Rush (User: melons)
Peter Kernel - Men Of The Women (User: melons)
The Everly Brothers - Cathy's Clown (User: melons)
Placebo - Nancy Boy (User: melons)
Total Victory - What The Body Wants, The Body Gets (User: melons)
Susan Boyle - Mad World (User: melons)
Céline Dion - Incognito (User: melons)
Pandora's Box - It's All Coming Back To Me Now - Edit (User: melons)
Meph luciano - You're Late... (User: melons)
Takafumi Oshiro - You're late (User: melons)
Ja Rule - Always On Time (User: melons)
All Saints - Never Ever (User: melons)
The Beatles - Do You Want To Know A Secret - Remastered 2009 (User: melons)
Failure - Saturday Saviour (User: melons)
Coda - golden times (User: melons)
GoGo Penguin - Hopopono (User: melons)
Coda - golden times (User: melons)
Mick Softley - I'm So Confused (User: melons)
Hurts - Blood, Tears & Gold (User: melons)
Handsome Furs - I'm Confused (User: melons)
Bill Wurtz - i'm confused (User: melons)
Pesukone - Pineapple Days (User: melons)
Frost* - Island Life (User: melons)
Alvin Robinson - I'm Just a Down Home Girl (User: melons)
The Grifters - She Blows Blasts of Static (User: melons)
Negu Gorriak - Radio Rahim (User: melons)
Negu Gorriak - Sexu Makina (User: melons)
Little Richard - The Commandments Of Love (User: melons)
Big Business - Grounds for Divorce (User: melons)
My Life Story - 12 Reasons Why I Love Her (User: melons)
Kanda Bongo Man - Monie (User: melons)
Loopy - Starting Out (User: melons)
Bibio - Lovers’ Carvings (User: melons)
Gus Harrower - Wonder (User: melons)
Jedi Mind Tricks - Design in Malice (User: melons)
Herb Alpert & The Tijuana Brass - Tijuana Taxi (User: melons)
Lifesigns - Impossible (Single Version) (User: melons)
Thes One - Brincidofovir (User: melons)
Lane 8 - Automatic (User: melons)
The Mutton Birds - Anchor Me (User: melons)
January Fire - Funeral in Frost (User: melons)
Kungs - This Girl (Kungs Vs. Cookin' On 3 Burners) (User: melons)
Ports - The Devil Is a Songbird (User: melons)
Total Victory - playing golf with the precariat (User: melons)
To Brave My Soul - Sally (User: melons)
Ale Otranto - Día Gris (User: melons)
Looking Glass - Brandy (You're A Fine Girl) (User: melons)
Lexsoul Dancemachine - Beef Grinder (User: melons)
deathcrash - Matt's Song (User: melons)
Bumps Myers Sextet - Memphis Hop (User: melons)
Paul Bascomb and His Orchestra - Ain't Nothin' Shakin' (User: melons)
Morris Lane And His Combo - Turntable (User: melons)
Charlie Singleton And His Band - SOS (User: melons)
Leo Parker And His Mad Lads - Cool Leo (User: melons)
JOE HOUSTON ORCHESTRA - Have A Ball (User: melons)
Felly - Another Beautiful Day (User: melons)
Awon - Problem Solver (feat. Adad) (User: melons)
3582 - Vanessa From Venezuela (User: melons)
Cultivo - Telltale (User: melons)
3582 - Vanessa From Venezuela (User: melons)
RJD2 - See you leave (User: melons)
James Lewis - Down 75 (Intermission) [feat. Juran Ratchford] (User: melons)
RJD2 - See you leave (User: melons)
Peebs The Prophet - Dead Calm (User: melons)
2nd Exit - If You Wouldn't Mind (User: melons)
King Geedorah - Next Levels (User: melons)
Darrell Cole - BOATS. - Based On A True Story (User: melons)
Exact Change Project - Keep It Jazzy (User: melons)
Phony Ppl - Why iii Love The Moon. (User: melons)
Anti Lilly & Phoniks - Blue In Green (User: melons)
Tom Misch - Beautiful Escape (User: melons)
The Globetroddas - Love (User: melons)
Dafuniks - All I Want (User: melons)
Pleasure - I'm confused (User: melons)
Prume - Non Planned Holiday (User: melons)
Rejjie Snow - Purple Tuesday (feat. Joey Bada$$ & Jesse Boykins III) (User: melons)
FKJ - We Ain't Feeling Time (User: melons)
MANWOLVES - These Days (User: melons)
Ehnsn - Life's Good (User: melons)
Ehnsn - Life's Good (User: melons)
Coops - That Jazz (User: melons)
Abstract Orchestra - New Day (User: melons)
J. Cole - Change (User: melons)
The Mouse Outfit - Got Me Thinkin' (feat. Sparkz) (User: melons)
Saba - Photosynthesis (User: melons)
Guru - Plenty (User: melons)
Seth Sentry - The Waitress Song (User: melons)
Marcus D - Elevator (User: melons)
Dizzy Wright - Wanna Remind You (User: melons)
J. Cole - Wet Dreamz (User: melons)
Animate Objects - Slow (User: melons)
Anti Lilly - Nobody's Perfect (User: melons)
GRANATA - You Dont Need Me (User: melons)
Gabri V - Opinions (User: melons)
The Mouse Outfit - No Stoppin This (feat. Sparkz & Truthos Mufasa) (User: melons)
Atmosphere - Yesterday (User: melons)
One Self - Bluebird (User: melons)
Trinix - Atomz (User: melons)
Felly - Fabrics (User: melons)
Coops - Odyssey (User: melons)
Caleb Belkin - I Fall in Love Too Easliy (User: melons)
Mickey Cho - Thoughts (feat. Sam Ock & J. Han) (User: melons)
Academics - Laid Back (User: melons)
Soulchef - Write This Down (User: melons)
Funky DL - Ode to Nujabes (User: melons)
Chet Faker - Talk Is Cheap (User: melons)
Summers Sons - Call It Love (User: melons)
Gas Lab - Blue (feat. Benaddict & Marcelo Gallo) (User: melons)
Masego - Tadow (User: melons)
Jalen Santoy - Foreplay (User: melons)
Karmacoda - Feels (Extrawelt Remix) (User: melons)
Costanza - I've Been Waiting for You (User: melons)
It's Immaterial - Driving Away from Home (Jim's Tune) (User: melons)
Matt Corby - Winter (User: melons)
Kim Fowley - The Trip (User: melons)
United Future Organization - Loud Minority - Radio Mix (User: melons)
Flunk - Petrified (User: melons)
Waldeck - Memories (User: melons)
Arca - Tiro (User: melons)
Oneohtrix Point Never - The Pure and the Damned (User: melons)
Hooverphonic - Eden (User: melons)
lo fi hip hop - Sad Saxophone Hip Hop (User: melons)
Palehound - If You Met Her (User: melons)
Costanza - Ritmo Latino - Ritmo Premier Club Mix (User: melons)
Tim Be Told - Me to You (User: melons)
Saul Williams - Break (User: melons)
The Mad Conductor - Yo, Kid! (User: melons)
Venetian Snares - Öngyilkos vasárnap (User: melons)
Aceyalone - The Hunt (User: melons)
Flobots - Jetpack (User: melons)
Quakers - Russia With Love (User: melons)
Dan Bull - Prelude (User: melons)
Nirvana - About a Girl (User: melons)
Mew - Then I Run (User: melons)
Mew - City Voices (User: melons)
Jonathan Jeremiah - Happiness (User: melons)
Clara Klingenström - Behöver inte dig idag (User: melons)
Mad Professor - Fast Forward Into Dub (User: melons)
Steve Lehman - Geminou (User: melons)
Ben Harper - Forever (User: melons)
David Bowie - Can You Hear Me - 2016 Remaster (User: melons)
Yungchen Lhamo - Happiness is… (User: melons)
Gone Gone Beyond - Coast (User: melons)
Ukandanz - Endè Iyèrusalem (User: melons)
Patrick Droney - Wrecking Ball (User: melons)
Mitski - Fireworks (User: melons)
Bruno Pernadas - Lachrymose (User: melons)
Rattle - Thunder (User: melons)
Moth Equals - The Heavens Opened and Closed (User: melons)
Falling - Said Alright (User: melons)
Market - Horsemeat (User: melons)
Joana Gomila - Ses transformacions (User: melons)
Ghoula - Ba77it (User: melons)
Ukandanz - Lantchi Biyé (User: melons)
Frankie Cosmos - Fool (User: melons)
Rattle - Boom (User: melons)
Chris & Cosey - FutureShock (User: melons)
Coil - The Snow (User: melons)
Katalyst - Clapping Song (User: melons)
maretu - Brain Revolution Girl 2016 Ver. (User: melons)
Roo Panes - I Just Love You (User: melons)
The Blinders - Orbit (Salmon Of Alaska) (User: melons)
Arzner - Finn & the Salmon of Doubt (User: melons)
The Blinders - Orbit (Salmon Of Alaska) (User: melons)
Gilla Band - Going Norway (User: melons)
Ghost Hunter - In the Early Months of the Emergency (User: melons)
Christian Padovan - Fitness Club (User: melons)
Ten Benson - I Don't Buy It (User: melons)
Future of the Left - Manchasm (User: melons)
mclusky - Lightsabre Cocksucking Blues (User: melons)
Four Thing - 1:33 (User: melons)
Marissa Nadler - Seabird (User: melons)
Wheelchair Sports Camp - YESS i'm a MESS (User: melons)
Johnnie Frierson - Have You Been Good To Yourself (User: melons)
Patricia Kelly - Doll (User: melons)
Depeche Mode - Blue Dress (User: melons)
youngster jiji - 1-800-273-TALK (8225) (User: melons)
JoJo - Too Little Too Late (User: melons)
Jeje - Yawa (User: melons)
Jaja - Chan Chara (User: melons)
Juju - WYS (User: melons)
Jiji - memories (User: melons)
Joji - Worldstar Money (Interlude) (User: melons)
Jeff Rosenstock - Nausea (User: melons)
Mike Cooper - A Chart of the Wet Blue Yonder (User: melons)
Market - Told (User: melons)
Noname - Self (User: melons)
Oval - id (User: melons)
Kevin Abstract - Peach (User: melons)
Jon Batiste - FREEDOM (User: melons)
FOG - A Word of Advice (User: melons)
Steve Lehman - Akap (User: melons)
The Tuts - Tut Tut Tut (User: melons)
Street Sects - Copper in the Slots (User: melons)
Martin Creed - I'm Going to Do Something Soon (User: melons)
Dimitri Vangelis & Wyman - Lighters (User: melons)
Nick Cave & the Bad Seeds - Rings of Saturn (User: melons)
Cecilia Gault - Hanasuto (User: melons)
Law Holt - Best of the Year (User: melons)
Pixvae - Mi Sombrerito (User: melons)
Ukandanz - Datsun Sèfèr (User: melons)
eMMplekz - Britain's Got Talon (User: melons)
Falling - Pleasant Street Bossa (User: melons)
Surface To Air Missive - My Stratocaster (User: melons)
Doomsday Student - The First Trip (User: melons)
Karima Walker - Waking the Dreaming Body (User: melons)
Mal Devisa - Fire (User: melons)
Car Seat Headrest - 1937 State Park (User: melons)
Rocks & Waves Song Circle - IV (User: melons)
The Sooper Swag Project - BADD TIME INC. (User: melons)
Drose - the unraveling (User: melons)
San Cha - Prettiest Thing (User: melons)
FOONYAP - Woolf and Plath (User: melons)
Kojey Radical - Payback (feat. Knucks) (User: melons)
Marcos Balter - Meltdown Upshot: No. 4, True/False (User: melons)
Beyoncé - Forward (feat. James Blake) (User: melons)
Anarchist Republic of Bzzz - Yguduh (User: melons)
Metá Metá - Angouleme (User: melons)
David Bowie - Kooks - 2015 Remaster (User: melons)
Flash and the Pan - Down Among the Dead Men (User: melons)
Zeal & Ardor - Devil Is Fine (User: melons)
Laura Mvula - Who I Am (User: melons)
Bologna Violenta - Mi fai schifo (User: melons)
Atrocity Exhibition - A Ray of Darkness (User: melons)
Crying - Origin (User: melons)
Luka Productions - Falaw (User: melons)
katie dey - Only to Trip and Fall Down Again (User: melons)
Public Speaking - Caress, Redact (User: melons)
Death Grips - Houdini (User: melons)
Baltic House Orchestra - Blue Monday (From the 'Wonder Woman 1984' Trailer) (User: melons)
Katie Kim - The Feast (User: melons)
David Bowie - Letter To Hermione - 2019 Mix (User: melons)
David Bowie - Absolute Beginners - 2002 Remaster (User: melons)
David Bowie - Holy Holy - 2020 Mix (User: melons)
David Bowie - Don't Bring Me Down - 2015 Remaster (User: melons)
Big L - Put It On (User: melons)
Midfield General - Devil in Sports Casual (User: melons)
Frijid Pink - House Of The Rising Sun (User: melons)
Jessi Colter - Psalm 150 Praise Ye The Lord (User: melons)
The Beatles - From Me To You - Mono Version / Remastered 2009 (User: melons)
The Beatles - Do You Want To Know A Secret - Remastered 2009 (User: melons)
The Beatles - It's Only Love - Remastered 2009 (User: melons)
The Beatles - I'm Happy Just To Dance With You - Remastered 2009 (User: melons)
The Beatles - From Me To You - Mono / Remastered (User: melons)
The Beatles - There's A Place - Remastered 2009 (User: melons)
The Beatles - Misery - Remastered 2009 (User: melons)
The Beatles - I'll Follow The Sun - Remastered 2009 (User: melons)
The Beatles - Little Child - Remastered 2009 (User: melons)
The Beatles - I'll Cry Instead - Remastered 2009 (User: melons)
The Beatles - I Will - Remastered 2009 (User: melons)
The Beatles - Why Don't We Do It in the Road? - Remastered 2009 (User: melons)
The Beatles - Carry That Weight - Remastered 2009 (User: melons)
The Beatles - Golden Slumbers - Remastered 2009 (User: melons)
The Beatles - Sgt. Pepper's Lonely Hearts Club Band - Reprise / Remastered 2009 (User: melons)
The Beatles - Polythene Pam - Remastered 2009 (User: melons)
The Beatles - Mean Mr Mustard - Remastered 2009 (User: melons)
The Beatles - Wild Honey Pie - Remastered 2009 (User: melons)
The Beatles - Dig It - Remastered 2009 (User: melons)
The Beatles - Maggie Mae - Remastered 2009 (User: melons)
The Beatles - You Never Give Me Your Money - Remastered 2009 (User: melons)
Radiohead - Karma Police (User: melons)
My Tiger My Timing - I am The Sound (User: melons)
Crystal Fighters - I Love London (User: melons)
Nottee - Control (User: melons)
Jolie Chérie - Star (User: melons)
Pleasure - NYCSC (User: melons)
Pleasure - Finest Thing (User: melons)
Pleasure - Eskimo Kiss (User: melons)
Pleasure - Silk Dream (User: melons)
Pleasure - Bite The Beat (User: melons)
Pleasure - Uptown (User: melons)
Pleasure - Back To You (User: melons)
Pleasure - Throw It All Away (User: melons)
Pleasure - Out Of Love (User: melons)
Pleasure - Alright all nite (User: melons)
Rihanna - Love on the Brain (User: melons)
Lake Minnetonka - Philly Cheese String (User: melons)
Pleasure - The visionary (User: melons)
Pleasure - I'm confused (User: melons)
Maximum Balloon - Tiger (User: melons)
Amwe - Friction Between The Lovers (User: melons)
Beni - Maximus (Harvard Bass remix) (User: melons)
Slagsmålsklubben - Brutal Weapons (User: melons)
Logo - Junocide (User: melons)
Heartsrevolution - Dance Till Dawn (User: melons)
Midnight Juggernauts - This New Technology (User: melons)
Le Corps Mince de Françoise - Something Golden (User: melons)
Siriusmo - High Together (User: melons)
Cool - 아로하 (User: melons)
French Horn Rebellion - Up All Night (User: melons)
Stockard Channing - Look At Me I'm Sandra Dee - From “Grease” (User: melons)
The Telescopes - High on Fire (User: melons)
The Telescopes - Splashdown (User: melons)
Slant 6 - Don't You Ever (User: melons)
Versus - Circle (User: melons)
Drugstore Oscillations - Oil-Seed Rape (User: melons)
The Telescopes - Oil Seed Rape (User: melons)
Terminal Cheesecake - Birds In 6/8 (User: melons)
Heroin - Head Cold (User: melons)
Elias - volcano (User: melons)
Slant 6 - What Kind of Monster Are You? (User: melons)
Versus - Blade Of Grass (User: melons)
Nikki McClure - Omnivore (User: melons)
Cheesecake - Mother's Little Helper (User: melons)
Bumblescrump - Whiteout (User: melons)
CW/A - Only Straight Girls Wear Dresses (User: melons)
Getaway Car - Sony Radio (User: melons)
Calamity Jane - Come On (User: melons)
Mary Lou Lord - Camden Town Rain (User: melons)
Godheadsilo - Braincloud (User: melons)
Tiger Trap - Super Crush (User: melons)
Jack Acid - Cheap Tragedies (User: melons)
Buffalo Tom - Sodajerk (User: melons)
BENEE - Supalonely (feat. Gus Dapperton) (User: melons)
Claw Boys Claw - Business (User: melons)
Johan - Everybody Knows (User: melons)
Spinvis - kom terug (User: melons)
Magnapop - Merry (User: melons)
Magnapop - Lay It Down (User: melons)
Anne Soldaat - You're Hard to Find (User: melons)
Tim Knol - Wandering Heart (User: melons)
Claw Boys Claw - Loaded (User: melons)
Hallo Venray - Are You Ready For The Country? (User: melons)
Daryll-Ann - Summerdaze (User: melons)
Bettie Serveert - Kid's Allright (User: melons)
Kaia - Salamander (User: melons)
Bettie Serveert - Palomine (User: melons)
Cadallaca - Your One Wish (User: melons)
Excuse 17 - I'd Rather Eat Glass (User: melons)
Lung Leg - Kung Fu on the Internet (User: melons)
Heavens to Betsy - Terrorist (User: melons)
Baby Guts - Staplegun (User: melons)
Team Dresch - St. Ides Heaven (User: melons)
The Butchies - The Galaxy Is Gay (User: melons)
Partyline - Trophy Wifey (User: melons)
Endigo - Big Chungus (User: melons)
Cold Cold Hearts - Any Resemblance... (User: melons)
Adickdid - She's Dangerous (User: melons)
Gina Young - Can She Bake a Cherry Pie? (User: melons)
Brother Ali - Forest Whitiker (User: melons)
Mal Blum - Fine! (User: melons)
45 Grave - Partytime (User: melons)
Against Me! - Thrash Unreal (User: melons)
Tribe 8 - Wrong Bathroom (User: melons)
Rasputina - Transylvanian Concubine (User: melons)
Geoff Berner - Dalloy Polizei (User: melons)
Rebel Diaz - Which Side Are You on? Remix (User: melons)
Propagandhi - Victory Lap (User: melons)
Star Fucking Hipsters - Ana Ng (User: melons)
Stick And Poke - Poison (User: melons)
Bambu - Chairman Mao (User: melons)
Leningrad - i_$uss (User: melons)
AJJ - brave as a noun (User: melons)
The Coup - My Favorite Mutiny (User: melons)
Harley Poe - I Wanna Die (User: melons)
Local News Legend - Neutral Spirit Hotel (User: melons)
Ghost Mice - Critical Hit (User: melons)
Pansy Division - Fem in a Black Leather Jacket (User: melons)
Mischief Brew - Coffee, God, And Cigarettes (User: melons)
Blackbird Raum - Honey in the Hair (User: melons)
Schmekel - FTM at the DMV (User: melons)
Defiance, Ohio - You Are Loved (User: melons)
G.L.O.S.S. - G.L.O.S.S. (We're From The Future) (User: melons)
THE ORPHANS - For An Old Kentucky Anarchist (User: melons)
Darts - Come Back My Love (User: melons)
Motor City Drum Ensemble - L.O.V.E. - Radio Edit (User: melons)
Timo Lassy - African Rumble - Mixed (User: melons)
LateComer - Cosmic Cart - Mixed (User: melons)
Recloose - Cardiology (Isolée Mix) - Mixed (User: melons)
Arts - I've Been Searching (Walter Gibbons 12" Mix) - Mixed (User: melons)
Loose Joints - Pop Your Funk (Vocal Version) - Mixed (User: melons)
Robert Hood - The Pace - mixed (User: melons)
Philippe Sarde - Le Cortege Et Course (User: melons)
Geraldo Pino - Black Woman Experience - Mixed (User: melons)
Creative Swing Alliance - Don't Forget Your Keyz - Mixed (User: melons)
Fred P - On This Vibe - Mixed (User: melons)
Stone - Girl I Like The Way That You Move (Dub) - Mixed (User: melons)
Rick Poppa Howard - Can Your Love Find It's Way (Club Vocal) - Mixed (User: melons)
Mr. Fingers - Mystery of Love - Mixed (User: melons)
Bad Jazz Troupe - Breakdown Treat - Mixed (User: melons)
Peven Everett - Stuck - Mixed (User: melons)
Tony Allen - Ariya - Mixed (User: melons)
Electric Wire Hustle - Again (Scratch 22 Remix) - Mixed (User: melons)
Sun Ra - Door To The Cosmos - Mixed (User: melons)
Lester Sterling - Wise Men (User: melons)
S. Carey - Break Me Open (User: melons)
Pet Shop Boys - Left To My Own Devices (User: melons)
Ted Hawkins - Sorry You're Sick (User: melons)
Mujeres - Right On (User: melons)
Boogie Times Tribe - The Dark Stranger - Origin Unknown Mix (User: melons)
Soulwax - Conversation Intercom (User: melons)
Flash and the Pan - Down Among the Dead Men (User: melons)
Fluke - Atom Bomb (User: melons)
Kiki Gyan - Disco Dancer (User: melons)
Photek - Into the 90's (User: melons)
Dopplereffekt - Infophysix (User: melons)
Virgo Four - In a Vision (User: melons)
Tyree Cooper - Turn Up The Bass - Fast Eddie Scratch It Up Mix (User: melons)
The Dice Man - Polygon Window (User: melons)
Dopplereffekt - Plastiphillia 2 (User: melons)
Derrick May - Nude Photo (User: melons)
Benjamin Damage - Montreal (User: melons)
Renegade Soundwave - The Phantom (User: melons)
LAUER - Esc - Prins Thomas Diskomiks (User: melons)
Juan Atkins - Track Ten (User: melons)
Escape from New York - Fire In My Heart (User: melons)
Answer Code Request - knbn2 (User: melons)
Coldcut - Timber (User: melons)
4hero - Les Fleur (User: melons)
The Shamen - Move Any Mountain - Beat Edit (User: melons)
Humanoid - Stakker Humanoid - 12" Original (User: melons)
Mouse on Mars - Fertilized (User: melons)
Timewarp inc. - Afrofunk - Valique Boogie Brother Remix (User: melons)
Thomas P. Heckmann - Himmel & Hoelle (User: melons)
Ellen Allien - Bowie In Harmony (User: melons)
Fjaak - TAKE YOUR LIFE (User: melons)
Demuja - Tokyo (User: melons)
Matrixxman - Arrival (User: melons)
DJ Boring - Winona (User: melons)
Birdy Nam Nam - Defiant Order (User: melons)
Pierre's Pfantasy Club - Fantasy Girl - Acid Mix (User: melons)
Palms Trax - Sumo Acid Crew (User: melons)
K-Hand - Sound 6 (User: melons)
Osunlade - Auto Machine (User: melons)
Omar-S - Ready My Black Asz (User: melons)
Cro-Magnon - Patchwork Jazz (User: melons)
Maurice Mc Gee - Do I Do - Extended Mix (User: melons)
Poolside - Next To You (User: melons)
Armando - Box Energy (User: melons)
Helena Hauff - The Smell Of Suds And Steel (User: melons)
F.U.S.E. - Substance Abuse (User: melons)
Ceephax Acid Crew - Commuter (User: melons)
Adonis - No Way Back (User: melons)
Fast Eddie - Acid Thunder (User: melons)
Recloose - Cardiology (Isolée Mix) - Mixed (User: melons)
Fast Eddie - Acid Thunder (User: melons)
Phuture - Acid Trax (User: melons)
DJ Rashad - Acid Bit (User: melons)
Mantronix - Bassline (User: melons)
The Garden of Eden - The Garden Of Eden (A Himalayan Song) (User: melons)
Todd Terje & The Olsens - Firecracker (User: melons)
Hardfloor - Acperience 1 (User: melons)
Luke Vibert - I Love Acid (User: melons)
Luke Vibert - I Love Acid (User: melons)
K.L.F.S. - What Time Is Love / Time Of Love (User: melons)
Alexander Robotnick - Problèmes d'Amour - Original (User: melons)
Mr. Fingers - Can You Feel It (User: melons)
Pet Shop Boys - Miserablism (User: melons)
Orange Juice - Rip It Up (User: melons)
LFO - LFO (Leeds Warehouse mix) (User: melons)
Orange Juice - Rip It Up (User: melons)
The Hickey Underworld - Future Words (User: melons)
The Hickey Underworld - Future Words (User: melons)
Arsenal - Estupendo (User: melons)
Faces On TV - Love / Dead (User: melons)
Balthazar - Fever (User: melons)
Millionaire - Champagne (User: melons)
School Is Cool - The World Is Gonna End Tonight (User: melons)
Millionaire - Champagne (User: melons)
The Van Jets - The Future (User: melons)
Soulwax - Much Against Everyone's Advice (User: melons)
Balthazar - Do Not Claim Them Anymore (User: melons)
Soulwax - Much Against Everyone's Advice (User: melons)
Bed Rugs - Piles (User: melons)
Goose - What You Need (User: melons)
Bed Rugs - Piles (User: melons)
Sons - Keep on Going (User: melons)
Sons - Keep on Going (User: melons)
Girls in Hawaii - Organeum (User: melons)
Balthazar - Later (User: melons)
dirk. - Sick 'n Tired (User: melons)
dEUS - Bad Timing (User: melons)
Mintzkov - Ruby Red (User: melons)
Arcade Fire - No Cars Go (User: melons)
The Black Box Revelation - Set Your Head On Fire (User: melons)
Arcade Fire - No Cars Go (User: melons)
BRNS - Mexico (User: melons)
BRNS - Mexico (User: melons)
TaxiWars - Soliloque (Sans Issue) (User: melons)
Nordmann - Save The Twos (User: melons)
Nordmann - Cascade(s) (User: melons)
Nordmann - Save The Twos (User: melons)
Warhaus - Leave With Me (User: melons)
Fence - Without A Trace (User: melons)
Glass Animals - Heart-Shaped Box (User: melons)
Frank Black - Headache (User: melons)
EMS Synthi 100 - Movement 1 (User: melons)
Soulwax - Wouldn't It Be Good? (User: melons)
Soulwax - Conversation Intercom (User: melons)
De Staat - KITTY KITTY - Soulwax Remix (User: melons)
SG Lewis - Impact - Soulwax Remix – Edit (User: melons)
LA Priest - What Moves - Soulwax Remix (User: melons)
Sylvester - You Make Me Feel (Mighty Real) - Soulwax For Despacio Remix (User: melons)
Rikkha - Je te tue (User: melons)
Rikkha - Personal Jesus (User: melons)
Rikkha - Metropolitain (User: melons)
Rikkha - Personal Jesus (User: melons)
Rikkha - About a Girl (User: melons)
Maxence Cyrin - Lithium (User: melons)
Torche - In Bloom (User: melons)
Bachelorette - Her Rotating Head (User: melons)
Hilken Mancini and Chris Colbourn - I Will Die (User: melons)
