Traditional - Ievan Polkka (User: melons)
Composerily - Cat Vibing To Ievan Polkka Swing (User: melons)
MicroMihai - WIDE PUTIN Song (Reggaeton Remix) (User: melons)
LIL SHRIMP - Gucci Gucci Gucci Nike Nike Nike Dior Dior - Pitched (User: melons)
Iceboy Ben - Chug Jug (User: melons)
MemerMeme - Windows XP Song (Meme) (User: melons)
waveyy - Meme Song (User: melons)
Karen Killer - The Banjo Beat, Pt. 2 (User: melons)
Leonz - Among Us... but its Lucid Dreams (User: melons)
Nolo Flows Yo - Super Mario Rap (User: melons)
Verbalase - Tetris - Beatbox (User: melons)
Trap Remix Guys - Super Mario - Trap Remix (User: melons)
Trap Remix Guys - Avengers - Trap Remix (User: melons)
Oli Is MLG - The Bonfire Behind the Slaughter (User: melons)
Flixterr - GRASS SKIRT CHASE (User: melons)
Keiron Raven - SPONGEBOB SONG - REMIX (User: melons)
DJ Facemask - No No Square Loop (User: melons)
Trap Geek - Caillou (From "Caillou") - Trap Remix (User: melons)
Trap Remix Guys - Pink Panther - Trap Remix (User: melons)
Bloxernicc - Noob Song (User: melons)
Roblox da Gamer - OOFED UP (User: melons)
Loginhdi - Oofmon (User: melons)
Andiroo - Oof - Trap Remix (User: melons)
Vineotap - Krusty Krab (Hip Hop Vine Remix) (User: melons)
William Jacobs - Krusty Krab Pizza Song (Spongebob Remix) (User: melons)
Trap Remix Guys - Krusty Krab - Trap Remix (User: melons)
grandayy - China Gang (User: melons)
FlyingKitty - Meme Theme (User: melons)
hangback - Super Mario World (Athletic Theme) - Remix (User: melons)
davay - Tri Poloski (User: melons)
TH3 PRODUC3RS - PIZZA TIME (User: melons)
Takeo Ischi - New Bibi-Hendl - Heimatsender-Mix (User: melons)
SlackCircus - HEYYEYAAEYAAAEYAEYAA (Fabulous Secret Powers) (User: melons)
Gabriel Mercado - Pirates of the Fartbean (User: melons)
Stryker Pose - Super Mario Bros (User: melons)
Roblox da Gamer - I Walk Around on That Bloxburg (User: melons)
John Cena - The Time is Now (User: melons)
Mcap Steve - Welcome to My Mine (User: melons)
Kollavinilika - Despacito 2 (User: melons)
Sufferryanyt - Suffer mode (User: melons)
Billy Marchiafava - Ligma (User: melons)
Iceboy Ben - Default Dance - Instrumental (User: melons)
Iceboy Ben - Wii Shop - Instrumental (User: melons)
Lil Memer - Love Me Long Time (User: melons)
Sam Dubs - Twitch Lasagna (User: melons)
Tiko - Fishy On Me (User: melons)
Sam Dubs - Congratulations (User: melons)
Glitch - YEET! (User: melons)
BeatsBoomingBang - Peepeepoopoo Check TikTok (User: melons)
Jack Shore - My No No Square (User: melons)
Lil $ucre - Sandwich Song (User: melons)
Holy Tony - Beanos Theme Song (User: melons)
Natural910 - Gunga Ginga (User: melons)
Lil Memer - Mining (User: melons)
Quadeca - Wii Music Fire (User: melons)
Murcy - Wii Turn Up (Wii Menu Remix) (User: melons)
Shokk - You Reposted in the Wrong Neighborhood I Glue70 Mashup (User: melons)
Little Jacob - Spider-Man 2 pizza theme (User: melons)
Thomas & Friends - Thomas Theme (Reprise) (User: melons)
Nicholas Fraser - why you always lying? (User: melons)
William Jacobs - Krusty Krab Spongebob Trap Remix Vine Theme (User: melons)
Spooky - Onglon (User: melons)
Tony Allen & The Wonders - Be My Love, Be My Love - 1958 (User: melons)
The Flannels - Hey Rube - 1957 (User: melons)
Plas Johnson - Last Call - 1956 (User: melons)
George Jenkins - Last Call - 1956 (User: melons)
Bob Destiny - Kalenda Rock - 1958 (User: melons)
The Seniors - It's Been a Long Time - 1959 (User: melons)
The Nightingales - I Love You Oh so Much - 1958 (User: melons)
Naaz - Words (User: melons)
bbrainz - omicron (User: melons)
Anthony Hobson - Omicron (User: melons)
Emma Bale - The Woman I Am Today (User: melons)
blackwave. - BIG Dreams (User: melons)
Milow - Christmas Is Finally Here (User: melons)
Tim Knol - A Kid's Heart (User: melons)
Nits - J.O.S. Days (User: melons)
HONNE - no song without you (User: melons)
Bülow - Revolver (User: melons)
Gavin James - City of Stars (User: melons)
Cochemea - Curandera (User: melons)
De Staat - Input Source Select - Vinticious Version (User: melons)
S10 - Sorry (User: melons)
Fresh Kitchen Beats - Wave Hello Hello (User: melons)
DJ Fresh Tunez - This Is Killing My Ears! (User: melons)
DJ Buck - Spin Around (User: melons)
Kyle Willkom - I'm Not Afraid (User: melons)
Taylor Jarman - An Offering (User: melons)
Streetlights - Titus 2 (User: melons)
Levi the Poet - Correspondence (A Commentary) [Introduction] (User: melons)
Matt Doering - White Flag (User: melons)
Chris Bernstorf - Fall Finds (User: melons)
Kyle Willkom - Set Yourself Free (User: melons)
Black Market Bologna - Chorizo (User: melons)
Written to Speak - blooming. (User: melons)
Miles Carter - If You Decide to Leave Someone (User: melons)
Ed Motta - S.O.S Amor (User: melons)
Orlando Julius - Love Thy Neighbour (User: melons)
Humphrey Campbell - Noel Noel (User: melons)
Gerda Havertong - Ik Kan Surinaams Spreken (User: melons)
Stromae - Alors On Danse - Dubdogz Remix (User: melons)
HANG YOUTH - SHELL IS EEN PRIMA BEDRIJF (ALS IK DE WEBSITE MAG GELOVEN) (User: melons)
Fleur - Mon Ami Martien (User: melons)
ADF Samski - Bitches Ain't Shit (feat. ADF Ricky) (User: melons)
Maria Bamford - The Power of Privilege (User: melons)
Norm MacDonald - O.J. (User: melons)
Brian Regan - Evel Knievel (User: melons)
Jim Norton - Al Sharpton Sucks (User: melons)
George Carlin - Parents In Hell (User: melons)
Greg Giraldo - Soulmates (Jfl 2005) (User: melons)
Steven Wright - Bohemiath (User: melons)
Mitch Hedberg - Cake Eater (User: melons)
Dave Attell - Homphobic (User: melons)
Michael Ian Black - I'm A Feminist (User: melons)
alOis - El Cielo Azul (User: melons)
Lewis Black - Thanks For Risking Your Life (User: melons)
Patton Oswalt - Treadmill (User: melons)
David Cross - Lunch With Frankenstein (User: melons)
Cameron Esposito - Cam Hates Camping (User: melons)
Cameron Esposito - What Are You? (User: melons)
Bob's Burgers - Doot Doo I Love You (User: melons)
$hirak - Done Done (User: melons)
alyona alyona - 20 тонн (User: melons)
Alex Gough - POCKET CHANGE (User: melons)
will maxwell - Viewed From All Angles (User: melons)
Alicia Edelweiss - Dreck (User: melons)
Lou & Simon - It's Just An Idea (User: melons)
The Embers - Shake Rattle & Roll (User: melons)
Carol Davies - Wee Wee Willie (User: melons)
Jay Epae - What Can I Do (User: melons)
Judge Wayne - Little Miss Rhythm & Blues (User: melons)
Herma Keil - Stagger Lee (User: melons)
Tony - Hello Jenny Lee (User: melons)
Max Merritt & The Meteors - Almost Grown (User: melons)
Peter Posa - Instrumental (User: melons)
Dinah Lee - I'm Walkin' (User: melons)
Jimmie Sloggett - Must Be Madison (User: melons)
Little Joy Yates - I'm Movin' On (User: melons)
Garth Young Trio - Sugartime (User: melons)
Peter Posa - The White Rabbit (User: melons)
The Keil Isles - Little Papoose (User: melons)
Jimmie Sloggett - Shake (User: melons)
The Embers - The Man From Laramie (User: melons)
Dave Henry - Ta Ta (User: melons)
Cole Wilson - Hub Boogie (User: melons)
The Q-Tees - That'll Be The Day (User: melons)
Bill Morton - I'm A Fool To Care (User: melons)
Ken Lemon - Yodel Boogie feat. The Tumbleweeds (User: melons)
Ivor Fisher - Call on Cupid (User: melons)
Cole Wilson - Tumbleweed Boogie (User: melons)
Ronnie Sundin - Moo Cow Boogie Blues (User: melons)
Luke Simmons - Hobo Joe's Boogie (User: melons)
Luke Simmons - Hey Baby (User: melons)
The Q-Tees - All Shook Up (User: melons)
The Nu-Sonics - Call It A Day (User: melons)
Anushka Chkheidze - Beside Halfie (User: melons)
arp Frique - Ijo Ya (User: melons)
ARTBAT - Best of Me - Radio Edit (User: melons)
IVAN$ITO - Tiempo (User: melons)
Porij - Can't Stop (User: melons)
Nenny - SUSHI (User: melons)
EPOQUE - Petite (User: melons)
Nala Sinephro - Space 3 (User: melons)
Coucou Chloe - NOBODY (User: melons)
cero ismael - PUBLIK (User: melons)
Jael - Usually I Don't (Do This) (User: melons)
Alewya - Dragon (User: melons)
Luidji - Mauvaise Nouvelle (User: melons)
Hauptman - What I've Started (User: melons)
IVAN$ITO - Tiempo (User: melons)
Kai Nakai - Ez Dakit (User: melons)
Kai Kwasi - lakitu (User: melons)
LNDFK - Souleyes (User: melons)
daniel sabater - cómo quieres que me enfade (User: melons)
Priya Ragu - Chicken Lemon Rice (User: melons)
Alewya - Play (User: melons)
Yade Lauren - In De Nacht (User: melons)
May The Muse - Take Me - A COLORS ENCORE (User: melons)
James BKS - Kusema (User: melons)
Hauptman - Send Me Flying (User: melons)
Kai Nakai - Kelokentoky (User: melons)
Pip Millett - Best Things (User: melons)
Amaranthe - Fury (User: melons)
Suzane - Laisse tomber les filles (User: melons)
No Small Children - Laisse Tomber Les Filles (User: melons)
THE ROARING 420s - Laisse Tomber Les Filles (User: melons)
Fabienne DelSol - Laisse tomber les filles (User: melons)
Carla Prata - Favelada (User: melons)
The Whitest Kids U' Know - Goodnight (User: melons)
guccihighwaters - Oh Fuck I'm Drunk (User: melons)
Jamie Kilstein - Citizen Radio (User: melons)
K Trevor Wilson - GPS (User: melons)
Morgan Murphy - Accents (User: melons)
Hannibal Buress - Salute the troops (User: melons)
Eugene Mirman - Grandmother (User: melons)
Brian Posehn - Having a Baby (User: melons)
Chloe Moriondo - Rly Don't Care (User: melons)
Jared Logan - Work - Live (User: melons)
Scott Aukerman - Asiatic (User: melons)
Cyne - Steady (User: melons)
Joshua Hedley - Weird Thought Thinker (User: melons)
Kevin - Langzaam (User: melons)
Jan & Dean - Manhattan (User: melons)
Vince Giordano And The Nighthawks - Manhattan (User: melons)
Elliot Speller-Gillott - I love love you (User: melons)
Gaia - Boca (User: melons)
Ed Dowie - How Light I (User: melons)
Anabel Englund - Midnight Rapture (User: melons)
Essel - Love Vibration (User: melons)
Steve Aoki - Equal in the Darkness (User: melons)
Nia Archives - Forbidden Feelingz (User: melons)
TELYKast - Unbreakable (with Sam Gray) (User: melons)
Bob Moses - Time and Time Again - Single Edit (User: melons)
LP Giobbi - O Retha (User: melons)
Doss - Cherry - Spotify Singles (User: melons)
Jethro Heston - Cut Me Loose - Edit (User: melons)
Sofi Tukker - Sun Came Up (User: melons)
Gryffin - After You (feat. Calle Lehmann) (User: melons)
Gabry Ponte - Thunder (User: melons)
Jauz - Make It Good (User: melons)
Elderbrook - I’ll Find My Way To You (User: melons)
Bonobo - Rosewood (User: melons)
Shygirl - Cleo - Edit (User: melons)
Vintage Culture - You Give Me A Feeling (User: melons)
Ewan McVicar - Tell Me Something Good (User: melons)
Oden & Fatzo - Lauren (User: melons)
Regard - Signals (User: melons)
Shane Codd - It Ain't Right (User: melons)
NGHTMRE - Shady Intentions (feat. Tori Levett) (User: melons)
ANZ - You Could Be (User: melons)
Afrojack - Anywhere With You (User: melons)
Dom Dolla - Strangers (with Mansionair) (User: melons)
Frank Walker - I Wonder (feat. Shai) (User: melons)
Lane 8 - Nuclear Lethargy (User: melons)
J. Worra - Wasteland (feat. Little Boots) (User: melons)
James Hype - Disconnected (User: melons)
Dillon Francis - Real Love (User: melons)
Sonny Fodera - Last Thought (feat. MKLA) (User: melons)
Gabry Ponte - Can't Get Over You (feat. Aloe Blacc) (User: melons)
Fred again.. - Hannah (The Sun) (User: melons)
Rezz - Paper Walls (User: melons)
KAYTRANADA - Intimidated (feat. H.E.R.) (User: melons)
Ben Kim - Somebody To Love (User: melons)
Wilkinson - Used to This (User: melons)
Mura Masa - 2gether (User: melons)
Joel Corry - I Wish (feat. Mabel) (User: melons)
System.Inc - The Don (User: melons)
Age Of Love - The Age Of Love - Charlotte de Witte & Enrico Sangiuliano Remix (User: melons)
Alesso - Somebody To Use (User: melons)
Nina Kraviz - This Time (User: melons)
Purple Disco Machine - Dopamine (feat. Eyelar) (User: melons)
Alison Wonderland - Fuck U Love U (User: melons)
Chris Lake - A Drug From God (User: melons)
Sam Feldt - Follow Me (User: melons)
Alan Walker - Man On The Moon (User: melons)
Meduza - Tell It to My Heart (User: melons)
Öwnboss - Move Your Body (User: melons)
Armin van Buuren - No Fun (User: melons)
Martin Garrix - Won’t Let You Go (User: melons)
R3hab - I Wanna Run Away (User: melons)
Chris Lorenzo - California Dreamin' (feat. High Jinx) (User: melons)
Rêve - CTRL + ALT + DEL (User: melons)
Oliver Heldens - Deja Vu (User: melons)
Tiësto - The Motto (User: melons)
ACRAZE - Do It To It (User: melons)
Parks, Squares and Alleys - Мёртвый сезон (User: melons)
Molchat Doma - Танцевать (User: melons)
Poshlaya Molly - Нон стоп (User: melons)
Valentin Strykalo - Дешёвые Драмы (User: melons)
Дайте танк (!) - Утро (User: melons)
buerak - Страсть к курению (User: melons)
Grechka - Анимешница (User: melons)
Vollny - Тебя нет рядом (User: melons)
MONETOCHKA - Пост-пост (User: melons)
Mujuice - Возвращайся Домой (User: melons)
Utro - Что-то не то творится (User: melons)
Svidaniye - Любовь (User: melons)
Мы - возможно (User: melons)
Shortparis - Страшно (User: melons)
I Monster - Everyone's A Loser (User: melons)
Fever The Ghost - Source (User: melons)
Jack Stauber - Dead Weight (User: melons)
Caravan Palace - Lay Down (User: melons)
Cuco - Summer Time High Time (User: melons)
Tally Hall - The Bidding (User: melons)
Mcbaise - She's a Big Boy (User: melons)
Lemon Demon - Touch-Tone Telephone (User: melons)
Big Data - Dangerous (feat. Joywave) (User: melons)
Molchat Doma - Судно (Борис Рижий) (User: melons)
The Dead Pirates - UGO (User: melons)
Scarlet - Independent Love Song (User: melons)
The Judds - Why Not Me (User: melons)
Mandolin Orange - Old Ties and Companions (User: melons)
Sinéad Lohan - Whatever It Takes (User: melons)
Abe Abraham - Where the Skies Are Blue (User: melons)
Parker Millsap - Your Water (User: melons)
Dispatch - Only the Wild Ones (User: melons)
Rainbow Kitten Surprise - Hide (User: melons)
Caamp - Misty (User: melons)
Fruition - Mountain Annie (User: melons)
The Last Alaskans - Love At First Sight (User: melons)
Ronnie Laws - Stay Awake (User: melons)
Miki Matsubara - Who Are You? (User: melons)
Ben Sollee - Letting Go (User: melons)
Maurice Fulton - Jigoo (User: melons)
TootArd - Moonlight (User: melons)
Grandaddy - Blindness (User: melons)
Rowlf - The Christmas Party Sing-Along (User: melons)
Lord Echo - Digital Haircut (User: melons)
Erika de Casier - Better Than That (User: melons)
Sudan Archives - Sink (User: melons)
Nara Leão - Lindonéia - Remastered (User: melons)
R.N.A-Organism - Weimar 22 (User: melons)
Joe Hisaishi - The Valley of the Wind (User: melons)
Fabiano do Nascimento - Rio Tapajós (User: melons)
Tommy Guerrero - Thank You MK (User: melons)
Adrian Younge - Hey Lover - Instrumental (User: melons)
Al Lopaka - Sassy (User: melons)
Aura - Yesterday's Love (User: melons)
Özdemir Erdoğan - Gurbet (User: melons)
Bremer/McCoy - Vega (User: melons)
Craig Leon - Visiting (User: melons)
Vulfpeck - Cory Wong (User: melons)
FaltyDL - For Karme (User: melons)
Emerson Kitamura - Rock Your Baby (User: melons)
Gus Levy - Plantar a Flor no Inferno (User: melons)
toe - C (User: melons)
linafornia - dot wav (User: melons)
Ahnamusica - Weather Channel (User: melons)
Soul Supreme - Runnin' (User: melons)
seprock - Kona Windz (User: melons)
Sweet Blindness - Ain't No Use (User: melons)
Carroll Thompson - No, You Don't Know - 2021 - Remaster (User: melons)
岩崎宏美 - カンバセーション (User: melons)
Lani Hall - Love Song (User: melons)
Lemuria - All I've Got to Give (User: melons)
Circus - フライ・アウェイ (User: melons)
Cold Diamond & Mink - The World Loves a Fool - Instrumental (User: melons)
Angel Bat Dawid - London (User: melons)
Eugene McDaniels - Headless Heroes (User: melons)
Kalapana - Love 'Em - Remastered (User: melons)
Naomi Akimoto - Dream On Fire (User: melons)
A Vision of Panorama - Interlude (User: melons)
Sam Prekop - Summer Places (User: melons)
Ebo Taylor - Heaven (User: melons)
Pearson Sound - Earwig - Mixed (User: melons)
Peggy Gou - Hungboo (DJ-Kicks) - Mixed (User: melons)
KMD - Peachfuzz (User: melons)
Jeff Parker - Build a Nest (User: melons)
Children Of Zeus - I Know (User: melons)
Alika Lyman Group - Night Orchid (User: melons)
Masahiro Sugaya - Wind Conversation (User: melons)
Mindy Meng Wang 王萌 - Sleeping Tiger On The Bund 蓄势待发 (User: melons)
The Vision - Mountains (feat. Andreya Triana) - Danny Krivit Remix (User: melons)
Tommy Guerrero - So Blue It's Black (User: melons)
Mogwaa - Mogwaa's Mood (Tribute to Kashif) (User: melons)
Kat O1O - Streams (User: melons)
João Donato - Sua Beleza e Beleza (User: melons)
Dominic J Marshall - feeling (User: melons)
Brijean - Paradise (User: melons)
Seals & Crofts - Midnight Blue (User: melons)
Altin Gün - Kaymakamın Kızları (User: melons)
Steps Ahead - Soul Eyes (User: melons)
松任谷由実 - ツバメのように (User: melons)
Miki Matsubara - Yuuyake No Jikan Desu (User: melons)
Synergetic Voice Orchestra - A Tale (User: melons)
Jun Matsue - Arrangement Hair Style (User: melons)
Sven Wunder - Natura Morta (User: melons)
Yu Su - Melaleuca - at night (User: melons)
Misses Misty - Mellow Mellow Ride On (User: melons)
Jukka ja Jytämimmit - Jytäkesä 015 (User: melons)
Parcels - Tieduprightnow (User: melons)
Essexx - Chromatics - !Distain Rmx (User: melons)
Sepikka - Vuodet vierii (User: melons)
Saimaa - Teema 1 sarjasta Politiikka-Suomi (User: melons)
Aivovuoto - Jotkut parhaista kavereistani ovat pankkiireita (User: melons)
J. Karjalainen - nancy ja sally (User: melons)
Muuan Mies - Flipparikvartetti (User: melons)
Seksihullut - Nyt vasta tiedän (User: melons)
Pelle Miljoona Oy - Anna soihtusi palaa (User: melons)
Asa - Taulu (User: melons)
Radiopuhelimet - Jaameri (The Arctic Ocean) (User: melons)
Ruusut - Bubo Bubo (User: melons)
Kynnet - Jukeboksin valot (User: melons)
J. Karjalainen - pontikkapoika (User: melons)
Faarao Pirttikangas - Iso susi ulvoo taas (User: melons)
Pekka Streng - Puutarhassa (User: melons)
Pekko Käppi - Mun vereni (User: melons)
Linkopii - Linkopii (User: melons)
22-Pistepirkko - Don't Say I'm So Evil (User: melons)
Ursus Factory - Oot pomo (User: melons)
Nyrkkitappelu - Seppo Räty / Pakkotoisto (User: melons)
Jarkko Martikainen - Pidän tästä paikasta (User: melons)
Plutonium 74 - Pasilasta (User: melons)
Jukka ja Jytämimmit - Vauhtikuningatar (User: melons)
Ursus Factory - Kaikki on niin vitun ihan jees (User: melons)
Tuomas Henrikin Jeesuksen Kristuksen Bändi - Käpytemppeli (User: melons)
Kivesveto Go Go - Tajuutsä Jätkä? (User: melons)
Vinttikoira - Mary Jane (User: melons)
Ruger Hauer - Riippusilta (User: melons)
Räjäyttäjät - Nyt maistuis A (User: melons)
Regina - Olisitko sittenkin halunnut palata (User: melons)
Pää Kii - Nyt skipataan kahvit (User: melons)
Ex Tuuttiz - Pitkät Vitut Blogosfääriin (User: melons)
Litku Klemetti - Mäkkärirakkautta (User: melons)
Yona - Nättii, eipä (User: melons)
Jukka Nousiainen - Meneehän se aika tässäkin (User: melons)
Litku Klemetti - Kimaltava mekko (User: melons)
Nyrkkitappelu - Tyttöjen farkut (User: melons)
TEKSTI-TV 666 - Sä et tuu enää takaisin koskaan (User: melons)
Risto - Rakkauden Rock (User: melons)
Livija Gradauskienė - 40 Kaštonų (User: melons)
Les Stagnateurs - Ateik Į Pasimatymą (User: melons)
Žvaigždžių kvartetas - O gražuole Palanga (User: melons)
Graffiti - Palanga (User: melons)
Cappuccino - Sudeginti tiltai (User: melons)
La Vita - Sveika Nijole (User: melons)
16Hz - Dar širdyje ne sutema (User: melons)
TIGRA - Jupi Ja (User: melons)
Aleksandras Makejevas - Juodas garvežys (User: melons)
UAB Music - Vėjas Man Pasakė (feat. Superžvaigždės) (User: melons)
Gytis Paškevičius - Raganų Puota (User: melons)
Violeta Riaubiškytė - Oi palauk palauk (User: melons)
Biplan - Anzelmutė (User: melons)
Gintarė Karaliūnaitė - Debesėli Debesėli (User: melons)
The Web - Sunshine of Your Love (User: melons)
The Mojos - Everything's Alright (User: melons)
Catch - A House on Fire (User: melons)
Miss Saigon Original Cast - Sun And Moon - Live (User: melons)
Readymade - Superficial (User: melons)
Galactic Cowboys - I Can't Wait (User: melons)
Rinderwahnsinn - Elden (User: melons)
Hutpferdemänner - Heut´Nacht (User: melons)
Die Aeronauten - Extremadura (User: melons)
Venom - The Evil One (User: melons)
Andy Armstrong & Marta Bayly - Simon Says (User: melons)
Bravo Cong - Catch Me if You Can (User: melons)
Stereo Total - Grand Prix Eurovision (User: melons)
Travis Tritt - Anymore - 2006 Remaster (User: melons)
Michael J - The Dark Side of Me (User: melons)
Big Brave - Struggles (User: melons)
Little Boots - Silver Balloons (User: melons)
Nails - I Don't Want to Know You (User: melons)
Hayleyesus Feyssa - Salayesh (User: melons)
Theodros Kassahun - Guadegna (User: melons)
Abinet Agonafir - Atnafikegn Lije (User: melons)
The William Loveday Intention - Thatcher's Children (User: melons)
My Girl The River - Sad Dog (User: melons)
Departure Lounge - Frédéric's Ghost (User: melons)
Octavio meza y su conjunto - LA PELEA CON EL DIABLO (User: melons)
Migrant Motel - Shock Sessions: I Dont Wanna Know - Shock Sessions (User: melons)
Pornomotora - dispárame (User: melons)
Aguas Ardientes - 5 Malparidos (User: melons)
Bajo Tierra - El Pobre (User: melons)
Cielito Drive - ¿Quién Tiene la Pelota? (User: melons)
Diomedes Díaz - La Vaca y El Toro - Versión Parranda (User: melons)
Los Makenzy - Delirio (User: melons)
DISTIMIA AGORAFÓBICA - Cayendo (User: melons)
La Pestilencia - Nada Me Obliga (User: melons)
Higuita en Chanclas - Roja en Wembley (User: melons)
La Derecha - Nada te va a corromper (User: melons)
Aterciopelados - Mujer Gala (User: melons)
Nicolás y los Fumadores - Bailando Triste (User: melons)
1280 Almas - Los Planetas (User: melons)
Margarita Siempre Viva - Techo De Astros Y Truenos: Fenómenos (User: melons)
Deafheaven - Neptune Raining Diamonds (User: melons)
Eyob Mekonen - Nekchalehu (User: melons)
Dawit Mellesse - Ayisemashim (User: melons)
Ephrem Tamiru - Godanayie (User: melons)
Aster Aweke - Wuha Wuha (User: melons)
Helen Berhe - Atasferaragn [Remastered] (User: melons)
Tomorrow Pulsar - Never Enough (User: melons)
Return To Tomorrow - Rocksta (User: melons)
Rana Alagöz - Gel Yanıma Gel (User: melons)
Return To Tomorrow - Never Enough (User: melons)
Dougie MacLean - Never Enough (User: melons)
The Controllers - If Tomorrow Never Comes (User: melons)
Lord Rhaburn Combo - Soul Brother (User: melons)
Lord Rhaburn Combo - Soul Brother (User: melons)
Francis Reneau & The Mission Singers Of Belize - I Hear You Calling (User: melons)
The Professionals - A Part of Being With You (User: melons)
The Web - The Same Old Me (User: melons)
Jesus Acosta & The Professionals - Guajida (User: melons)
Lord Rhaburn - Disco Connection (User: melons)
Urfali Babi - Salako (User: melons)
Kamuran Akkor - Aşk Eski Bir Yalan (User: melons)
Nadia Cattouse - Long Time Boy (User: melons)
Nazan Şoray - Hal Hal - Barış K Edit (User: melons)
Soul Creations - Funky Jive Part II (User: melons)
The Harmonettes - Can't Go Halfway (User: melons)
Cem Karaca - Nem Alacak Felek Benim - Barış K Edit (User: melons)
Floyd Lavine - Lampião - Baris K Dub Mix (User: melons)
yohana - Shelter (User: melons)
jano band - Kenat Wediya (User: melons)
Dawit Tsige - Chall Zendero (User: melons)
Ephrem Amare - Atiyo (User: melons)
Dawit Cherent - Fiker (User: melons)
Gildo Kassa - Lageba New (User: melons)
Vision Music Entertainment - Yebleniloo (User: melons)
Betty G - Mengedegna (User: melons)
Muluken Dawit - Ena (User: melons)
Rahel Getu - Tilobign (User: melons)
Ephrem Amare - 'Sey (User: melons)
Natti Haile - Bob Marly (User: melons)
jano band - Hager Alegn (User: melons)
Abdu Kiar - Altelashim (User: melons)
Kako Getachew - Gude (User: melons)
Bisrat Surafel - Godanaw (User: melons)
Teddy Afro - Abebayewosh (User: melons)
Abdu Kiar - Fiker Beamargna (User: melons)
jano band - Rega (User: melons)
Lij Michael - Zemenay Mariye (User: melons)
Zebiba Girma - Gerager (User: melons)
Dawit Mellesse - Endet Lichal (User: melons)
Buzuayew Demissie - Tizita (User: melons)
Mahmoud Ahmed - Dèra (User: melons)
Dawit Tsige - Betam New Emewodish (User: melons)
Teddy Yo - Africa (User: melons)
Nhatty Man - Yemegemeriyaye (User: melons)
Bisrat Surafel - Yebet Sira (User: melons)
Rophnan - Lingerish (User: melons)
jano band - Keteraraw Mado (User: melons)
Sami Dan - 123 (User: melons)
Betty G - Birabiroye (User: melons)
Rophnan - Get to work (User: melons)
BALTHVS - Colombian Girl (User: melons)
Selda Bağcan - Yaz Gazeteci Yaz (User: melons)
Ayla Algan - Bilenler Kazanıyor (User: melons)
Nazan Şoray - Hal Hal (User: melons)
Füsun Önal - Ah Nerede (User: melons)
Neşe Karaböcek - Çayelinden Öteye/Yali Yali (User: melons)
Moğollar - Çığrık (User: melons)
Rana Alagöz - Gel Yanıma Gel (User: melons)
Altin Gün - Kırşehirin Gülleri (User: melons)
Altin Gün - Kırşehirin Gülleri (User: melons)
Nur Yoldaş - sultan-i yegah (User: melons)
Barış Manço - Dere Boyu Kavaklar (User: melons)
Mazhar Ve Fuat - Adımız Miskindir Bizim (User: melons)
Mustafa Özkent - Üsküdara Giderken (User: melons)
Esin Afşar - Zühtü (User: melons)
Ersen ve Dadaşlar - Derman Bulunmaz - Barış K Edit (User: melons)
Şenay - Dalkavuk - Barış K Edit (User: melons)
Erkin Koray - Cemalım - Barış K Edit (User: melons)
Barış Manço - Kazma (User: melons)
Özdemir Erdoğan - Gurbet (User: melons)
Crash Course in Science - Jump Over Barrels (User: melons)
White Car - The Factor (User: melons)
The KVB - Leaning (User: melons)
The Present Moment - Cheap Thrills (User: melons)
Boytronic - Trigger Track (User: melons)
Absolute Body Control - Figures (User: melons)
Pesteg Dred - transaction (User: melons)
Oppenheimer Analysis - The Devil's Dancers (User: melons)
Crash Course in Science - No More Hollow Doors (User: melons)
Eleven Pond - Tear And Cinnamon (User: melons)
Trisomie 21 - Red or Green (User: melons)
Sally Dige - Hard To Please (User: melons)
Inhalt - Vehicle (User: melons)
silent em - Nýchta (User: melons)
Glass Candy - Digital Versicolor (User: melons)
Lust for Youth - New Boys (User: melons)
Pictureplane - Goth Star (User: melons)
The KVB - NIGHT GAMES (User: melons)
Skeleton Hands - Oxygen (User: melons)
Das Kabinette - The Cabinet (User: melons)
Pure Ground - No Passage (User: melons)
silent em - Case Unclear (User: melons)
Peine Perdue - Cerceaux (User: melons)
Eleven Pond - Watching Trees (User: melons)
Frank (just Frank) - Do The Soviet (User: melons)
Cold Colors - Eleven (User: melons)
ortrotasce - World Unrelated (User: melons)
Equinoxious - Cosmódromo (User: melons)
Peine Perdue - Segment (User: melons)
silent em - Singular Malice (User: melons)
Pure Ground - Second Skin (User: melons)
Equinoxious - El satélite del ejército negro (User: melons)
DAF - Brothers - Gabi's Mix (User: melons)
Ryuichi Sakamoto - The Left Bank (User: melons)
The Coral - Lover Undiscovered (User: melons)
Amanaz - I am Very Far (User: melons)
Eno Moebius Roedelius - The Belldog (User: melons)
Popol Vuh - Morgengruss II (User: melons)
Eden Ahbez - Eden's Cove (User: melons)
Bobb Trimble - Killed by the Hands of an Unknown Rock Starr (User: melons)
Headless Heroes - True Love Will Find You In The End (User: melons)
Bobb Trimble - Killed by the Hands of an Unknown Rock Starr (User: melons)
Sleater-Kinney - Worry With You (User: melons)
Sleater-Kinney - Worry With You (User: melons)
Nancy - 7ft Tall Post-Suicidal Feel Good Blues (User: melons)
Miles Davis - Honky Tonk (User: melons)
Michael Farneti - The River (User: melons)
Andy Bell - Cherry Cola (User: melons)
The Primitives - The Ostrich (User: melons)
Patrick Cowley - One Hot Afternoon (User: melons)
Quiet Marauder - Pretty Girls Are (Pretty) (User: melons)
Richard Swift - Dressed Up For The Letdown (User: melons)
Wendy & Bonnie - By The Sea (User: melons)
Time Zone - World Destruction (User: melons)
Gastr Del Sol - The Seasons Reverse (User: melons)
Tamar Aphek - Crossbow (User: melons)
Loose Fur - Laminated Cat (User: melons)
John Cale - Paris 1919 (User: melons)
The Catenary Wires - Face on the Rail Line (User: melons)
Bunny Sigler - Theme For Five Fingers Of Death (User: melons)
Daniel Lanois - Torn Again (User: melons)
The Whispers - It's a Love Thing (User: melons)
Linx - Wonder What You're Doing Now (User: melons)
Don Rendell Quintet - A Matter Of Time - Remastered 2020 (User: melons)
Greentea Peng - Satta (User: melons)
Cleo Sol - Why Don't You (User: melons)
Dave - System (feat. WizKid) (User: melons)
Shibashi - All the Lights (feat. Aoife Whenyoung) (User: melons)
jxdn - Pray (User: melons)
Promoting Sounds - Memory (User: melons)
Quinn XCII - Stacy (User: melons)
Greyson Chance - Shut Up (User: melons)
Lauv - Miss Me - Demo (User: melons)
Jeremy Zucker - we're fucked, it's fine (User: melons)
Khalid - Angels (User: melons)
Christian Leave - Can't Help Falling in Love (User: melons)
Mt. Joy - Have Faith (Feat. Liz Vice) (User: melons)
Bülow - Sundress (User: melons)
Lauv - Dishes (User: melons)
Yung Pinch - Hell On Earth (User: melons)
Alec Benjamin - Match in the Rain (User: melons)
Caamp - Vagabond (User: melons)
Lennon Stella - Kissing Other People (User: melons)
King Princess - Holy (User: melons)
MOTEL 7 - would u believe me (User: melons)
Vance Joy - Call If You Need Me (User: melons)
The Hunna - She's Casual - Acoustic (User: melons)
Gracie Abrams - Stay (User: melons)
Olivia O'Brien - Just Friends (User: melons)
Christian French - sweet home (User: melons)
Alison Wonderland - High (User: melons)
blackbear - CHANGES (User: melons)
Souly Had - All the Time (User: melons)
BØRNS - Blue Madonna (User: melons)
lovelytheband - filling a void - interlude (User: melons)
X Ambassadors - I DON’T KNOW HOW TO PRAY (User: melons)
Coin - Dreamland Sequence (User: melons)
Powfu - ill come back to you (feat. Sarcastic Sounds & Rxseboy) (User: melons)
Chelsea Cutler - Sleeping With Roses (User: melons)
Jeremy Zucker - glisten (interlude) (User: melons)
Role Model - that's just how it goes (User: melons)
Pinegrove - Amulets (User: melons)
Christian Leave - please notice (User: melons)
The 1975 - The 1975 (User: melons)
The 1975 - The 1975 (User: melons)
Lil Nas X - Panini (User: melons)
24kGoldn - CITY OF ANGELS (User: melons)
Beyoncé - NILE (User: melons)
Ariana Grande - pete davidson (User: melons)
Dayglow - Something (User: melons)
Ne-Yo - “Caterpillars 1st” (INTRO) (User: melons)
ElyOtto - SugarCrash! (User: melons)
Victoria Monét - We Might Even Be Falling in Love (Interlude) (User: melons)
Tori Kelly - Where I Belong - Intro (User: melons)
HONNE - our love will never die (User: melons)
Logic - Perfect (User: melons)
PARTYNEXTDOOR - Break from Toronto (User: melons)
Dominic Fike - Babydoll (User: melons)
Soulchef - Seashore (User: melons)
Soulchef - Seashore (User: melons)
Andrew McCrorie-Shand - Altered Images (User: melons)
Bob Foster - China Doll (User: melons)
Richard Myhill - Spoof Sleuth (User: melons)
Toby Fox - Deal Gone Wrong (User: melons)
Andrew McCrorie-Shand - Health and Efficiency (User: melons)
Jed Whedon - Bad Horse Chorus (User: melons)
The Budos Band - Untitled (User: melons)
The Beach Boys - Untitled (Redwood) - Instrumental (User: melons)
Reme Martin - True Love (User: melons)
Reme Martin - Salute (User: melons)
Cornflakes Heroes - Polyclinique du parc (User: melons)
Richard Harvey - Enchantment (User: melons)
Passion Pit - Two Veils To Hide My Face (User: melons)
The Mothers of ınvention - Bow Tie Daddy (User: melons)
Nick Glennie-Smith - The Knack (User: melons)
Mild High Club - Skiptracing (Reprise) (User: melons)
Reme Martin - Screw Loose (User: melons)
Yellow Eyes - Dry Stone At Fields Edge (User: melons)
Koushik - Outerlude (User: melons)
Andy Clark - Success Factor (User: melons)
The New Seekers - Free To Be...You And Me (Reprise) - Outro (User: melons)
Glenn Phidick - Raising a Smile (User: melons)
Graham Preskett - Switch On (User: melons)
Asheru - The Boondocks Main Title (User: melons)
Sam Cooke - Soul - Hidden Track (User: melons)
Toby Fox - Nyeh Heh Heh! (User: melons)
Andrew McCrorie-Shand - Stadium (User: melons)
DJ Sorama - Treblalude (User: melons)
The Sound of Animals Fighting - Intro (User: melons)
Articolo 31 - Non Ce La Fai (User: melons)
The Tokens - Perhaps, The Joy Of Giving (User: melons)
Dick Walter - A New Challenge (2) (User: melons)
Oneohtrix Point Never - ECCOJAMC1 (User: melons)
Reme Martin - Beyond the Future (User: melons)
John Devereaux - Wired (User: melons)
Flying Lotus - Stirring (User: melons)
John Devereaux - Win or Lose (User: melons)
Thomas & Friends - Thomas Theme (Reprise) (User: melons)
Richard Myhill - The Driving Force (User: melons)
Cinematika - Monsters Are Mashed (User: melons)
Richard Harvey - Soft Wings (User: melons)
Leikeli47 - 85 South (Skit) (User: melons)
Bob Foster - New Awakening (User: melons)
Spite - Despise (User: melons)
Succumb - Lilim (User: melons)
Thoughtcrimes - Misery's a Muse (User: melons)
Exhibition - Adapt Or Die (User: melons)
Angelmaker - Lazarus (User: melons)
200 Stab Wounds - Drilling Your Head (User: melons)
Genocide Pact - Deprive / Degrade (User: melons)
Heriot - Near Vision (User: melons)
Gel - XOXO (User: melons)
Spy - Obtained Under Duress (User: melons)
Letters To Catalonia - insignificance (User: melons)
.gif from god - no dude...he STILL likes to spray (User: melons)
meth. - Cold Prayers (User: melons)
Kraus - Boundary (User: melons)
Momentum - The Lie After Life (User: melons)
All Under Heaven - Cement Shoes (User: melons)
Zulu - Straight From Da Tribe Of Tha Moon (User: melons)
Heads. - A Swarming Tide (User: melons)
Nūr - Ein Junes (User: melons)
Enemymine - Coccoon Clo3 (User: melons)
Enemymine - Man Enough (User: melons)
Blacklisters - Cash Cow (User: melons)
P I N K O - Hex The Body (User: melons)
End You - X'd Out (User: melons)
Vampyre - Catacomb Bones (User: melons)
Exhalants - Bang (User: melons)
Corvid Canine - Emberizidae (User: melons)
True Body - D.I. (User: melons)
Codeine - Skeletons - SOS Demo (User: melons)
Distortion Felix - Red Lips (User: melons)
Starflyer 59 - Happy Days Are Here Again - Silver Album Version (User: melons)
Venus Twins - Fkn Lightning (User: melons)
Creeping Death - Skinned Alive (User: melons)
Bleed - Burnt (By the Sun) (User: melons)
Big Bite - Old Mood (User: melons)
GLARE - Into Me (User: melons)
Trauma Ray - Spinning (User: melons)
Garden of Mary - The Agony in Memory (User: melons)
Clear Acid - Kick Me Down (User: melons)
Skourge - Old Gods Return (User: melons)
Ozone - Pushing On (User: melons)
Gagging Order - INTRO (User: melons)
deepincision - deepincision (User: melons)
fallfiftyfeet - Twisted World (User: melons)
Blind Equation - :reconnect: (User: melons)
The Callous Daoboys - Die on Mars (Side Story) (User: melons)
Wristmeetrazor - Nietzsche Is Dead (User: melons)
Binary - Blood Is the New Fashion (User: melons)
ASkySoBlack - In A Field (User: melons)
Dreg - perfect_machine.start (User: melons)
Ballista - 1000 Stitches 2000 Cuts (User: melons)
The Queen Guillotined - deceased_people_in_shallow_graves_in_the_backyards_of_suburban_neighborhoods (User: melons)
fromjoy - what's it like when you die? (User: melons)
Bummer - JFK Speedwagon (User: melons)
Portrayal of Guilt - Touched by an Angel (User: melons)
Chat Pile - Davis (User: melons)
Kurama - There Are More Planes in the Ocean Than Submarines in the Sky (User: melons)
Tooth & Nail - Tombstone (User: melons)
The Goofs - Don't Mess With Texas (User: melons)
Trampled by Turtles - Wildflowers (User: melons)
Nahko and Medicine for the People - Lifeguard (User: melons)
Lissie - Everywhere I Go (User: melons)
Ingrid Michaelson - You And I (User: melons)
Boyce Avenue - Titanium (User: melons)
Emily Browning - God Help The Girl (User: melons)
Pascal & Pearce - Belong (User: melons)
The Asteroids Galaxy Tour - The Golden Age (User: melons)
Citizen Cope - Bullet And A Target (User: melons)
Morningwood - Nth Degree (User: melons)
We Were Promised Jetpacks - Moving Clocks Run Slow (User: melons)
Atlas Genius - Trojans (User: melons)
Matt & Kim - Cameras (User: melons)
Feed Me Jack - Rosies (User: melons)
Amyelle - Push It (User: melons)
Chris Lake - A Drug From God (User: melons)
220 Kid - I'll Take You Down (feat. Chilli Chilton) (User: melons)
Biscits - Wait A Minute (User: melons)
Jess Bays - Cold Love (feat. Jack Hawitt) (User: melons)
Essel - Love Vibration (User: melons)
Shadow Child - The North Quarter (User: melons)
Redlight - Sweat (User: melons)
James Hype - Disconnected (User: melons)
Finn - All About Love - Edit (User: melons)
Ewan McVicar - Back Tae Ayr (User: melons)
Anish Kumar - Blackpool Boulevard - Edit (User: melons)
Ben Kim - Somebody To Love (User: melons)
Chris Lorenzo - California Dreamin' (feat. High Jinx) (User: melons)
Joshwa - My Humps (User: melons)
jobii - Sisu (User: melons)
Nxworries - Intro (User: melons)
347aidan - IDWK (User: melons)
Choker - Jet Stereo (User: melons)
Radiohead - Everything in Its Right Place (User: melons)
Sault - Let Me Go (User: melons)
Half Moon Run - Seasons of Change (User: melons)
Robert Wyatt - Shipbuilding - Remastered in 1998 (User: melons)
Siouxsie and the Banshees - Peek-A-Boo (User: melons)
Explainer - Lorraine (User: melons)
Trouble Funk - Drop The Bomb (User: melons)
Sarah McLachlan - Adia (User: melons)
Shakira - Hips Don't Lie (feat. Wyclef Jean) (User: melons)
Kelly Moran - Love Birds (acoustic) - WXAXRXP Session (User: melons)
Galya Bisengalieva - Tulpar (User: melons)
Lafawndah - Uniform (User: melons)
Zavoloka - Symvol (User: melons)
Akiko Haruna - Raw (User: melons)
Mhysa - before the world ends (User: melons)
object blue - ECSTASY OF ST. TERESA (User: melons)
Lucy Liyou - Uncle (User: melons)
Varg²™ - I Get Lit (cause if not I think of you) (User: melons)
LI YILEI - A Star Without Guidance (User: melons)
rRoxymore - Home Is Where the Music is (User: melons)
Leya - ABBA/Mary - Christina Vantzou Remix (User: melons)
Flora Yin-Wong - Bitterness (User: melons)
Machine Woman - Timbu Limbu And Her War Bass (User: melons)
Ola Szmidt - Spring (User: melons)
Pan Daijing - Clean (User: melons)
Sophia Loizou - Anima (User: melons)
Eartheater - Below the Clavicle (User: melons)
Deena Abdelwahed - Lila Fi Tounes (User: melons)
Klein - Claim It (User: melons)
Such Small Hands - Carousel - The Keep Remix (User: melons)
Nailah Hunter - Enter (User: melons)
Patricia Brennan - Magic Square (User: melons)
Rachel Lyn - Seen Any Monsters Lately? (User: melons)
DJ CLEA - Meditations (User: melons)
Waterbaby - I don't want to sing I don't want to look (User: melons)
Daisy Moon - Chambers (User: melons)
SMERZ - Rain (User: melons)
Susannah Stark - Saturn (User: melons)
Carmen Villain - Two Halves Touching (User: melons)
Loraine James - Insecure Behaviour and Fuckery (User: melons)
Elysia Crampton - Grove (feat. Embaci) (User: melons)
Kaitlyn Aurelia Smith - The Steady Heart (User: melons)
Lisa Lerkenfeldt - In Her Hair (User: melons)
Ana Roxanne - Suite Pour L'invisible (User: melons)
Lyra Pramuk - Witness (User: melons)
object blue - Procession of Healers (User: melons)
Ale Hop - La procesión (User: melons)
Lucrecia Dalt - Nu (User: melons)
Green-House - Sunflower Dance (User: melons)
Faten Kanaan - The North Wind (User: melons)
SMERZ - Max (User: melons)
Felicia Atkinson - Everything Evaporate (User: melons)
Nídia - nik com (User: melons)
Loraine James - Let's go (User: melons)
Grouplove - Ways To Go (User: melons)
Galantis - Runaway (U & I) - Svidden & Jarly Remix; Paper Towns Soundtrack Version (User: melons)
Magic Man - Paris (User: melons)
Carwash - striptease (User: melons)
Harmless - Swing Lynn (User: melons)
Alfie Templeman - Film Scene Daydream (User: melons)
Young MIster - The Best Part (User: melons)
David Das - Candy Crush (User: melons)
Grenn - My Heart Is Still Connected to My Body (User: melons)
MILK. - A Little More (User: melons)
Yot Club - Fly Out West (User: melons)
Gus Dapperton - Ditch (User: melons)
Unclenathannn - Araly (Demo) (User: melons)
LOVING - Visions (User: melons)
Lucette Bourdin - Ocean (User: melons)
Vangelis - Rêve - Remastered (User: melons)
Ambient Endeavors - An Open Door (User: melons)
Alaskan Tapes - Hólar (User: melons)
Bahrambient - 2am Echoes (User: melons)
Night Gestalt - Between Two Breaths (User: melons)
Mjorn - Watchmaker's Shop (User: melons)
Kwajbasket - A Well Deserved Break (User: melons)
Michiru Aoyama - Kuronami (User: melons)
Sirabhorn - Psyconaut (User: melons)
Goodparley - For Ernest Hood - Instrumental (User: melons)
Martijn Comes - Memories of a Southern Childhood (User: melons)
Brian Sangmeister - We Buried Innocence Behind the Old Tool Shed (User: melons)
Cpektir - Thank You to the People in My Life for Putting up With Me (User: melons)
Sensitizer - A.i (User: melons)
scarless arms - Transcience (User: melons)
Brannan Lane - Nature (User: melons)
Saffronkeira - Emanation (User: melons)
Inhmost - Bubble Wrap (User: melons)
Jim Wallis - On Deck (User: melons)
Ian Wong - Rendezvous (User: melons)
Svvn - Time and Space (User: melons)
The Tony Hatch Orchestra - Sportsnight - From 'Hit the Road to Themeland (User: melons)
Pom Poko - Like A Lady (User: melons)
Carlos Ferreira - Settling Vapor (User: melons)
Distant Fires Burning - DFB131 (User: melons)
Orson Carroll - Falling Into Waves (User: melons)
Whettman Chelmets - Faire Apaiser (User: melons)
Angel Ruediger - Elegy (User: melons)
Cholosus - Existence (User: melons)
Alphaxone - Grayland (User: melons)
Sebastian Plano - Silk & Sand (User: melons)
Teruyuki Kurihara - Decay (User: melons)
Bing Satellites - Kites - Ambient World Version (User: melons)
Wolfgang Merx - Choral I (User: melons)
Ryan J Raffa - Memory Field (User: melons)
Dahlia's Tear - Across the Shifting Abyss (User: melons)
Jason Blake - Eyes Above (User: melons)
AndAWan - Time to Remember (User: melons)
Neil Foster - All Things Pass (User: melons)
Seaworthy - Rennix Heath (User: melons)
Angel Ruediger - When I See The Sea - Boardwalk Edit (User: melons)
Spacecraft - Nightfall (User: melons)
Dave Griffiths - Liturgy of the Hours: Matins (User: melons)
Sunwarper - Arctic Horizon (User: melons)
Dear Gravity - Quiesce (User: melons)
Yarbrough & Peoples - Don't Stop The Music (User: melons)
Jacob Jeffries - My Superhero Movie (User: melons)
OR3O - Greedy (User: melons)
CG5 - I See a Dreamer (User: melons)
Simply Three - Counting Stars (User: melons)
The Living Tombstone - My Ordinary Life (User: melons)
ElyOtto - SugarCrash! (User: melons)
Dream - Mask (User: melons)
Dream - Roadtrip (User: melons)
Duncan Laurence - Arcade (User: melons)
Mother Mother - Hayloft (User: melons)
Netta - Toy (User: melons)
just valery - Your Love Is My Drug (8 Bit Slowed) (User: melons)
Penelope Scott - Rät (User: melons)
BadBoyHalo - MUFFIN (User: melons)
Arcade Player - Coconut Mall (From "Mario Kart Wii") (User: melons)
Wilbur Soot - Your New Boyfriend (User: melons)
Tubbo - life by the sea (User: melons)
Cosmo Sheldrake - Pelicans We (User: melons)
The Harmaleighs - I Keep Ticking On (User: melons)
Candle Kid - Waiting For Death (User: melons)
Oldelaf et Monsieur D. - Le Café (User: melons)
Crystal Fighters - Follow (User: melons)
CoCo and the Butterfields - Battlegrounds (User: melons)
Milky Chance - Flashed Junk Mind (User: melons)
Tankus the Henge - Recurring Dream (User: melons)
Pierce Brothers - Amsterdam (User: melons)
Bukahara - No! (User: melons)
Fiddler's Green - One Fine Day (User: melons)
Young Chinese Dogs - Sweet Little Lies (User: melons)
mewithoutYou - The Fox, The Crow And The Cookie (User: melons)
Aliceband - Home (User: melons)
Katzenjammer - To the Sea (User: melons)
The Magic Mumble Jumble - Don’t Forget (User: melons)
Steve ´n´ Seagulls - Self Esteem (User: melons)
The Homeless Gospel Choir - Depression (User: melons)
The Hush Sound - We Intertwined (User: melons)
Cobra Skulls - One Day I'll Never (User: melons)
Bukahara - We Are Still Here! (User: melons)
breathe. - It's Not the End (User: melons)
ill peach - DANDELION (User: melons)
Naylor - Want U (User: melons)
Will Hyde - when u need me. (User: melons)
twocolors - Feel It 2 (User: melons)
House of EL - Push On (User: melons)
Elias Boussnina - Been Fru (User: melons)
Ralph Castelli - Rare (User: melons)
Fyfe - Looks The Same (User: melons)
FLØRE - Another year like that and we'd all be dead - Stripped (User: melons)
Emily Nance - Softer Still (User: melons)
Jlin - Connect The Dots (User: melons)
Morning Midnight - River (User: melons)
Jaie - Won't You Stay (User: melons)
yUuL - Feel - with Kyson (User: melons)
FLORES - Fool's Gold (User: melons)
Flaws - Saturday Evening (User: melons)
Girlpool - Faultline (User: melons)
MEYY - Rain (User: melons)
James Gillespie - Smile (User: melons)
Alyss - Kandy (User: melons)
Ruel - GROWING UP IS _____ (User: melons)
Aeris Roves - Long Way Down (User: melons)
YoungR - Back 2 U (User: melons)
daisy world - picnic (User: melons)
danny dwyer - Brokenhearted (User: melons)
Cruza - Brewster (User: melons)
Hotel Ugly - Stevie Doesn't Wonder (User: melons)
Isaia Huron - One in a Million (User: melons)
noteaf - Kosmichni (User: melons)
Clear Eyes - no place i'd rather be (User: melons)
Toyko - Grown up Money (User: melons)
Skøien - Breathe (User: melons)
Lucky Daye - Candy Drip (User: melons)
Anna Shoemaker - Change My Mind (User: melons)
Lannds - HITEM (User: melons)
R i v i e r a - Kids (User: melons)
MAX - Butterflies (feat. FLETCHER) (User: melons)
Maie - Like You (User: melons)
Julielle - bad news (User: melons)
Elohim - I Need a Doctor (User: melons)
EXES - it was supposed to be us (User: melons)
Julia Wolf - In My Way (chi sei) (User: melons)
Astrid S - Pretty (User: melons)
Dirty Beaches - True Blue (User: melons)
Peder Mannerfelt - Limits to Growth (User: melons)
DVA Damas - In The Clear (User: melons)
