Regina Spektor - Bleeding Heart (User: jbwharris)
Jordan Klassen - Baby Moses (User: jbwharris)
Dear Criminals - slowdisco (User: jbwharris)
Low Roar - Bones (User: jbwharris)
My Brightest Diamond - Pressure (User: jbwharris)
Nick Cave & the Bad Seeds - Rings of Saturn (User: jbwharris)
Dirty Projectors - Little Bubble (User: jbwharris)
Lambchop - Relatives #2 (User: jbwharris)
Dan Mangan + Blacksmith - Forgetery (User: jbwharris)
Thus Owls - As Long As We Try A Little (User: jbwharris)
Bon Iver - 33 “GOD” (User: jbwharris)
These Brittle Bones - Numb (User: jbwharris)
Møme - Why Is It (User: jbwharris)
Timber Timbre - Velvet Gloves & Spit (User: jbwharris)
Santigold - Chasing Shadows (User: jbwharris)
Frightened Rabbit - Death Dream (User: jbwharris)
The Verve - The Rolling People (Live From The Haigh Hall Concert Hall) (User: jbwharris)
Talking Heads - Crosseyed and Painless (User: jbwharris)
JJ Wilde - Best Boy (User: jbwharris)
Garbage - Stupid Girl (User: jbwharris)
The Odds - Heterosexual Man (User: jbwharris)
The Stone Roses - Fools Gold (User: jbwharris)
The Stranglers - Always the Sun (User: jbwharris)
Ryuichi Sakamoto - thatness and thereness (2019 Remastering) (User: jbwharris)
Ewun - The Divide (User: jbwharris)
The Mountain Goats - Done Bleeding (User: jbwharris)
Stars - Going, Going, Gone (User: jbwharris)
187 Lockdown vs. 20 Fingers - Short Gun Man (User: jbwharris)
Cracker - Guarded By Monkeys (User: jbwharris)
Viagra Boys - In Spite of Ourselves (feat. Amy Taylor) (User: jbwharris)
HAIM - Don't Wanna (User: jbwharris)
TV on the Radio - Staring At The Sun (User: jbwharris)
The Black Crowes - Evergreen (User: jbwharris)
The Verve - History (User: jbwharris)
Ben Folds - Careless Whisper (Live Mountain Winery, Saratoga, CA) [with Rufus Wainwright] (User: jbwharris)
A.C. Newman - I'm Not Talking (User: jbwharris)
Interpol - Success (User: jbwharris)
Black Rebel Motorcycle Club - Mercy (live) (User: jbwharris)
Cobra Man - Heatwave (User: jbwharris)
U2 - Lemon (User: jbwharris)
Spoon - You Got Yr. Cherry Bomb (User: jbwharris)
Fløris - Guns For Hire (User: jbwharris)
The Russian Futurists - Extro (User: jbwharris)
U2 - Sunday Bloody Sunday (User: jbwharris)
Jimmy Work - Making Believe (User: jbwharris)
Taylor Swift - We Are Never Ever Getting Back Together (User: jbwharris)
falcxne - Wet (User: jbwharris)
The War on Drugs - Lost in the Dream (User: jbwharris)
Glass Animals - Heat Waves (User: jbwharris)
Vector Burn - Paradise Lost (D-Star Remix) (User: jbwharris)
Jimmy 'Bo' Horne - Is It In (User: jbwharris)
Tones and I - Dance Monkey (Stripped Back) (User: jbwharris)
lkffct - Chipping Paint (User: jbwharris)
Phil Collins - In the Air Tonight (User: jbwharris)
Rebekka Karijord, Jessica Dessner, Complete Mountain Almanac, Bryce Dessner & Aaron Dessner - February (User: jbwharris)
Crystal Castles - Not in Love (User: jbwharris)
Yello - Oh Yeah (User: jbwharris)
The Clash - Should I Stay or Should I Go (User: jbwharris)
Chalk Circle - April Fool (User: jbwharris)
David Bowie - Space Oddity (User: jbwharris)
Walk Off the Earth - Red Hands (User: jbwharris)
New Order - Bizarre Love Triangle (User: jbwharris)
The Lowest of the Low - Salesmen, Cheats and Liars (User: jbwharris)
Simple Minds - Up On the Catwalk (User: jbwharris)
Freischwimmer - California Dreamin (User: jbwharris)
Valerie June - Smile (User: jbwharris)
Nirvana - Molly's Lips (User: jbwharris)
Bleachers - I Miss Those Days (User: jbwharris)
Deltron 3030 - Battlesong (User: jbwharris)
Field Music - You're So Pretty (User: jbwharris)
Sloan - Over You (User: jbwharris)
Doughboys - Long Hall (User: jbwharris)
geom - Back to You (User: jbwharris)
Rhye - Black Rain (User: jbwharris)
The Crusaders - Soul Shadows (User: jbwharris)
Andra Day - Strange Fruit (User: jbwharris)
Mighty Sam McClain - Georgia Pines (User: jbwharris)
Ron Gallo - Young Lady, You're Scaring Me (User: jbwharris)
Men I Trust - 5am Waltz (User: jbwharris)
Antony & Bryce Dessner - I Was Young When I Left Home (User: jbwharris)
The Fratellis - Henrietta (User: jbwharris)
Frank Turner - The Gathering (User: jbwharris)
Beach House - Masquerade (User: jbwharris)
Sven Libaek - Open Sea Theme (User: jbwharris)
Romero - Crossing Lines (User: jbwharris)
Panic! at the Disco - I Write Sins, Not Tragedies (User: jbwharris)
Deadbeats - Funky For You (Dorfmeister VS Madrid De Los Austrias Remix) (User: jbwharris)
Stevie Wonder - Can I Get A Witness (User: jbwharris)
Lewis Wake - Hypno Chaise Longue (Wet Leg vs. Rezz & deadmau5) (User: jbwharris)
Thundercat - Unrequited Love (User: jbwharris)
Rheostatics - Claire (User: jbwharris)
Aimee Mann - Nothing Is Good Enough (User: jbwharris)
Overcoats - Hold Me Close (User: jbwharris)
Cansei de Ser Sexy - Music Is My Hot Hot Sex (User: jbwharris)
Role Model - alive (User: jbwharris)
The Beaches - T-Shirt (User: jbwharris)
Double Grave - The Farm (User: jbwharris)
Mumford & Sons - I Will Wait (User: jbwharris)
Ryan Adams - Dirty Rain (User: jbwharris)
Bakslash - Tainted Love (Minimal Chic Mix) (User: jbwharris)
Rhye - Beautiful (feat. Lewis OfMan) [Lewis Ofman Remix] (User: jbwharris)
The xx - Try (User: jbwharris)
Wintersleep - Migration (User: jbwharris)
David Guetta - I'm Good (User: jbwharris)
Lil Nail Tech - First Class (User: jbwharris)
MacKenzie Porter - These Days (User: jbwharris)
Bush - The Chemicals Between Us (User: jbwharris)
Bedouin Soundclash - They Gutted This City (User: jbwharris)
Soul Asylum - Misery (Single Version) (User: jbwharris)
The Sonics - The Witch (User: jbwharris)
Belle and Sebastian - The Party Line (User: jbwharris)
Still Woozy - Habit (User: jbwharris)
I, the Mountain - Bare Hands (User: jbwharris)
Blur - Country House (User: jbwharris)
The Box - L'affaire Dumoutier (User: jbwharris)
Devo - Through Being Cool (User: jbwharris)
Rapsody - Whoopi (User: jbwharris)
The Novaks - I'll Give You A Ring (User: jbwharris)
Jason Isbell and The 400 Unit - Sad But True (User: jbwharris)
Howie Beck - I Need Light (User: jbwharris)
Clairo - Flaming Hot Cheetos (User: jbwharris)
Matthew Good Band - Apparitions (User: jbwharris)
Cassius - Vedra (User: jbwharris)
Shiro Schwarz - Electrify (User: jbwharris)
Asobi Seksu - Thursday (User: jbwharris)
Holy Fuck - Safari (User: jbwharris)
Basia Bulat - Love is at the End of the World (User: jbwharris)
Half Moon Run - Need It (User: jbwharris)
System of a Down - Protect the Land (User: jbwharris)
Split System - Climbing (User: jbwharris)
Yola - Dancing Away in Tears (User: jbwharris)
The Japanese House - Saw You in a Dream (User: jbwharris)
The Cure - Killing an Arab (User: jbwharris)
Bob Marley & The Wailers - Stir It Up (User: jbwharris)
Widowspeak - Even True Love (User: jbwharris)
Hether - Sex Wax (User: jbwharris)
Digable Planets - La Femme Fetal (User: jbwharris)
The Shins - The Great Divide (User: jbwharris)
Orgy - Blue Monday (User: jbwharris)
The Black Keys - Tighten Up (User: jbwharris)
Oh Wonder - Without You (User: jbwharris)
The Super Friendz - 10 Lbs. (User: jbwharris)
Dan Mangan - Just Know It (User: jbwharris)
Roy Ayers Ubiquity - Ain't No Sunshine (User: jbwharris)
Jukebox the Ghost - I Love You Always Forever (User: jbwharris)
Dusty Springfield - Spooky (User: jbwharris)
Dead Man's Bones - In the Room Where You Sleep (User: jbwharris)
Snow Patrol - Make This Go on Forever (User: jbwharris)
Jessie Reyez - ROOF (User: jbwharris)
Leonard Cohen - Everybody Knows (User: jbwharris)
Mr. Scruff - Valley Of The Sausages (feat. Sneaky & Seaming To) (User: jbwharris)
Fine Young Cannibals - Johnny Come Home (User: jbwharris)
Jake Xerxes Fussell - Love Farewell (User: jbwharris)
NAVVI - Dopamine (User: jbwharris)
Joy Division - Twenty Four Hours (User: jbwharris)
Roxy Music - Love Is the Drug (User: jbwharris)
Fontaines D.C. - I Love You (User: jbwharris)
Rosalie Deighton - Wagon Wheel (These Days) (User: jbwharris)
Yeah Yeah Yeahs - Heads Will Roll (User: jbwharris)
Wild Nothing - Dizziness (User: jbwharris)
Sally Anthony - Today Is Not Tomorrow (User: jbwharris)
Juliana Hatfield - Mouthful of Blood (User: jbwharris)
Bloody Civilian feat. Rema - Wake Up (User: jbwharris)
Massive Attack - Radiation Ruling the Nation (Protection) (User: jbwharris)
Our Lady Peace - Future Disease (User: jbwharris)
DJ Spooky - Degree Zero (User: jbwharris)
Lee “Scratch” Perry - Black Spell (User: jbwharris)
The Gun Club - Promise Me (User: jbwharris)
Modest Mouse - Gravity Rides Everything (User: jbwharris)
Ruby Goon - Spicy Space Pasta (User: jbwharris)
Orchestra Gold - Keleya (User: jbwharris)
Makaya McCraven - This Place That Place (User: jbwharris)
Dumb - Watch This Drive (User: jbwharris)
Death - You're A Prisoner (User: jbwharris)
Sault - Above The Sky (User: jbwharris)
JAY-Z - Can't Knock The Hustle (User: jbwharris)
Algiers - Bite Back (User: jbwharris)
Homeboy Sandman - Satellite (User: jbwharris)
Nina Simone - Baltimore (User: jbwharris)
King Gizzard & The Lizard Wizard - No Body (User: jbwharris)
King Missile - Jesus Was Way Cool (User: jbwharris)
Black Marble - Somewhere (User: jbwharris)
Yves Tumor - God Is a Circle (User: jbwharris)
Faithless - Insomnia (User: jbwharris)
Enola - Metal Body (User: jbwharris)
Chain Wallet - Abroad (User: jbwharris)
Ladytron - City of Angels (User: jbwharris)
Gil Scott-Heron - Lady Day and John Coltrane (User: jbwharris)
Fatoumata Diawara featuring Damon Albarn - Nsera (User: jbwharris)
Guru - Le Bien, Le Mal (User: jbwharris)
Guru - loungin’ (User: jbwharris)
Jockstrap - Greatest Hits (User: jbwharris)
Model Shop - Letters To Melissa (User: jbwharris)
Throwing Muses - Two Step (User: jbwharris)
Bonobo - Flutter (User: jbwharris)
Jungle - PROBLEMZ (User: jbwharris)
Gorillaz feat. Tame Impala and Bootie Brown - New Gold (User: jbwharris)
St. Vincent - Masseduction (User: jbwharris)
L'Rain - Two Face (User: jbwharris)
SZA - Good Days (User: jbwharris)
The Haunted Youth - Broken (User: jbwharris)
Brittany Howard - You And Your Folks, Me And My Folks (Recorded At East West Studios) (User: jbwharris)
Funkadelic - Can You Get to That (User: jbwharris)
Sleigh Bells - Rill Rill (User: jbwharris)
Sault - Heal The World (User: jbwharris)
Chancha Vía Circuito - Monolina (User: jbwharris)
Santigold - Fall First (User: jbwharris)
Tom Vek - C-C (You Set The Fire In Me) (User: jbwharris)
The Murder Capital - Only Good Things (User: jbwharris)
Beck - Black Tambourine (User: jbwharris)
Bad Colours - Watch Your Tone (User: jbwharris)
Khruangbin & Leon Bridges - B-Side (User: jbwharris)
Shaolinn - Cherish (User: jbwharris)
Shannon and the Clams - Do I Wanna Stay (User: jbwharris)
Caroline Polachek - Welcome to My Island (User: jbwharris)
Siouxsie and the Banshees - Cities in Dust (User: jbwharris)
Oliver Sim - Romance With A Memory (User: jbwharris)
Destroyer - Kaputt (User: jbwharris)
Quasi - Doomscrollers (User: jbwharris)
The Ting Tings - Great DJ (User: jbwharris)
Johnny Boy - You Are the Generation That Bought More Shoes and You Get What You Deserve (User: jbwharris)
The Ronettes - Be My Baby (User: jbwharris)
Bat for Lashes - What’S A Girl To Do? (User: jbwharris)
Lucky Lo - I Will Always Be You (User: jbwharris)
Big Joanie - Your Words (User: jbwharris)
Edwyn Collins - A Girl Like You (User: jbwharris)
Matthew Sweet - Girlfriend (User: jbwharris)
Lenny Kravitz - Are You Gonna Go My Way (User: jbwharris)
Iggy Pop - The Passenger (User: jbwharris)
The Golden Dregs - American Airlines (User: jbwharris)
Nation of Language - Rush & Fever (User: jbwharris)
Peter Gabriel - Panopticom (Bright Side Mix) (User: jbwharris)
INXS - Kiss The Dirt (Falling Down The Mountain) (User: jbwharris)
The The - Uncertain Smile (User: jbwharris)
The New Pornographers - Really Really Light (User: jbwharris)
Wet Leg - Oh No (User: jbwharris)
The Linda Lindas - Oh! (User: jbwharris)
Caution - To Decide (User: jbwharris)
The Breeders - Invisible Man (User: jbwharris)
Nakhane - My Ma Was Good (User: jbwharris)
Elvis Costello - Alison (User: jbwharris)
Sandra Kolstad - Run Away (Where Are We?) (User: jbwharris)
Janet Jackson - Escapade (User: jbwharris)
TV on the Radio - Yr God (User: jbwharris)
Tuns - Mind Over Matter (User: jbwharris)
The Beloved - Sweet Harmony (User: jbwharris)
David Bowie - Heroes (User: jbwharris)
The Northern Pikes - Things I Do For Money (User: jbwharris)
Our Lady Peace - Starseed (User: jbwharris)
The Lemonheads - Mrs. Robinson (User: jbwharris)
The Cure - Let's Go to Bed (User: jbwharris)
Garbage - Only Happy When It Rains (User: jbwharris)
Holy Fuck - Free Gloss (feat. Nicholas Allbrook) (User: jbwharris)
Charlotte Day Wilson - Keep Moving (User: jbwharris)
Broken Social Scene - This House is On Fire (User: jbwharris)
Hannah Georgas - That Emotion (User: jbwharris)
Tanya Tagaq - Teeth Agape (User: jbwharris)
Joel Plaskett Emergency - Nowhere With You (User: jbwharris)
ging - Can You See Me (User: jbwharris)
maxime. - rubber ‎checks (User: jbwharris)
Lowell - God Is A Fascist (User: jbwharris)
Babygirl - You Were in My Dream Last Night (User: jbwharris)
OMBIIGIZI, Status/Non-Status & Zoon - Cherry Coke (User: jbwharris)
New West - Kids Who Stole The World (User: jbwharris)
fanclubwallet - That I Won't Do (User: jbwharris)
Stars - Pretenders (User: jbwharris)
Andy Shauf - Satan (User: jbwharris)
MorMor - Won't Let You (User: jbwharris)
Ada Lea - can't stop me from dying (User: jbwharris)
Grimes - Shinigami Eyes (User: jbwharris)
Half Moon Run - Favourite Boy (User: jbwharris)
Aviv - You Feel Like Depression (User: jbwharris)
Metric - Synthetica (User: jbwharris)
PUP - Robot Writes a Love Song (User: jbwharris)
Ducks Ltd. - Sheets Of Grey (User: jbwharris)
Luna Li & beabadoobee - Silver Into Rain (User: jbwharris)
Arcade Fire - The Lightning I, II (User: jbwharris)
Tim Baker - Dance (User: jbwharris)
Sister Ray - Crucified (User: jbwharris)
Deanna Petcoff - Devastatingly Mediocre (User: jbwharris)
Marci - Entertainment (User: jbwharris)
Dizzy - Sunflower (User: jbwharris)
Patrick Watson & La Force - Height of the Feeling (User: jbwharris)
Chastity - Pummeling (User: jbwharris)
Jaunt - Nostalgia For The Present Moment (User: jbwharris)
Helena Deland - Swimmer (User: jbwharris)
Broken Social Scene - This House is On Fire (User: jbwharris)
Destroyer - It Takes a Thief (User: jbwharris)
fanclubwallet - Car Crash in G Major (User: jbwharris)
Grae - Boxes (User: jbwharris)
ging - Can You See Me (User: jbwharris)
Frog Eyes - When You Turn on the Light (User: jbwharris)
The Zolas - Swooner (User: jbwharris)
Charlotte Day Wilson - Keep Moving (User: jbwharris)
Stars - Pretenders (User: jbwharris)
Sleep.Ing & Dave Faber - Flood (User: jbwharris)
Nap Eyes - Mystery Calling (User: jbwharris)
Orville Peck - C'mon Baby, Cry (User: jbwharris)
OMBIIGIZI, Status/Non-Status & Zoon - Cherry Coke (User: jbwharris)
Matt Mays & El Torpedo - Tall Trees (User: jbwharris)
NxWorries, Anderson .Paak & Knxwledge - Suede (User: jbwharris)
Aaron Frazer - If I Got It (Your Love Brought It) (User: jbwharris)
Jitwam - whereyougonnago? (User: jbwharris)
Still Woozy - Habit (User: jbwharris)
Warpaint - Champion (6 Music Session, 4 May 2022) (User: jbwharris)
Silk - I Can't Stop (Turning You On) (User: jbwharris)
Katie Tupper - Live Inside (User: jbwharris)
Bluestaeb, Mick Jenkins & Aréna - MOVIN' (User: jbwharris)
Hannah Williams - Late Nights & Heartbreak (User: jbwharris)
Hush Forte, AaRON & Myquale - DOMINICANA (User: jbwharris)
Quelle Chris - Alive Ain't Always Living (User: jbwharris)
13th Ward Social Club - Tigress (User: jbwharris)
Daphni - Cloudy (User: jbwharris)
Yasuko Agawa - L.A. Night (User: jbwharris)
Swindle - What More (feat. Greentea Peng) (User: jbwharris)
All Day Breakfast Cafe - What if Nile Rodgers and Fela Kuti Were Friends (User: jbwharris)
Raf Rundell - More U Know (User: jbwharris)
Brién - Sundried (User: jbwharris)
Gorillaz - Baby Queen (User: jbwharris)
Joel St. Julien - Where I am (User: jbwharris)
The Black Ryder - Let Me Be Your Light (User: jbwharris)
Jo Beth Young - Adversity (User: jbwharris)
Decadance - On And On (Fears Keep On) (User: jbwharris)
Drab Majesty - Oxytocin (User: jbwharris)
Fever Ray - Dry and Dusty (User: jbwharris)
Kendrick Lamar & SZA - All the Stars (User: jbwharris)
Eartheater - Supersoaker (User: jbwharris)
Ash Ra Tempel - Deep Distance (User: jbwharris)
Vangelis - Tears in Rain (User: jbwharris)
Brian Reitzell - Love Crime from the Wrath of the Lamb (feat. Siouxsie Sioux) (User: jbwharris)
Jóhann Jóhannsson - Mandy Love Theme (User: jbwharris)
Mogwai - Funeral Pyre (User: jbwharris)
New Order - Dreams Never End (User: jbwharris)
The Joe Cuba Sextet - La Palomilla (User: jbwharris)
Robert Glasper - All Masks (feat. Masego) (User: jbwharris)
The Chemical Brothers - Morning Lemon,Mars Needs Women,Thunder,Losing Control (User: jbwharris)
Francis of Delirium - Come Out And Play (User: jbwharris)
twenty one pilots - Saturday (User: jbwharris)
Arctic Monkeys - There’d Better Be a Mirrorball (User: jbwharris)
The Red Jumpsuit Apparatus - Face Down (User: jbwharris)
Portugal. The Man - Feel It Still (User: jbwharris)
"Weird Al" Yankovic - Now You Know (User: jbwharris)
Circa Waves - The Aisles of Strange (User: jbwharris)
Dispatch - Skin the Rabbit (User: jbwharris)
All Time Low - Sleepwalking (User: jbwharris)
Neutral Milk Hotel - In the Aeroplane Over the Sea (User: jbwharris)
Yeah Yeah Yeahs - Wolf (User: jbwharris)
The Little Ones - Boracay (User: jbwharris)
Death Cab for Cutie - Pepper (User: jbwharris)
Death by Unga Bunga - I Wanted Everything (User: jbwharris)
Silversun Pickups - Scared Together (User: jbwharris)
The Redwalls - Modern Diet (User: jbwharris)
Tokyo Police Club - Feel The Effect (User: jbwharris)
George Ezra - Budapest (User: jbwharris)
HAIM - The Wire (User: jbwharris)
American Teenager - Ethel Cain (User: jbwharris)
Wet - Old Bone (Jim-E Stack Remix) (User: jbwharris)
The Fall - Hey! Luciani (User: jbwharris)
Tiësto - Ritual (User: jbwharris)
Sasha Lopez - All my people (User: jbwharris)
Foals - 2am (User: jbwharris)
Hunter Brothers - Santa Claus Is Coming to Town (User: jbwharris)
Thundercat - Them Changes (User: jbwharris)
Melissa Etheridge - Like The Way I Do (User: jbwharris)
Venetian Snares - Bebikukorica Nigiri (User: jbwharris)
Kim Carnes - Bette Davis Eyes (User: jbwharris)
Toro y Moi - Goes By So Fast (User: jbwharris)
The Fire Theft - It's Over (User: jbwharris)
Arkells - Private School (User: jbwharris)
Selmer - Thinkin' Freely (User: jbwharris)
Soulwax vs. A-Ha - (The Sun Always Shines) On a Miserable Boy (User: jbwharris)
Neil Cicierega - Numbers (User: jbwharris)
Porter Wagoner & Dolly Parton - Better Move It on Home (User: jbwharris)
Steve Lawrence - Last Night I Made A Little Girl Cry (User: jbwharris)
NRBQ - Macho Maria (User: jbwharris)
Guitar Slim Green - Shake 'Em Up (User: jbwharris)
Marvin Rainwater - Down in the Cellar (User: jbwharris)
Strangers, The - Jennifer Eccles (User: jbwharris)
First Base - If I See You With That Girl Again (User: jbwharris)
Millie Jackson - Hurts So Good (User: jbwharris)
Glenn Thompson - What a line (User: jbwharris)
Matt Lucas - Water Moccasin (User: jbwharris)
Dave Edmunds - Never Been in Love (User: jbwharris)
LaVern Baker - Itty Bitty Girl (User: jbwharris)
Herbie Mann - The Night Before (User: jbwharris)
Joe Tex - Show Me (User: jbwharris)
Roger Miller - It Happened Just That Way (User: jbwharris)
Del Ashley - Little Miss Stuck Up (User: jbwharris)
roy meriwether trio - Zip-A-Dee-Doo-Dah (User: jbwharris)
The Hood Internet - 1979 (User: jbwharris)
Aperture Science Psychoacoustics Laboratory - Want You Gone (User: jbwharris)
David Wise - Aquatic Ambience (User: jbwharris)
Gunhild Carling - Bagpipe Blues (User: jbwharris)
Ricardo Lemvo & Makina Loca - Nono Femineh (User: jbwharris)
東京スカパラダイスオーケストラ - Baby Elephant Walk / Sesame Street (User: jbwharris)
Bill loko - nen lambo (User: jbwharris)
Pomplamoose - Jamiroquai Bee Gees Mashup (User: jbwharris)
Fats Domino - Swanee River Hop (User: jbwharris)
Darrell Labrado - Da Kine (User: jbwharris)
矢野顕子 - Kuma (User: jbwharris)
Ayane Yamazaki - Mimosa (User: jbwharris)
Takeo Ishii - New Bibi Hendl (Chicken Yodeling) (User: jbwharris)
Beat Okamine - An Utau Can Yodel (User: jbwharris)
Katamari Damacy - Lonely Rolling Star (User: jbwharris)
Simple Simon - Bawling (User: jbwharris)
Cory Henry - The Revival Project (User: jbwharris)
Cory Henry & Nick Semrad - Full Jam session at NAMM 2016 (User: jbwharris)
Vulfpeck - Back Pocket (User: jbwharris)
Scary Pockets - If Vulfpeck wrote MMMBop by Hanson (User: jbwharris)
Kurs Valüt - Kurs Valüt (User: jbwharris)
Cut Copy - Hearts On Fire (User: jbwharris)
James And The Cold Gun - Chewing Glass (User: jbwharris)
The Bug Club - Love is a Painting (User: jbwharris)
New Pagans - Better People (User: jbwharris)
The Cranberries - Zombie (User: jbwharris)
Nia Archives - So Tell Me… (User: jbwharris)
Little Simz - Heart On Fire (User: jbwharris)
Joyce - R.U.R. (User: jbwharris)
Francis of Delirium - The Funhouse (User: jbwharris)
Moreish Idols - Speedboat (User: jbwharris)
Dry Cleaning - Gary Ashby (User: jbwharris)
Qlowski - Folk Song (User: jbwharris)
Wet Leg - Too Late Now (Soulwax Remix) (User: jbwharris)
TSHA feat. Clementine Douglas - Dancing In The Shadows (User: jbwharris)
Gorillaz feat. Tame Impala and Bootie Brown - New Gold (Dom Dolla remix) (User: jbwharris)
Talk Talk - It’s My Life (User: jbwharris)
Peter Gabriel - Panopticom (User: jbwharris)
Alina Pash - Bosorkanya (User: jbwharris)
Sudan Archives - NBPQ (Topless) (User: jbwharris)
M.I.A. - Visa (User: jbwharris)
Songø - Tsibiri (User: jbwharris)
Sex Pistols - EMI (User: jbwharris)
AC/DC - Back in Black (User: jbwharris)
Pop Will Eat Itself - Can U Dig It? (User: jbwharris)
LCD Soundsystem - new body rhumba (from the film White Noise) (User: jbwharris)
Jungle by Night - Multi Beam (User: jbwharris)
Khruangbin & Felix Dickinson - Time (You and I) (Put a Smile on DJ’s Face Mix) (User: jbwharris)
Khruangbin - Time (You and I) (User: jbwharris)
Dj Bacon - Breathe and Stop (User: jbwharris)
Thione Seck - Talibi (User: jbwharris)
Orchestra Baobab - Aline (User: jbwharris)
Youssou N’Dour - Xale Yi Rew Mi (User: jbwharris)
John Coltrane - Dakar (User: jbwharris)
Tyler, the Creator - EARFQUAKE (User: jbwharris)
Sault - Glory (User: jbwharris)
Buffalo Daughter - Socks, Drugs and Rock'n'roll (User: jbwharris)
Fievel Is Glauque - Clues Not To Read (User: jbwharris)
Dionne Warwick - Walk On By (User: jbwharris)
Doja Cat - Celebrity Skin (User: jbwharris)
Hemlocke Springs - girlfriend (User: jbwharris)
Kendrick Lamar, Blxst & Amanda Reifer - Die Hard (User: jbwharris)
Honey Dijon - Love Is A State Of Mind (User: jbwharris)
Animal Collective - Guys Eyes (User: jbwharris)
Sault - Spirit High (User: jbwharris)
Little Simz - Sideways (User: jbwharris)
Queen Latifah - Wrath Of My Madness (User: jbwharris)
Thee Sacred Souls - Future Lover (User: jbwharris)
Bakar - Hell N Back (User: jbwharris)
Brutus - What Have We Done (User: jbwharris)
MIYNT - Lonely beach (User: jbwharris)
The 1975 - Happiness (User: jbwharris)
Don McLean - American Pie (User: jbwharris)
Guerilla Toss - Excitable Girls (User: jbwharris)
MIYNT - Lonely beach (User: jbwharris)
Narrow Head - T.W.I.N. (User: jbwharris)
Sudan Archives - Selfish Soul (User: jbwharris)
Narrow Head - T.W.I.N. (User: jbwharris)
Dry Cleaning - Icebergs (User: jbwharris)
Angel Olsen - Big Time (User: jbwharris)
N0V3L - Group Disease (User: jbwharris)
Vitamin D - Another Day (User: jbwharris)
Deltron 3030 - Things You Can Do (User: jbwharris)
Broadcast - the note (message from home) (User: jbwharris)
The Smile - Thin Thing (Live at Montreux Jazz Festival) (User: jbwharris)
Been Stellar - Kids 1995 (User: jbwharris)
Sudan Archives - Selfish Soul (User: jbwharris)
Been Stellar - Kids 1995 (User: jbwharris)
Momma - Tall Home (User: jbwharris)
VHS Collection - Survive (User: jbwharris)
Momma - Tall Home (User: jbwharris)
VHS Collection - Survive (User: jbwharris)
Beach Bunny - Entropy (User: jbwharris)
Beach Bunny - Entropy (User: jbwharris)
Low - What Part of Me (User: jbwharris)
Low - Gentle (User: jbwharris)
Low - Do You Know How To Waltz (User: jbwharris)
Low - Slide (User: jbwharris)
Low - Throw Out the Line (User: jbwharris)
Low - Especially Me (User: jbwharris)
Low - Tonight (User: jbwharris)
Low - Breaker (User: jbwharris)
Low - Step (User: jbwharris)
Low - Immune (User: jbwharris)
Low - Laser Beam (User: jbwharris)
Low - Just Make It Stop (User: jbwharris)
Low - Hatchet (User: jbwharris)
Low - Disarray (User: jbwharris)
Low - Days Like These (User: jbwharris)
Low - California (User: jbwharris)
Low - Canada (User: jbwharris)
Low - Over the Ocean (User: jbwharris)
Low - Tired (User: jbwharris)
Low - Dancing and Blood (User: jbwharris)
Low - Sunflower (User: jbwharris)
Low - Witches (User: jbwharris)
Low - Disappearing (User: jbwharris)
Low - Fly (User: jbwharris)
Low - Dinosaur Act (User: jbwharris)
Low - Lullaby (User: jbwharris)
Low - Caroline (User: jbwharris)
Andrew Bernstein - in flux (excerpt) (User: jbwharris)
Andrew Bernstein - in flux (excerpt) (User: jbwharris)
Ammothea - Your Spirit Chokes (User: jbwharris)
700 Bliss - Bless Grips (User: jbwharris)
Ammothea - Your Spirit Chokes (User: jbwharris)
700 Bliss - Bless Grips (User: jbwharris)
0decathexis0 - little mermaid with a hook still stuck in her jaw (User: jbwharris)
0decathexis0 - little mermaid with a hook still stuck in her jaw (User: jbwharris)
Tiësto - Hot in It (User: jbwharris)
Sacred Son - Le Blakheth (User: jbwharris)
Tiësto - Hot in It (User: jbwharris)
Sacred Son - Le Blakheth (User: jbwharris)
Cloud Rat - Dropping from the Trees - B's Don't Bother Just End It Mix (User: jbwharris)
Cloakroom - Doubts (User: jbwharris)
Cloud Rat - Dropping from the Trees - B's Don't Bother Just End It Mix (User: jbwharris)
Cloakroom - Doubts (User: jbwharris)
N3ptune - MILITIA - 2.0 (User: jbwharris)
umru - heart2 (User: jbwharris)
N3ptune - MILITIA - 2.0 (User: jbwharris)
umru - heart2 (User: jbwharris)
Sadness - late spring true love (User: jbwharris)
The Body - Miserable Freedom (User: jbwharris)
Sadness - late spring true love (User: jbwharris)
The Body - Miserable Freedom (User: jbwharris)
HO99O9 - BATTERY NOT INCLUDED (User: jbwharris)
HO99O9 - BATTERY NOT INCLUDED (User: jbwharris)
LustSickPuppy - BOY DESTROYER (User: jbwharris)
LustSickPuppy - BOY DESTROYER (User: jbwharris)
Holy Fawn - Death Is A Relief (User: jbwharris)
ROSALÍA - SAOKO (User: jbwharris)
Holy Fawn - Death Is A Relief (User: jbwharris)
ROSALÍA - SAOKO (User: jbwharris)
Gleemer - Backlog (User: jbwharris)
Narrow Head - T.W.I.N. (User: jbwharris)
Gleemer - Backlog (User: jbwharris)
Narrow Head - T.W.I.N. (User: jbwharris)
Bleach Lab - Take It Slow (User: jbwharris)
Bleach Lab - Take It Slow (User: jbwharris)
Lucy Daydream - 1000 Days (User: jbwharris)
MIYNT - Aria (User: jbwharris)
Lucy Daydream - 1000 Days (User: jbwharris)
Billy Howerdel - Free And Weightless (User: jbwharris)
MIYNT - Aria (User: jbwharris)
Billy Howerdel - Free And Weightless (User: jbwharris)
Just Mustard - Still (User: jbwharris)
Just Mustard - Still (User: jbwharris)
✝✝✝ (Crosses) - Sensation (User: jbwharris)
Francis of Delirium - The Funhouse (User: jbwharris)
✝✝✝ (Crosses) - Sensation (User: jbwharris)
Thyla - Breathe (User: jbwharris)
Francis of Delirium - The Funhouse (User: jbwharris)
Thyla - Breathe (User: jbwharris)
Silversun Pickups - Alone on a Hill (User: jbwharris)
Silversun Pickups - Alone on a Hill (User: jbwharris)
Goon - Emily Says (User: jbwharris)
Silversun Pickups - Alone on a Hill (User: jbwharris)
Soft Kill - Always Running (User: jbwharris)
Goon - Emily Says (User: jbwharris)
Soft Kill - Always Running (User: jbwharris)
Hatchie - Lights On (User: jbwharris)
Swim Deep - Worlds Unluckiest Guy (User: jbwharris)
Hatchie - Lights On (User: jbwharris)
Swim Deep - Worlds Unluckiest Guy (User: jbwharris)
Snarls - After You (Samantha's Song) (User: jbwharris)
Egoism - For Ages (User: jbwharris)
Snarls - After You (Samantha's Song) (User: jbwharris)
girlhouse - a long december (User: jbwharris)
Egoism - For Ages (User: jbwharris)
girlhouse - a long december (User: jbwharris)
Willy Moon - Yeah Yeah (User: jbwharris)
Daft Punk - Indo Silver Club (User: jbwharris)
Feli Colina - Chakatrunka (feat. Valentina Brishantina) (User: jbwharris)
Julian Casablancas - Tourist (User: jbwharris)
The Cars - You're All I've Got Tonight (User: jbwharris)
Goldfrapp - Ooh La La (When Andy Bell Met Manhattan Clique Remix) (User: jbwharris)
The Stone Roses - Elizabeth My Dear (Kinobe Remix) (User: jbwharris)
Jackson Browne - Take It Easy (User: jbwharris)
Barry Louis Polisar - All I Want Is You (User: jbwharris)
The Sails - Chocolate (User: jbwharris)
The Killers - All These Things That I've Done (User: jbwharris)
Craig Mack - Flava In Ya Ear (Remix) [feat. The Notorious B.I.G., LL Cool J, Busta Rhymes & Rampage] (User: jbwharris)
Ben Kweller - Penny On A Train Track (Acoustic) (User: jbwharris)
Moondog - Lament I, "Bird's Lament" (Instrumental) (User: jbwharris)
Nada Surf - Do It Again (User: jbwharris)
Sault - Safe Within Your Hands (User: jbwharris)
Yot Club - no way ! (User: jbwharris)
U2 - Mysterious Ways (User: jbwharris)
David Bowie - Let's Dance (User: jbwharris)
Alicia Keys - Fallin' (User: jbwharris)
Elliott Smith - Say Yes (User: jbwharris)
Danger Mouse and Sparklehorse - Everytime I'm With You (with Jason Lytle) (User: jbwharris)
Grant Lee Buffalo - The Whole Shebang (User: jbwharris)
Trans-X - Living on Video (User: jbwharris)
Devo - Girl U Want (User: jbwharris)
Dan Mangan - Robots (User: jbwharris)
Red Hot Chili Peppers - Otherside (User: jbwharris)
Nirvana - The Man Who Sold the World (User: jbwharris)
Daft Punk - Da Funk (User: jbwharris)
World Party - Ship Of Fools (User: jbwharris)
The Fall - Cruiser's Creek (Single Version Remastered) (User: jbwharris)
Sam Roberts - Brother Down (User: jbwharris)
Taylor Swift - Question...? (User: jbwharris)
Shawn Mendes - When You're Gone (User: jbwharris)
Eve & Alicia Keys vs. Joan Jett - Rock 'N' Roll (User: jbwharris)
Oasis - Acquiesce (User: jbwharris)
Ray Charles - Hit the Road Jack (feat. The Raelets) (User: jbwharris)
Jon Secada - Just Another Day (User: jbwharris)
Phantogram - You Don't Get Me High Anymore (User: jbwharris)
Private World - Birdy (User: jbwharris)
David Bowie - Space Oddity (User: jbwharris)
Hundred Waters - Xtalk (User: jbwharris)
Arcade Fire - Signs of Life (User: jbwharris)
The National - Afraid of Everyone (User: jbwharris)
Neverending White Lights - My Fate (feat. Dallas Green) [Demo] (User: jbwharris)
Shannon Vs. The Rasmus - Let The Shadows Play (User: jbwharris)
Headstones - Tweeter And The Monkey Man (User: jbwharris)
The Dead Weather - 60 Feet Tall (User: jbwharris)
Nightmares on Wax - Nights Interlude (User: jbwharris)
JON VINYL - Life (User: jbwharris)
Thank You, I'm Sorry - Follow Unfollow (User: jbwharris)
Steve Winwood - Roll With It (User: jbwharris)
Aerosmith - Crazy (User: jbwharris)
Ibibio Sound Machine - All That You Want (User: jbwharris)
Built to Spill - Gone (User: jbwharris)
Built to Spill - The Wait (User: jbwharris)
Built to Spill - Comes A Day (User: jbwharris)
Built to Spill - Center of the Universe (User: jbwharris)
Built to Spill - Nowhere Nothin' Fuckup (User: jbwharris)
Built to Spill - In the Morning (User: jbwharris)
Built to Spill - Kicked it in the Sun (User: jbwharris)
Built to Spill - Never Be The Same (User: jbwharris)
Built to Spill - Goin' Against Your Mind (User: jbwharris)
Built to Spill - Randy Described Eternity (User: jbwharris)
Built to Spill - Reasons (User: jbwharris)
Built to Spill - Sidewalk (User: jbwharris)
Built to Spill - Conventional Wisdom (User: jbwharris)
Built to Spill - I Would Hurt a Fly (User: jbwharris)
Built to Spill - Hindsight (User: jbwharris)
Built to Spill - Big Dipper (User: jbwharris)
Built to Spill - The Plan (User: jbwharris)
Built to Spill - Living Zoo (User: jbwharris)
Built to Spill - Strange (User: jbwharris)
Built to Spill - Velvet Waltz (User: jbwharris)
Built to Spill - Car (User: jbwharris)
Built to Spill - Carry the Zero (User: jbwharris)
The Rocket Summer - Do You Feel (User: jbwharris)
The Who - We Got A Hit (User: jbwharris)
Silverchair - Petrol & Chlorine (User: jbwharris)
Jessie Ware - Free Yourself (User: jbwharris)
Doves - Sea Song (User: jbwharris)
Alaska Reid - Big Bunny (User: jbwharris)
Alice Cooper - Feed My Frankenstein (User: jbwharris)
Jesus Jones - Right Here Right Now (User: jbwharris)
The Diodes - Catwalker (User: jbwharris)
T. Rex - Jeepster (User: jbwharris)
Wintersleep - Amerika (User: jbwharris)
Peter Schilling - Major Tom (User: jbwharris)
Arcade Fire - The Suburbs (User: jbwharris)
David Ford - Perfect Soul (User: jbwharris)
Ericdoa & umru - movinglikeazombie (feat. SEBii, angelus, kmoe, Lewis Grant, savepoint, Tony Velour, emotegi, d0llywood1 & 4kmirage) [remix] (User: jbwharris)
RPA & The United Nations of Sound - America (User: jbwharris)
The Offspring - Self Esteem (User: jbwharris)
Danger Mouse and Sparklehorse - Dark Night Of The Soul (with David Lynch) (User: jbwharris)
Pearl Jam - Smile (User: jbwharris)
Dave Matthews - Gravedigger (Acoustic) (User: jbwharris)
ATV - Action Time Vision (User: jbwharris)
Michael Jackson vs. Goldfrapp - The Way Train (User: jbwharris)
Dear Reader - Smoke Machine (feat. One Fine Day Kids) (User: jbwharris)
The National - Ashamed Of The Story I Told (User: jbwharris)
Frou Frou - Let Go (User: jbwharris)
Dead or Alive - You Spin Me Round (Like a Record) [Re-Recorded] (User: jbwharris)
Leon Vynehall - Sugar Slip (The Lick) (User: jbwharris)
Amanda Shires - Take It Like A Man (User: jbwharris)
Amanda Shires - Take It Like A Man (User: jbwharris)
Andrew Bird - I felt a Funeral, in my Brain [feat. Phoebe Bridgers] (User: jbwharris)
Angel Olsen - Right Now (User: jbwharris)
Andrew Bird - I felt a Funeral, in my Brain [feat. Phoebe Bridgers] (User: jbwharris)
Angel Olsen - Right Now (User: jbwharris)
Angela Aux - Anywhere To Nowhere (User: jbwharris)
Anna Tivel - Outsiders (User: jbwharris)
Angela Aux - Anywhere To Nowhere (User: jbwharris)
Anna Tivel - Outsiders (User: jbwharris)
Arima Ederra - Portals (User: jbwharris)
Arima Ederra - Portals (User: jbwharris)
Art d'Ecco - Until the Sun Comes Up (User: jbwharris)
Barrie - Dig (User: jbwharris)
Benjamin Clementine - Delighted (User: jbwharris)
Bill Callahan - Coyotes (User: jbwharris)
Billie Eilish - TV (User: jbwharris)
Black Country, New Road - Basketball Shoes (User: jbwharris)
Camp Cope - Running with the Hurricane (User: jbwharris)
Caroline - Good morning (red) (User: jbwharris)
Cheekface - I Feel So Weird! (User: jbwharris)
CMAT - I Wanna Be a Cowboy, Baby! - Acoustic version (User: jbwharris)
Connie Constance - Red Flag (User: jbwharris)
Courting - Loaded (User: jbwharris)
Dazy - Pressure Cooker (User: jbwharris)
Death of the High street - Synergy (User: jbwharris)
deer scout - Peace With The Damage (User: jbwharris)
Dehd - No Difference (User: jbwharris)
Erin Rae - Can't See Stars (feat. Kevin Morby) (User: jbwharris)
Ezra Furman - Come Close (User: jbwharris)
First Aid Kit - Fallen Snow (User: jbwharris)
Florence + the Machine - King (User: jbwharris)
Fontaines D.C. - I Love You (User: jbwharris)
Fousheé - simmer down (User: jbwharris)
Frankie Stew and Harvey Gunn - Cats and Dogs (User: jbwharris)
GRLwood - The Rent (User: jbwharris)
Homeboy Sandman - Fresh Air Fund (User: jbwharris)
Hurray For The Riff Raff - RHODODENDRON (User: jbwharris)
IDLES - Crawl! - DGG Edit (User: jbwharris)
Imarhan - Adar Newlan (User: jbwharris)
Jake Xerxes Fussell - Love Farewell (User: jbwharris)
Jens Lekman - Your Beat Kicks Back Like Death (User: jbwharris)
Jermiside - For The Money (User: jbwharris)
Jesca Hoop - Hatred Has A Mother (User: jbwharris)
Kae Tempest - Grace (User: jbwharris)
Karen O - Hum Hum Hum (User: jbwharris)
Katie Bejsiuk - Onion Grass (User: jbwharris)
Kevin Morby - This Is A Photograph (User: jbwharris)
Kid Kapichi - I.N.V.U. (User: jbwharris)
Kiki Riggs - 2x2 (User: jbwharris)
The King Khan & BBQ Show - Going Down (User: jbwharris)
K.O.G - Ayinye (User: jbwharris)
Kurt Vile - Flyin (like a fast train) (User: jbwharris)
Lady Wray - Melody feat. Melody Bloom Bacote (User: jbwharris)
Le Butcherettes - The Universe (User: jbwharris)
Lisa O'Neill - Old Note (User: jbwharris)
Lizzo - Grrrls (User: jbwharris)
The Black Crowes - Oh Josephine (User: jbwharris)
Lou Turner - Dancing to Hold Music (User: jbwharris)
Lydia Ramsey - Wolf In The Night (User: jbwharris)
Lyrics Born - Go Ape Shit (User: jbwharris)
Maggie Rogers - Different Kind of World (User: jbwharris)
Marvin Tate's D-Settlement - Turn Da Fuckin' Lights Back On (User: jbwharris)
Megan Thee Stallion - Her (User: jbwharris)
Melissa Weikart - Diamond (User: jbwharris)
Meskerem Mees - Cod Liver Oil and Orange Juice (User: jbwharris)
Metronomy - It's good to be back - Metronomy x Panic Shack (User: jbwharris)
Aloe Blacc - The Man (User: jbwharris)
Kadeema - Beat Up Car (User: jbwharris)
Motorcade - Static (User: jbwharris)
Glass Animals - Heat Waves (User: jbwharris)
Mt. Joy - Evergreen (User: jbwharris)
Natural Sympathies - Coyote (User: jbwharris)
Caesars - Punkrocker (User: jbwharris)
Nina Nastasia - This Is Love (User: jbwharris)
Ondara - An Alien In Minneapolis - Edit (User: jbwharris)
Otoboke Beaver - Yakitori (User: jbwharris)
Otyken - Storm (User: jbwharris)
Owen Fitzgerald - Don't Give Me a Pet (User: jbwharris)
Panda Bear - Danger (User: jbwharris)
Panda Riot - Magic Only (User: jbwharris)
Panic Shack - Meal Deal (User: jbwharris)
Porridge Radio - Birthday Party (User: jbwharris)
Quelle Chris - Alive Ain't Always Living (User: jbwharris)
Regina Spektor - Up the Mountain (User: jbwharris)
Robyn Hitchcock - The Shuffle Man (User: jbwharris)
ROSALÍA - DELIRIO DE GRANDEZA (User: jbwharris)
Rose Betts - Secret (User: jbwharris)
S.G. Goodman - Keeper of the Time (User: jbwharris)
Samia - Kill Her Freak Out (User: jbwharris)
Samm Henshaw - Joy (User: jbwharris)
Sammy Copley - To The Bone (User: jbwharris)
Saya Gray - IF THERE’S NO SEAT IN THE SKY (WILL YOU FORGIVE ME???) (User: jbwharris)
Sharon Van Etten - Darkness Fades (User: jbwharris)
Soak - swear jar (User: jbwharris)
Sondre Lerche - Guarantee That I’d Be Loved (User: jbwharris)
Sorry - Closer (User: jbwharris)
Spoon - On The Radio (User: jbwharris)
Still Woozy - Pool (User: jbwharris)
Sudan Archives - Selfish Soul (User: jbwharris)
Tai Verdes - LAst dAy oN EaRTh (User: jbwharris)
Tami Neilson - Careless Woman (User: jbwharris)
Tess Parks - Old Life (User: jbwharris)
Toro y Moi - The Loop (User: jbwharris)
Viagra Boys - Punk Rock Loser (User: jbwharris)
Wet Leg - Ur Mum (User: jbwharris)
Yard Act - 100% Endurance (User: jbwharris)
Young Fathers - Geronimo (User: jbwharris)
Sloan - The Other Man (User: jbwharris)
Otis Redding & Carla Thomas - Tramp (User: jbwharris)
Arkells - Oh, The Boss Is Coming! (User: jbwharris)
Marcy Playground - Sex and Candy (User: jbwharris)
The Decemberists - Easy Come, Easy Go (User: jbwharris)
Shining - Find A Reason (User: jbwharris)
Bartees Strange - Jealousy (User: jbwharris)
Future Islands - Haunted by You (User: jbwharris)
The Replacements - Here Comes A Regular (User: jbwharris)
Vells - Larger Than Life (User: jbwharris)
Matt Berninger - One More Second (Future Islands Remix) (User: jbwharris)
Pilate - Knife-Grey Sea (User: jbwharris)
Pokémon - Pokemon Theme Season 2 - One Piece Theme - Incredible Crash Dummies Theme (User: jbwharris)
Sam Roberts - I Feel You (Radio Edit #2) (User: jbwharris)
Doves - Spellbound (User: jbwharris)
Reel 2 Real - I Like to Move It (User: jbwharris)
Willy Moon - I Wanna Be Your Man (User: jbwharris)
Sneaker Pimps - Spin Spin Sugar (Armand's Dark Garage Mix) (User: jbwharris)
María Ayo - El ciclo de la vida/Nants' Ingonyama (User: jbwharris)
Chad Stuart - That's What Friends Are For (User: jbwharris)
Phil Collins - Son Of Man (User: jbwharris)
Blue Swede - Hooked on a Feeling (User: jbwharris)
New Order - The Perfect Kiss (User: jbwharris)
Baby Rose - Fight Club (feat. Georgia Anne Muldrow) (User: jbwharris)
Cansei de Ser Sexy - Superafim (User: jbwharris)
Robin S - Show Me Love (1993) (User: jbwharris)
Cate Le Bon - Miami (User: jbwharris)
NRBQ - That Makes Me a Fool (User: jbwharris)
JJ72 - Brother Sleep (User: jbwharris)
The Jesus and Mary Chain - April Skies (User: jbwharris)
The Jesus and Mary Chain - April Skies (User: jbwharris)
Jordan Rakei - Send My Love (User: jbwharris)
Jordan Rakei - Send My Love (User: jbwharris)
Yeah Yeah Yeahs - Y Control (User: jbwharris)
Yeah Yeah Yeahs - Y Control (User: jbwharris)
Foo Foo - High Enuff - Jodys Dusted Drum Mix - Beatport Exclusive (User: jbwharris)
Foo Foo - High Enuff - Jodys Dusted Drum Mix - Beatport Exclusive (User: jbwharris)
Sex Pistols - God Save the Queen (User: jbwharris)
Sex Pistols - God Save the Queen (User: jbwharris)
Horror Music Orchestra - Sounds from Night (User: jbwharris)
Horror Music Orchestra - Sounds from Night (User: jbwharris)
Good Lovelies - I See Gold (User: jbwharris)
Good Lovelies - I See Gold (User: jbwharris)
Monster Magnet - Powertrip (User: jbwharris)
Monster Magnet - Powertrip (User: jbwharris)
Sharon Van Etten - We Are Fine (User: jbwharris)
Barns Courtney - You And I (User: jbwharris)
Scritti Politti - Cooking (User: jbwharris)
Roxy Music - Love Is the Drug (User: jbwharris)
Jessie Reyez - ROOF (User: jbwharris)
Low - Days Like These (User: jbwharris)
Real Estate - Had to Hear (User: jbwharris)
hannah jadagu - Say It Now (User: jbwharris)
Billy Idol - Eyes Without A Face (Poolside Remix) (User: jbwharris)
Pet Shop Boys - Always on My Mind (User: jbwharris)
Chotto Ghetto - New Horror (User: jbwharris)
Milky Chance - I Am Lost_Demo (User: jbwharris)
The Sadies - It's Easy (Like Walking) [feat. Kurt Vile] (User: jbwharris)
Kellylee Evans - KNOW HIS WORTH (User: jbwharris)
Mark Oakland - Live Forever (User: jbwharris)
Social Distortion - I Was Wrong (User: jbwharris)
Gord Downie - Useless Nights (User: jbwharris)
Guns N' Roses - Civil War (User: jbwharris)
The Shins - The Great Divide (User: jbwharris)
The White Stripes - Jolene (User: jbwharris)
Emmylou Harris - Wheels of Love (User: jbwharris)
Hot Chip - Positive (User: jbwharris)
Andy Shauf - Satan (User: jbwharris)
The Japanese House - Saw You in a Dream (User: jbwharris)
Clairo - Flaming Hot Cheetos (User: jbwharris)
Sarah McLachlan - Adia (User: jbwharris)
Broken Social Scene - Anthems For A Seventeen-year-old Girl (User: jbwharris)
Cannons - Bad Dream (User: jbwharris)
The Velvet Underground - Pale Blue Eyes (User: jbwharris)
Jack White - Lazaretto (User: jbwharris)
Ryley Walker - Opposite Middle (User: jbwharris)
Aretha Franklin - (You Make Me Feel Like) a Natural Woman (User: jbwharris)
Roy Ayers Ubiquity - Ain't No Sunshine (User: jbwharris)
Men I Trust - Billie Toppy (User: jbwharris)
Boyce Avenue - Drops of Jupiter (User: jbwharris)
Split System - Climbing (User: jbwharris)
The Dears - Who Are You, Defenders Of The Universe? (User: jbwharris)
Hey Ocean! - Islands (User: jbwharris)
Björk - Atopos (feat. Kasimyn) (User: jbwharris)
Matthew Good Band - Sort Of A Protest Song (User: jbwharris)
Lorde - Solar Power (User: jbwharris)
Stars - Hold on When You Get Love and Let Go When You Give It (User: jbwharris)
POLIÇA - Wandering Star (User: jbwharris)
Arkells - Private School (User: jbwharris)
The Elwins - So Down Low (User: jbwharris)
Deadbeats - Funky For You (Dorfmeister VS Madrid De Los Austrias Remix) (User: jbwharris)
Bartees Strange - Mr. November (User: jbwharris)
Oasis - Cigarettes  & Alcohol (User: jbwharris)
Rhye - Black Rain (User: jbwharris)
Ibibio Sound Machine - The Chant (Iquo Isang) (User: jbwharris)
Tame Impala - Patience (User: jbwharris)
Animal Collective - Leaf House (User: jbwharris)
Rose Cousins - Chains (User: jbwharris)
Beastie Boys - Sure Shot (User: jbwharris)
UNO stereo - TEXT (feat. Amindi) (User: jbwharris)
LCD Soundsystem - Dance Yrself Clean (User: jbwharris)
Alvvays - Belinda Says (User: jbwharris)
St. Vincent - The Melting of the Sun (User: jbwharris)
Echo & the Bunnymen - Bring On The Dancing Horses (User: jbwharris)
Our Lady Peace - Potato Girl (User: jbwharris)
Anti-Flag - Brandenburg Gate (User: jbwharris)
Menomena - Five Little Rooms (User: jbwharris)
Your Smith - The Spot (User: jbwharris)
Mumford & Sons - I Will Wait (User: jbwharris)
Zero 7 - In the Waiting Line (User: jbwharris)
Rozalla - Everybody's Free (User: jbwharris)
Hot Chip - One Pure Thought (User: jbwharris)
Lilblackkids, Georgia Anne Muldrow & Keith Rice - Friday (User: jbwharris)
Aso - Ultra Violet (User: jbwharris)
Kali Uchis - telepatía (User: jbwharris)
Bakslash - Tainted Love (Minimal Chic Mix) (User: jbwharris)
Special Interest - Cherry Blue Intention (User: jbwharris)
Father John Misty - Q4 (User: jbwharris)
Frank Turner - The Gathering (User: jbwharris)
Johnny Cash - Would You Lay With Me (In a Field of Stone) (User: jbwharris)
Romero - Crossing Lines (User: jbwharris)
Kokoroko - Something's Going On (User: jbwharris)
Mighty Sam McClain - Georgia Pines (User: jbwharris)
SmackJive - 26 (User: jbwharris)
George Harrison - Wah-Wah (User: jbwharris)
JP Cooper - everything i wanted (User: jbwharris)
Lloyd Cole & The Commotions - Perfect Skin (User: jbwharris)
The Presidents of the United States of America - Peaches (User: jbwharris)
Portishead - Sour Times (User: jbwharris)
Alfie Templeman - Stop Thinking (About Me) (User: jbwharris)
Oasis - The Knock On Effect (User: jbwharris)
Jamie T - The Old Style Raiders (User: jbwharris)
Klaxons - Four Horsemen of 2012 (User: jbwharris)
Leonard Cohen - Everybody Knows (User: jbwharris)
Courtney Barnett - Charity (User: jbwharris)
Shiro Schwarz - Electrify (User: jbwharris)
Sascha Dikiciyan - Adam Jensen 2.0 Trailer (User: jbwharris)
Buddy Holly - Dearest (User: jbwharris)
RÜFÜS DU SOL - Make It Happen (User: jbwharris)
Other Lives - Landforms (User: jbwharris)
The Cure - Killing an Arab (User: jbwharris)
MC Frontalot - Shame Of The Otaku (User: jbwharris)
Black Eyed Peas vs. Salt-N-Pepa - Hump It (User: jbwharris)
Tyler Shaw - Maybe This Christmas (User: jbwharris)
The Smashing Pumpkins - The Everlasting Gaze (User: jbwharris)
Riders in the Sky - Act Naturally (User: jbwharris)
Matthew Good - Flashdance II (User: jbwharris)
Daft Punk - Get Lucky (feat. Pharrell Williams & Nile Rodgers) (User: jbwharris)
Matisyahu - Jerusalem (User: jbwharris)
Gorillaz - Baby Queen (User: jbwharris)
Moist - Ophelia (User: jbwharris)
Metronomy & spill tab - Uneasy - Metronomy x spill tab (User: jbwharris)
Wintersleep - Weighty Ghost (User: jbwharris)
Glasvegas - Flowers and Football Tops (User: jbwharris)
Oasis - Roll with It (User: jbwharris)
Four Tops - It's The Same Old Song (User: jbwharris)
The Tymes - So Much In Love (User: jbwharris)
The Crystals - Da Doo Ron Ron (User: jbwharris)
The Crickets - That'll Be The Day (User: jbwharris)
Dick Dale & His Del-Tones - Miserlou (User: jbwharris)
Otis Redding - Try a Little Tenderness (User: jbwharris)
Jerry Lee Lewis and His Orchestra - Whole Lotta Shakin' Goin On (User: jbwharris)
The Supremes - You Can't Hurry Love (User: jbwharris)
The Everly Brothers - Bye Bye Love (User: jbwharris)
Marvin Gaye - How Sweet It Is (To Be Loved By You) (User: jbwharris)
Eddie Cochran - C'mon Everybody (User: jbwharris)
Martha Reeves & The Vandellas - Jimmy Mack (User: jbwharris)
The Dovells - You Can't Sit Down (User: jbwharris)
The Coasters - Yakety Yak (User: jbwharris)
The Monkees - Last Train to Clarksville (User: jbwharris)
The Orioles - Crying in the Chapel (User: jbwharris)
The Ventures - Hawaii Five-O (User: jbwharris)
Ray Charles - Hit the Road Jack (User: jbwharris)
Elvis Presley - Jailhouse Rock (User: jbwharris)
Hank Ballard - Work with Me Annie (User: jbwharris)
The Beach Boys - Surfin' U.S.A. (User: jbwharris)
The Monotones - The Book of Love (User: jbwharris)
Sam The Sham & The Pharaohs - Wooly Bully (User: jbwharris)
James Brown & The Famous Flames - I Got You (I Feel Good) (User: jbwharris)
The Platters - The Great Pretender (User: jbwharris)
The Temptations - Ain't Too Proud to Beg (User: jbwharris)
Little Richard - Rip It Up (User: jbwharris)
The Ad Libs - The Boy From New York City (User: jbwharris)
The Shirelles - Soldier Boy (User: jbwharris)
Chuck Berry - Roll over Beethoven (User: jbwharris)
Stevie Wonder - Uptight (Everything's Alright) (User: jbwharris)
Ricky Nelson - Hello Mary Lou, Goodbye Heart (User: jbwharris)
Petula Clark - Downtown (User: jbwharris)
Electric Light Orchestra - Can't Get It Out Of my Head (7" Edit) (User: jbwharris)
Arthur Conley - Sweet Soul Music (User: jbwharris)
Taylor Swift - gold rush (User: jbwharris)
Young-Holt Unlimited - Wack Wack (User: jbwharris)
Howie Beck - I Need Light (User: jbwharris)
Miguel - the valley (User: jbwharris)
Built to Spill - Goin' Against Your Mind (User: jbwharris)
Jonathan Richman - Circle I (User: jbwharris)
King Princess & Fousheé - Little Bother (User: jbwharris)
Stevie Wonder - Lately (User: jbwharris)
Limahl - The NeverEnding Story (User: jbwharris)
Marvin Gaye - Sexual Healing (Kygo Remix) (User: jbwharris)
Mumford & Sons - I Will Wait (User: jbwharris)
Steve Lacy - Sunshine (feat. Fousheé) (User: jbwharris)
The Black Keys - It Ain't Over (User: jbwharris)
M. Ward - Let's Dance (User: jbwharris)
Mark Oakland - Live Forever (User: jbwharris)
Czarface & MF Doom - Forever People (User: jbwharris)
Curtis Harding - Explore (User: jbwharris)
Beach House - Sunset (User: jbwharris)
Neverending White Lights - The Grace (User: jbwharris)
Brenda Boykin - Wonderful (User: jbwharris)
