My Favorite Robot - Dead Of The Dance (User: jbwharris)
Little Scream - Dear Leader (User: jbwharris)
Dayglow - Close to You (User: jbwharris)
Linda Ronstadt - You're No Good (User: jbwharris)
Ace of Base - All That She Wants (User: jbwharris)
Ray LaMontagne - Paper Man (User: jbwharris)
Sierra Ferrell - Jeremiah (User: jbwharris)
Micachu - Golden Phone (User: jbwharris)
Lou Bega - Mambo No. 5 (A Little Bit Of...) (User: jbwharris)
The Kount - Hey (User: jbwharris)
St. Panther - B.O.M.B. (User: jbwharris)
So Many Wizards - Best Friends (User: jbwharris)
Goldfish - Fort Knox (User: jbwharris)
Gary Clark Jr. - This Land (User: jbwharris)
Dylan LeBlanc - Cautionary Tale (User: jbwharris)
Dylan LeBlanc - Cautionary Tale (User: jbwharris)
The Lightning Seeds - All I Want (User: jbwharris)
John Legend - I Do (User: jbwharris)
Dope Lemon - Hey You (User: jbwharris)
Dope Lemon - Hey You (User: jbwharris)
Netsky - Give & Take (User: jbwharris)
Adaline - Waist Down (User: jbwharris)
Tom Misch & Yussef Dayes - What Kinda Music (User: jbwharris)
Howlin' Wolf - I Ain't Superstitious (feat. Eric Clapton, Steve Winwood, Bill Wyman & Charlie Watts) (User: jbwharris)
Shiro Schwarz - Electrify (User: jbwharris)
Young-Holt Unlimited - Wack Wack (User: jbwharris)
Madonna - Into the Groove (User: jbwharris)
Spectrals - You Can't Live On Love Alone (User: jbwharris)
Tracy Chapman - For My Lover (User: jbwharris)
Frank Ene - No Longer (User: jbwharris)
The Sheepdogs - Let It All Show (User: jbwharris)
Jemapur - Reprocessing Plant (User: jbwharris)
Cub Scout Bowling Pins - Heaven Beats Iowa (User: jbwharris)
Jenny Lewis - Red Bull & Hennessy (User: jbwharris)
Madonna - Don't Cry for Me Argentina (User: jbwharris)
A Silver Mt. Zion - Stumble Then Rise on Some Awkward Morning (User: jbwharris)
The Jon Spencer Blues Explosion - Bag Of Bones (User: jbwharris)
Guided by Voices - Paper Cutz (User: jbwharris)
Courtney Barnett - Charity (User: jbwharris)
Cat Power - Good Woman (User: jbwharris)
Ryan and Pony - Start Making Sense (User: jbwharris)
Tina Turner - I Don't Wanna Fight (User: jbwharris)
Juana Molina - Un Día Punk (User: jbwharris)
Steve Gunn - Stonehurst Cowboy (User: jbwharris)
PJ Harvey - Man-Size (User: jbwharris)
Bailen - Your Love Is All I Know (User: jbwharris)
Drake - Portland (feat. Quavo & Travis Scott) (User: jbwharris)
Rosanne Cash - Black Cadillac (User: jbwharris)
King Gizzard & The Lizard Wizard - Bone (User: jbwharris)
Fountains of Wayne - Denise (User: jbwharris)
King Gizzard & The Lizard Wizard - Altered Beast III (User: jbwharris)
St. Vincent - Masseduction (User: jbwharris)
Leon Bridges - Better Man (User: jbwharris)
Chance the Rapper - Work Out (User: jbwharris)
Andy Mason - Robin In The Rain (User: jbwharris)
Loose Shus - Ladies (User: jbwharris)
Missy D - Paint (User: jbwharris)
Counting Crows - Come Around (User: jbwharris)
Disturbed - The Sound of Silence (User: jbwharris)
Warren Zevon - Keep Me In Your Heart (User: jbwharris)
POLIÇA - Be Again (User: jbwharris)
Vampire Weekend - Rich Man (User: jbwharris)
Local H - All The Kids Are Right (User: jbwharris)
Emily Edrosa - Action (User: jbwharris)
Jeff Tweedy - Guess Again (User: jbwharris)
Mac DeMarco - Still Beating (User: jbwharris)
Dinosaur Jr. - I Ran Away (User: jbwharris)
Wolf Parade - I'll Believe in Anything (User: jbwharris)
Manchester Orchestra - Bed Head (User: jbwharris)
U2 - All I Want Is You (User: jbwharris)
Blawan - What You Do With What You Have (User: jbwharris)
Beyoncé - ***Flawless (feat. Chimamanda Ngozi Adichie) (User: jbwharris)
Better Oblivion Community Center, Conor Oberst & Phoebe Bridgers - Sleepwalkin' (User: jbwharris)
Ben Esser & Beau Diako - Stripes (feat. Emawk) (User: jbwharris)
Belle and Sebastian - Poor Boy (User: jbwharris)
Bedouin Soundclash - Salt-Water (User: jbwharris)
Bedouin Soundclash - Full Bloom (User: jbwharris)
Barenaked Ladies - Lovers in a Dangerous Time (User: jbwharris)
Baggage - E-350 (User: jbwharris)
Badly Drawn Boy - Promises (User: jbwharris)
Bachelor Girl - Buses and Trains (User: jbwharris)
Ayzha Nyree - Holy Class (User: jbwharris)
The Avener & Tiwayo - Wild (The Avener Rework) (User: jbwharris)
Arctic Monkeys - Why'd You Only Call Me When You're High? (User: jbwharris)
Annie Lennox - Why (User: jbwharris)
Anna Nalick - Breathe (2 AM) (User: jbwharris)
Angel Olsen - Tonight (Without You) (User: jbwharris)
Andrew Bird - Manifest (User: jbwharris)
Andra Day - Strange Fruit (User: jbwharris)
amindi k. fro$t - Eggs Aisle (User: jbwharris)
Allie Sherlock - Stay (User: jbwharris)
Allah-Las - Star (User: jbwharris)
Alice in Chains - Got Me Wrong (User: jbwharris)
Alex Siegel - Lonely Holiday (User: jbwharris)
Alex Porat - only hanging out cause i'm lonely (User: jbwharris)
Aimee Mann - You Do (User: jbwharris)
Ralph Castelli - Soft Spot (User: jbwharris)
Weezer - Buddy Holly (User: jbwharris)
Pearl Jam - Yellow Ledbetter (User: jbwharris)
Waxahatchee - Fire (User: jbwharris)
Mauno - Vampire (User: jbwharris)
The Collection - In Love With Your Soul (User: jbwharris)
LC Huffman - Fool's Gold (User: jbwharris)
John Lee Hooker - Boom Boom (User: jbwharris)
Michaela Anne - Run Away With Me (User: jbwharris)
Gulfer - Blurry (User: jbwharris)
The Weather Station - I Don't Know What to Say (User: jbwharris)
Solace - Infinite (User: jbwharris)
Bob Marley & The Wailers - Is This Love (User: jbwharris)
Cat Power - Sea of Love (User: jbwharris)
Squarepusher - Love Will Tear Us Apart (User: jbwharris)
Gorillaz - 12D3 (User: jbwharris)
Patrice Michaud - La grande évasion (User: jbwharris)
MiMi - Afraid (User: jbwharris)
Nilüfer Yanya - Crash (User: jbwharris)
Bongwater - You Don't Love Me Yet (User: jbwharris)
Raveena - Heartbeat (User: jbwharris)
The Electric Prunes - The Adoration (User: jbwharris)
Gerry Cinnamon - Canter (User: jbwharris)
Scala & Kolacny Brothers - Seashell (User: jbwharris)
oso oso - Wake Up Next To God (User: jbwharris)
Tokyo Police Club - Rubber Bands (User: jbwharris)
Eve Owen - So Still For You (User: jbwharris)
The Whitest Boy Alive - Burning (User: jbwharris)
Suzi Quatro - She's In Love With You (User: jbwharris)
Alex Lustig - Dive (feat. Akacia) (User: jbwharris)
Dawes - All Your Favorite Bands (User: jbwharris)
Francis and the Lights - Can't Tell Me Nothing (User: jbwharris)
Pixies - The Good Works of Cyrus (User: jbwharris)
Collective Soul - Shine (User: jbwharris)
Happy Mondays - Step On (2007 Remastered) (User: jbwharris)
Hurray For The Riff Raff - Hungry Ghost (User: jbwharris)
Deryk - goodtimes (User: jbwharris)
Into It. Over It. - We Prefer Indoors (User: jbwharris)
Ben Harper & The Innocent Criminals - Excuse Me Mr. (User: jbwharris)
Ladytron - White Elephant (User: jbwharris)
Pearl Jam - Yellow Ledbetter (User: jbwharris)
Courteeners - Not Nineteen Forever (User: jbwharris)
Elliott Smith - Memory Lane (User: jbwharris)
Spiritualized - Hey Jane (User: jbwharris)
Richard Ashcroft - All My Dreams (User: jbwharris)
Julien Baker - Faith Healer (User: jbwharris)
Raised on TV - Smog City (User: jbwharris)
Walt Disco - Hey Boy (You're One Of Us) (User: jbwharris)
Sweet Alibi - Confetti (User: jbwharris)
Natalie Cole - Pink Cadillac (User: jbwharris)
The Thrills - Not For All The Love In The World (User: jbwharris)
TATUM - Fever (User: jbwharris)
Explosions in the Sky - Have You Passed Through This Night? (User: jbwharris)
Arcade Fire - The Suburbs (User: jbwharris)
Bill Evans - What Are You Doing The Rest Of Your Life? (User: jbwharris)
Strange Ranger - House Show (User: jbwharris)
Owls - Everyone Is My Friend (User: jbwharris)
Dua Lipa - Tiny Desk (Home) Concert (User: jbwharris)
Dua Lipa - Don't Start Now (User: jbwharris)
Dua Lipa - Levitating (User: jbwharris)
William Fitzsimmons - I Kissed a Girl (User: jbwharris)
Simon & Garfunkel - Keep the Customer Satisfied (User: jbwharris)
The Amazons - Black Magic (User: jbwharris)
Trila - Trapped (User: jbwharris)
Zach zoya - In Da Way (User: jbwharris)
The Smiths - Sheila Take a Bow (User: jbwharris)
Dashboard Confessional - Screaming Infidelities (User: jbwharris)
Link Wray - Fallin' Rain (User: jbwharris)
Des'ree - You Gotta Be (User: jbwharris)
Kito & Empress Of - Wild Girl (User: jbwharris)
Low Cut Connie - Private Lives (User: jbwharris)
Reuben James - BBQ Energy (feat. Adam Flowers & Keyon Harrold) (User: jbwharris)
The T-Bones - No Matter What Shape (Your Stomach's In) [Rerecorded] (User: jbwharris)
Martyn - What Is Room 101 (User: jbwharris)
Radiohead - Karma Police (User: jbwharris)
environments - Dusk in the Okefenokee Swamp (User: jbwharris)
Julia Church - Shiloh (User: jbwharris)
Julien Chang - Butterflies from Monaco (User: jbwharris)
Biffy Clyro - Mountains (User: jbwharris)
Johnny Cash - Nobody (User: jbwharris)
Mitch Hedberg - Business Cards (User: jbwharris)
Miley Cyrus - Night Crawling (feat. Billy Idol) (User: jbwharris)
Coldplay - God Put a Smile Upon Your Face (User: jbwharris)
Karen O & Willie Nelson - Under Pressure (User: jbwharris)
Two Lone Swordsmen - You Are... (User: jbwharris)
Valerie June - Call Me A Fool (feat. Carla Thomas) (User: jbwharris)
The Killers - Everything Will Be Alright (User: jbwharris)
Shawn Mendes - Can't Take My Eyes Off You (BBC Live Version) (User: jbwharris)
Jay Ronic - Positivity (User: jbwharris)
George Harrison - Give Me Love (Give Me Peace on Earth) (User: jbwharris)
Clementine & the Galaxy - Heart Shaped Box (User: jbwharris)
The Walkmen - Stop Talking (User: jbwharris)
The Farsights - City's Coming Down (User: jbwharris)
Bea. - Amor Ingrato (User: jbwharris)
Annie Mack - Testify (User: jbwharris)
The Belfast Cowboys - Looking for the Northern Lights (User: jbwharris)
Keny Grey - Wow (User: jbwharris)
Mama Rose - Sweet Waters (User: jbwharris)
Seaberg - Pandemonium feat. Kory LaQuess (User: jbwharris)
Chastity Brown - Golden (User: jbwharris)
Tina Schlieske - What Would You Pay (Dear Harvey) (User: jbwharris)
Psalm One - Anxious, Nervous and Imperfect (User: jbwharris)
BLOOD $MOKE BODY - Black Velvet (User: jbwharris)
Double Grave - The Farm (User: jbwharris)
Paul Metsa - Slow Justice (User: jbwharris)
Annie and the Bang Bang - Voodoo Ranger (User: jbwharris)
Lady Midnight - Tide Over (User: jbwharris)
Dizzy Fae - 360 Baby (User: jbwharris)
Under Violet - California Moon (User: jbwharris)
OKnice - Scumbag (User: jbwharris)
Sarah White - August (User: jbwharris)
Polica - Be Again (User: jbwharris)
Ivers - Push (User: jbwharris)
Benjamin Miller - Try To Think (User: jbwharris)
Gowns - Imaginary Number (User: jbwharris)
Dessa - Bombs Away (User: jbwharris)
Mark Mallman - Fake Gold Silver Chains (User: jbwharris)
Rogue Valley - The Wolves and the Ravens (User: jbwharris)
Jose Gonzalez - El Invento (User: jbwharris)
Nilufer Yanya - Crash (User: jbwharris)
David Bowie - Heroes (User: jbwharris)
Kaleo - Break My Baby (User: jbwharris)
Tai Verdes - Stuck in the Middle (User: jbwharris)
Mac DeMarco - No Other Heart (User: jbwharris)
The Big Moon - Your Light (User: jbwharris)
Rhye - Black Rain (User: jbwharris)
TV Priest - This Island (User: jbwharris)
Pixies - There Goes My Gun (User: jbwharris)
Lianne La Havas - Can't Fight (User: jbwharris)
Nick Cave and Warren Ellis - Hand of God (User: jbwharris)
Jason Isbell and The 400 Unit - White Man's World (User: jbwharris)
Them - It's All Over Now, Baby Blue (User: jbwharris)
Karen O and Danger Mouse - WOMAN (User: jbwharris)
Nur-D - BandAid prod. Cxdy (User: jbwharris)
First Communion Afterparty - 2CB (User: jbwharris)
The Avalanches - The Divine Chord feat. MGMT and Johnny Marr (User: jbwharris)
Beth Orton - She Cries Your Name (User: jbwharris)
Lord Huron - Not Dead Yet (User: jbwharris)
Royal Blood - Trouble's Coming (User: jbwharris)
Bobby Fuller Four - I Fought the Law (User: jbwharris)
Tame Impala - Borderline (User: jbwharris)
Noname - Rainforest (User: jbwharris)
Future Islands - Plastic Beach (User: jbwharris)
Bakar - Hell N Back (User: jbwharris)
Billy Bragg & Wilco - Hesitating Beauty (User: jbwharris)
The Staves - Trying (User: jbwharris)
The Go Go's - Club Zero (User: jbwharris)
J Roddy Walston and The Business - Marigold (User: jbwharris)
Foo Fighters - Waiting on a War (User: jbwharris)
Lloyd Cole and The Commotions - Rattlesnakes (User: jbwharris)
Valerie June - Call Me A Fool (User: jbwharris)
Sea Wolf - You're A Wolf (User: jbwharris)
David Huckfelt - Bury Me Not (The Dying Cowboy) (User: jbwharris)
Romy - Lifetime (User: jbwharris)
Franz Ferdinand - Always Ascending (User: jbwharris)
Elastica - Connection (User: jbwharris)
Squid - Narrator (User: jbwharris)
SZA - Good Days (User: jbwharris)
Perfume Genius - Jason (User: jbwharris)
John Mayall - Steppin' Out (User: jbwharris)
Nathaniel Rateliff - Redemption (User: jbwharris)
Kathleen Edwards - Hard On Everyone (User: jbwharris)
Belle and Sebastian - I'm a Cuckoo (User: jbwharris)
Illiterate Light and Devon Gilfillian - Freedom (User: jbwharris)
Joni Mitchell - River (User: jbwharris)
Weezer - All My Favorite Songs (User: jbwharris)
R.E.M. - Pop Song 89 (User: jbwharris)
Manchester Orchestra - Bed Head (User: jbwharris)
Cannons - Fire For You (User: jbwharris)
Sharon Jones and the Dap-Kings - How Long Do I Have To Wait For You (User: jbwharris)
Carm - Land feat. Justin Vernon (User: jbwharris)
Frances Forever - Space Girl (User: jbwharris)
Green Day - Warning (User: jbwharris)
Suzi Quatro - She's In Love With You (User: jbwharris)
Lana Del Rey - Beautiful People Beautiful Problems feat. Stevie Nicks (User: jbwharris)
Mary Wells - My Guy (User: jbwharris)
Chet Faker - Low (User: jbwharris)
LC Huffman - Fool's Gold (User: jbwharris)
The Strokes - The Adults Are Talking (User: jbwharris)
Paul Westerberg - Seein' Her (User: jbwharris)
Lake Street Dive - Hypotheticals (User: jbwharris)
Coldplay - Orphans (User: jbwharris)
Lorde - Green Light (User: jbwharris)
beabadoobee - Care (User: jbwharris)
Lucero - Back in Ohio (User: jbwharris)
Edith Whiskers - Home (User: jbwharris)
Fleet Foxes - Can I Believe You (User: jbwharris)
Beck - Blue Moon (User: jbwharris)
Gary Numan - Cars (User: jbwharris)
Wolf Alice - The Last Man on Earth (User: jbwharris)
Joe Tex - Hold What You've Got (User: jbwharris)
Tune-Yards - hold yourself (User: jbwharris)
Lupin - May (User: jbwharris)
Arlo Parks - Hurt (User: jbwharris)
Black Pumas - Black Moon Rising (User: jbwharris)
Car Seat Headrest - Can't Cool Me Down (User: jbwharris)
Dylan Cartlidge - Molasses (Walk The Walk) (User: jbwharris)
Big Audio Dynamite - Emc2 (User: jbwharris)
Kiwi Jr. - Cooler Returns (User: jbwharris)
Led Zeppelin - Custard Pie (User: jbwharris)
Bugsy - Talk To You (User: jbwharris)
The Monks - Monktime (User: jbwharris)
Dinosaur Jr - I Ran Away (User: jbwharris)
Julien Baker - Hardline (User: jbwharris)
Yuna - Dance Like Nobody's Watching (User: jbwharris)
Social Distortion - Ball and Chain (User: jbwharris)
Michigander - Let Down (User: jbwharris)
Andra Day - Strange Fruit (User: jbwharris)
Hurray For The Riff Raff - Rican Beach (User: jbwharris)
Chicano Batman - Color My Life (User: jbwharris)
Ani DiFranco - Simultaneously (User: jbwharris)
The Cure - The Caterpillar (User: jbwharris)
Dessa - Rome (User: jbwharris)
James Hunter - People Gonna Talk (User: jbwharris)
Javier Santiago - Dream feat. Taylor Johnson (User: jbwharris)
The Staves - Satisfied (User: jbwharris)
Joseph - Fighter (User: jbwharris)
The Avalanches - Frontier Psychiatrist (User: jbwharris)
Bomba Estéreo - Agua (User: jbwharris)
Flock of Dimes - Two (User: jbwharris)
KHRUANGBIN AND LEON BRIDGES - TEXAS SUN (User: jbwharris)
The Beatles - Hello Goodbye (User: jbwharris)
Remi Wolf - Hello Hello Hello (User: jbwharris)
Courtney Barnett - Charity (User: jbwharris)
The Dandy Warhols - Minnesoter (User: jbwharris)
ONR - Must Stop feat. Sarah Barthel (User: jbwharris)
Low Cut Connie - 02 Boozophilia (User: jbwharris)
WizTheMc - For a Minute (User: jbwharris)
Gill Bondy - Sick by the Sea (User: jbwharris)
Yo La Tengo - Green Arrow (User: jbwharris)
Matthew Mole - Back to You (User: jbwharris)
Keane - A Bad Dream (User: jbwharris)
Grumpster - Teeth (User: jbwharris)
London Grammar - Hell to the Liars (User: jbwharris)
Joe Jackson - Friend Better (User: jbwharris)
Snail Mail - Pristine (User: jbwharris)
Capital Cities - Stayin Alive (User: jbwharris)
David Holmes - $165 Million + Interest (Intro) The Round Up (User: jbwharris)
My Chemical Romance - I'm Not Okay (I Promise) (User: jbwharris)
Jordan Ward - moveOn (User: jbwharris)
Joyce Manor - House Warning Party (User: jbwharris)
Jason Isbell - Traveling Alone (User: jbwharris)
The Beths - Out of Sight (User: jbwharris)
Kelly Lee Owens - L.I.N.E. (User: jbwharris)
Robyn Hitchcock & The Egyptians - So You Think You're In Love (User: jbwharris)
The Chemical Brothers - The Boxer (Radio Edit) (User: jbwharris)
Arlo Parks - Black Dog (Apple Music At Home With Session) (User: jbwharris)
TV on the Radio - Wolf Like Me (User: jbwharris)
The Civil Wars - Disarm (User: jbwharris)
Mandala - Mirror (User: jbwharris)
YEEK - Solstice (User: jbwharris)
spencer. - Maybe (User: jbwharris)
Idman - Down For It (User: jbwharris)
Kaleo - Break My Baby (User: jbwharris)
Jamie xx - Loud Places (feat. Romy) (User: jbwharris)
a goofy movie - After Today (User: jbwharris)
The Jackson 5 - Rockin' Robin (User: jbwharris)
Gerardo - Here We Go Loopty_Loo (User: jbwharris)
Charlie Hope - Two Little Blackbirds (User: jbwharris)
Little Richard - The Magic School Bus Theme (User: jbwharris)
The Helpsters ft. Shaggy - I Like Sidewalks (User: jbwharris)
The Helpsters ft. Shaggy - I Like Sidewalks (User: jbwharris)
Jerry Garcia & David Grisman - Three Men Went A-Hunting (User: jbwharris)
Bag Raiders - Prelude (User: jbwharris)
Siouxsie and the Banshees - Cities in Dust (User: jbwharris)
Jonathan Richman And The Modern Lovers - Roadrunner (User: jbwharris)
Adaline - Waist Down (User: jbwharris)
The Smiths - Panic (User: jbwharris)
Frazey Ford - Done (User: jbwharris)
Sheryl Crow - My Favorite Mistake (User: jbwharris)
Wilco - Heavy Metal Drummer (User: jbwharris)
Broken Bells - Good Luck (User: jbwharris)
The Lytics - Last Bit (Lovely Words) (User: jbwharris)
The Dandy Warhols - We Used to Be Friends (User: jbwharris)
James Bay - Pink Lemonade (User: jbwharris)
Jeremy Fisher - Cigarette (User: jbwharris)
Gary Clark Jr. - Ain't Messin 'Round (User: jbwharris)
Natalie Prass - Short Court Style (User: jbwharris)
David Bowie - Young Americans (User: jbwharris)
Clap Your Hands Say Yeah - The Skin of My Yellow Country Teeth (User: jbwharris)
Ivan & Alyosha - Everybody Breaks (User: jbwharris)
Lily Allen - Smile (User: jbwharris)
Benjamin Booker - Believe (User: jbwharris)
Dawes - Time Spent In Los Angeles (User: jbwharris)
Common - The Light (User: jbwharris)
John Legend - I Do (User: jbwharris)
Brasstronaut - Raveshadow (User: jbwharris)
Luscious Jackson - Naked Eye (User: jbwharris)
Elise LeGrow - Evan (User: jbwharris)
Robyn Dell'Unto - Face to Face (User: jbwharris)
Overcoats - Hold Me Close (User: jbwharris)
Broken Bells - No Matter What You're Told (User: jbwharris)
Belle and Sebastian - White Collar Boy (User: jbwharris)
Emily King - Look At Me Now (User: jbwharris)
Jason Collett - Charlyn, Angel of Kensington (User: jbwharris)
Sam Roberts Band - FIEND (User: jbwharris)
Cayley Thomas - Two Minds (User: jbwharris)
Black Eyed Peas,Esthero - Weekends (User: jbwharris)
George Ezra - Don't Matter Now (User: jbwharris)
The Cure - Lovesong (User: jbwharris)
Adele - Rolling in the Deep (User: jbwharris)
mxmtoon, Carly Rae Jepsen - ok on your own (User: jbwharris)
Passion Pit - Dreams (User: jbwharris)
Daniel Romano - Time Forgot (To Change My Heart) (User: jbwharris)
Hammock - Black Metallic (User: jbwharris)
Purity Ring - begin again (User: jbwharris)
The Dirty Knobs - Pistol Packin' Mama (feat. Chris Stapleton) (User: jbwharris)
The Verbrilli Sound - Edin (User: jbwharris)
Drake - Portland (feat. Quavo & Travis Scott) (User: jbwharris)
Groj - Bereth en Eithel (User: jbwharris)
Major Lazer,Partynextdoor - Run up (Ft. Nicki Minaj) (User: jbwharris)
Aidan Baker - You Are Microscopic (User: jbwharris)
La+ch,Dustbuster - Hunter (User: jbwharris)
Ash - Burn Baby Burn (User: jbwharris)
WILLA - Hey (User: jbwharris)
Ryan Hemsworth - Hurt Me (User: jbwharris)
Boundary - Yamuna Expressway (User: jbwharris)
Millimetrik - La Dualite Du Temps (Pour Myriam C) (User: jbwharris)
DJ Champion - No Heaven (User: jbwharris)
Auk - Tomorrow Morning (User: jbwharris)
My Favorite Robot - Dead Of The Dance (User: jbwharris)
La+ch,Dustbuster - Hunter (User: jbwharris)
WILLA - Hey (User: jbwharris)
Ryan Hemsworth - Hurt Me (User: jbwharris)
Boundary - Yamuna Expressway (User: jbwharris)
Millimetrik - La Dualite Du Temps (Pour Myriam C) (User: jbwharris)
DJ Champion - No Heaven (User: jbwharris)
Auk - Tomorrow Morning (User: jbwharris)
My Favorite Robot - Dead Of The Dance (User: jbwharris)
Grimes - Artangels (User: jbwharris)
Steve Blair - Sunday (User: jbwharris)
DragonForce - Through the Fire and Flames (User: jbwharris)
Tiga - Shoes (Spencer & Hill remix) (User: jbwharris)
The Verbrilli Sound - Indus (User: jbwharris)
Longwalkshortdock - Why Should I Bother? (User: jbwharris)
A-Trak - Say Whoa (User: jbwharris)
Allie X - All the Rage (User: jbwharris)
Lowell - High Enough (User: jbwharris)
Porter Robinson - Mirror (User: jbwharris)
Luna - Most of the Time (User: jbwharris)
Joy Division - A Means To An End (live) (User: jbwharris)
Littleuniverses - Those Things (User: jbwharris)
Spoon - Can I Sit Next To You (User: jbwharris)
Washed Out - Time to Walk Away (User: jbwharris)
Little Scream - One Lost Time (User: jbwharris)
Disturbed - The Sound of Silence (User: jbwharris)
Joe Cocker - With A Little Help From My Friends (User: jbwharris)
Bobby Womack - Fire And Rain (User: jbwharris)
Echo & the Bunnymen - People Are Strange (User: jbwharris)
Luke Doucet - Sundown (User: jbwharris)
Passion Pit - Dreams (User: jbwharris)
Lizz Wright - Old Man (User: jbwharris)
Elise LeGrow - You Never Can Tell (User: jbwharris)
Sarah McLachlan - Dear God (User: jbwharris)
Shawn Colvin - Every Little Thing (He) Does Is Magic (User: jbwharris)
Jennifer Warnes - Ain't No Cure for Love (User: jbwharris)
Fiona Apple - Across the Universe (User: jbwharris)
Poolside - Harvest Moon (User: jbwharris)
Overcoats - Fix You (User: jbwharris)
Ben Folds - Doctor My Eyes (User: jbwharris)
Birdy - Skinny Love (User: jbwharris)
Jadea Kelly - Wildflowers (User: jbwharris)
Mandy Moore - Help Me (User: jbwharris)
UB40 - Red, Red Wine (User: jbwharris)
Richard Thompson - OOPS- I DID IT AGAIN (User: jbwharris)
Phantom Planet - Our House (User: jbwharris)
Donovan Woods - Could I Be Your Girl (User: jbwharris)
Paul Weller - Early Morning Rain (User: jbwharris)
Andrew Bird - The Fake Headlines (User: jbwharris)
Jamie N Commons - Have A Little Faith (User: jbwharris)
Tegan and Sara - Fool To Cry (User: jbwharris)
Stevie Wonder - We Can Work It Out (User: jbwharris)
Aaron Espe - Suddenly I See (User: jbwharris)
Ike & Tina Turner - Come Together (User: jbwharris)
Kinnie Starr - Another One Bites The Dust (User: jbwharris)
Brooke Fraser - Distant Sun (User: jbwharris)
Bahamas - Don't You Want Me (User: jbwharris)
Florence + the Machine - Addicted to Love (User: jbwharris)
Carly Rae Jepson,Lil Yachty - It Takes Two (User: jbwharris)
Amy Winehouse - Will You Love Me tomorrow (User: jbwharris)
Q-Tip,Demi Lovato - Don't Go Breaking My Heart (User: jbwharris)
Ed Sheeran - Atlantic City (User: jbwharris)
M. Ward - Let's Dance (User: jbwharris)
The Skydiggers - Eight Miles High (User: jbwharris)
Brooke Palsson - The Way You Make Me Feel (User: jbwharris)
Earth, Wind & Fire - Got to Get You into My Life (User: jbwharris)
The Bird and the Bee - Rich Girl (User: jbwharris)
William Fitzsimmons - I Kissed a Girl (User: jbwharris)
Ryan Adams - Wonderwall (User: jbwharris)
Scott Helman - Jockey Full of Bourbon (User: jbwharris)
Seu Jorge - Rebel Rebel (User: jbwharris)
Great Big Sea - Run Runaway (User: jbwharris)
Father John Misty - Suburbs (User: jbwharris)
Emm Gryner - She's Gone (User: jbwharris)
Ben Taylor - I Try (User: jbwharris)
Nicolas Jaar - Faith Made of Silk (User: jbwharris)
Artisan Loyalist - Silica (User: jbwharris)
Siv Jakobsen - How We Used To Love (Martin Hviid Remix) (User: jbwharris)
Lydia Ainsworth - Diamonds Cutting Diamonds (User: jbwharris)
Handsome Furs - All we Want, Baby, is Everything (User: jbwharris)
The Elwins - Don't Walk Away from Me (User: jbwharris)
Can I Call You Tonight? - Dayglow (User: jbwharris)
Ron Thompson & His Rowdy Guitar - Switchblade (User: jbwharris)
The Versatones - Bila (User: jbwharris)
The Chicks - The Hucklebuck (User: jbwharris)
Royal Blood - Trouble's Coming (User: jbwharris)
Billie Eilish - bad guy (User: jbwharris)
Machine Gun Kelly - My Ex's Best Friend (User: jbwharris)
Bad Child - Million Bucks (User: jbwharris)
Monowhales - Out With The Old (User: jbwharris)
Haviah Mighty - Atlantic (User: jbwharris)
KALLITECHNIS - colo(u)rs (User: jbwharris)
Chastity - Losing a Whole Year (User: jbwharris)
Valley - Like 1999 (User: jbwharris)
Keeper E. - Leaf In A River (User: jbwharris)
Witch Prophet - Tesfay (User: jbwharris)
Mo Kenney - You Belong To Me (User: jbwharris)
Rhye - Helpless (User: jbwharris)
Mirabelle - Phenomene (User: jbwharris)
Charlotte Cardin - Meaningless (User: jbwharris)
Grae - 2725 (User: jbwharris)
Missy D - Paint (User: jbwharris)
Vampire Weekend - Harmony Hall (User: jbwharris)
Michael Kiwanuka - Hero (User: jbwharris)
Coldplay - Yellow (User: jbwharris)
July Talk - The News (User: jbwharris)
Spiritualized - Ladies and Gentlemen We Are Floating in Space (User: jbwharris)
Silver Jews - Trains Across the Sea (User: jbwharris)
Sonic Youth - Kool Thing (User: jbwharris)
Pearl Jam - Spin the Black Circle (User: jbwharris)
Chester Watson - Floating (User: jbwharris)
Hot Chip - Straight To The Morning (feat. Jarvis Cocker) (User: jbwharris)
Tom Waits - San Diego Serenade (User: jbwharris)
Tones and I - Dance Monkey (Stripped Back) (User: jbwharris)
Tones and I - Dance Monkey (Stripped Back) (User: jbwharris)
Foo Fighters - Shame Shame (User: jbwharris)
YUNGBLUD - acting like that (feat. Machine Gun Kelly) (User: jbwharris)
Zero 7 - Aurora (feat. José González) (User: jbwharris)
Parker Ainsworth - The Way That It Was (User: jbwharris)
Joy Division - A Means to an End (User: jbwharris)
The House of Love - Blind (User: jbwharris)
Mates of Mine - Something From Nothing (User: jbwharris)
Boz Scaggs - Payday (User: jbwharris)
Billy Talent - Afraid of Heights (User: jbwharris)
Amy Shark - Adore (User: jbwharris)
John Mayer - Heartbreak Warfare (User: jbwharris)
Charlotte Day Wilson - Work (User: jbwharris)
The Hold Steady - Unpleasant Breakfast (User: jbwharris)
Iron & Wine - Time After Time (User: jbwharris)
Lingua Ignota - Wicked Game (feat. Alexis Marshall) (User: jbwharris)
Danny Godwin - I Know (User: jbwharris)
Rage Against the Machine - Killing in the Name (User: jbwharris)
Gary V - Eternal Return (Deja Vu) (User: jbwharris)
Elderbrook - Numb (User: jbwharris)
Propellerheads - Spybreak! (Short One) (User: jbwharris)
Superlative & Mr. Scruff - Read All About It (User: jbwharris)
Loony - WHiTE LiE (User: jbwharris)
M83 - Midnight City (User: jbwharris)
Adam Chini - Let The Night Slip Away (User: jbwharris)
System of a Down - Spiders (User: jbwharris)
Iron Maiden - The Number of the Beast (User: jbwharris)
Soul Asylum - Somebody to Shove (User: jbwharris)
Dramarama - Anything, Anything (I'll Give You) (User: jbwharris)
Orgy - Stitches (User: jbwharris)
Brand New - Sic Transit Gloria...Glory Fades (User: jbwharris)
White Zombie - More Human Than Human (User: jbwharris)
DragonForce - Through the Fire and Flames (User: jbwharris)
Motörhead - Ace of Spades (User: jbwharris)
Alice in Chains - Rooster (User: jbwharris)
Orgy - Blue Monday (User: jbwharris)
Alexisonfire - The Northern (User: jbwharris)
Foals - Black Bull (User: jbwharris)
Sponge - Plowed (User: jbwharris)
Nirvana - Aneurysm (User: jbwharris)
Metallica - One (User: jbwharris)
Local H - All The Kids Are Right (User: jbwharris)
Stone Temple Pilots - Trippin' on a Hole in a Paper Heart (User: jbwharris)
The 1975 - People (User: jbwharris)
Monster Magnet - Powertrip (User: jbwharris)
Pearl Jam - State of Love and Trust (User: jbwharris)
Alexisonfire - Young Cardinals (User: jbwharris)
Queens of the Stone Age - 3's & 7's (User: jbwharris)
Black Rebel Motorcycle Club - Weapon of Choice (User: jbwharris)
Idlewild - A Modern Way of Letting Go (User: jbwharris)
Rusty - Misogyny (User: jbwharris)
Filter - Hey Man Nice Shot (User: jbwharris)
Guns N' Roses - You Could Be Mine (User: jbwharris)
Blind Melon - Galaxie (User: jbwharris)
Queens of the Stone Age - Feel Good Hit of the Summer (User: jbwharris)
Filter - Welcome to the Fold (User: jbwharris)
Buzzcocks - Ever Fallen in Love (With Someone You Shouldn't've?) [1996 Remastered Version] (User: jbwharris)
Iron Maiden - The Trooper (User: jbwharris)
The White Stripes - Hotel Yorba (User: jbwharris)
Metallica - Master of Puppets (User: jbwharris)
The Hold Steady - Hanover Camera (User: jbwharris)
Spoon - The Underdog (User: jbwharris)
Peter Bjorn and John - Young Folks (User: jbwharris)
LCD Soundsystem - Someone Great (User: jbwharris)
Cartel Madras & Jide - WORKING (User: jbwharris)
Matthew Good - Empty's Theme Park (User: jbwharris)
Fleet Foxes - Ragged Wood (User: jbwharris)
Barenaked Ladies - What a Good Boy (User: jbwharris)
Terry Jacks - Seasons in the Sun (User: jbwharris)
Thank You, I'm Sorry - Follow Unfollow (User: jbwharris)
Tobi - Made Me Everything (User: jbwharris)
Judy Garland - Over the Rainbow (User: jbwharris)
Bloc Party - Positive Tension (User: jbwharris)
Jack White - Love Interruption (User: jbwharris)
John Denver - Take Me Home, Country Roads (Original Version) (User: jbwharris)
M.I.L.K. - Need A Witness (User: jbwharris)
Karen Gwyer - Waukon (User: jbwharris)
Scorpions - Wind of Change (User: jbwharris)
Johnny Cash - Field of Diamonds (User: jbwharris)
Lykke Li - Unchained Melody (User: jbwharris)
HEALTH & Youth Code - INNOCENCE (User: jbwharris)
Lil Peep - Broken Smile (My All) (User: jbwharris)
Hockey Dad - Good Eye (User: jbwharris)
maxwell young - No. 5 (User: jbwharris)
Willie Nelson - On The Road Again (User: jbwharris)
You Love Her Coz She's Dead - Superheroes (User: jbwharris)
Bruce Springsteen - Thunder Road (Springsteen on Broadway) (User: jbwharris)
Vic Chesnutt - You Are Never Alone (User: jbwharris)
Slow Pulp - At It Again (User: jbwharris)
The Sounds - Seven Days a Week (User: jbwharris)
Roberta Flack - Jesse (User: jbwharris)
Porridge Radio - 7 Seconds (User: jbwharris)
Ride - Leave Them All Behind (User: jbwharris)
David Bowie - Let's Dance (User: jbwharris)
Xela - Last Breath (User: jbwharris)
Super Duper - Quiver (feat. Lonas) (User: jbwharris)
Porches - I Miss That (User: jbwharris)
Sea Level - Rain In Spain (User: jbwharris)
Oasis - Shakermaker (User: jbwharris)
Bob Dylan - Tangled Up in Blue (User: jbwharris)
Kane Brown, Swae Lee, Khalid - Be Like That (User: jbwharris)
Tom Furse - Trans-Universal Express (User: jbwharris)
Muse - Darkshines (User: jbwharris)
Che Ecru - DONT LOVE ME (User: jbwharris)
Woolworm - Let Me Wear the Mask (User: jbwharris)
Dream Nails - Vagina Police 2.0 (User: jbwharris)
The Lowest of the Low - The Hand of Magdelena (User: jbwharris)
Gang of Four - The Dying Rays (2020) (User: jbwharris)
Genesis - Driving the Last Spike (User: jbwharris)
Bronson - KEEP MOVING (User: jbwharris)
Michael Bublé, Barenaked Ladies & Sofía Reyes - Gotta Be Patient (User: jbwharris)
Daniel Johnston - Some Things Last a Long Time (User: jbwharris)
Daniel Johnston - Some Things Last a Long Time (User: jbwharris)
Rheostatics - Claire (User: jbwharris)
The Killers - Read My Mind (User: jbwharris)
Purity Ring - peacefall (User: jbwharris)
Colie - Kids These Days (User: jbwharris)
Møme & Ricky Ducati - They Said (User: jbwharris)
Orla Gartland - heavy (User: jbwharris)
Tame Impala - Eventually (User: jbwharris)
Squeeze - Pulling Mussels (From The Shell) (User: jbwharris)
Foxfire Run - Dear Mrs. Young (User: jbwharris)
SYML - Here Comes the Sun (User: jbwharris)
Abc Dialect - Magic (User: jbwharris)
Viagra Boys - In Spite of Ourselves (feat. Amy Taylor) (User: jbwharris)
Fleet Foxes - Montezuma (User: jbwharris)
Amaarae - LIKE IT (User: jbwharris)
Guided by Voices - Learning to Hunt (User: jbwharris)
The Police - Roxanne (User: jbwharris)
The Great Yawn - Buy things (User: jbwharris)
The Ventures - Walk, Don't Run '64 (Re-Recorded) (User: jbwharris)
Local Natives - Lemon (feat. Sharon Van Etten) (User: jbwharris)
Bruce Springsteen - Letter To You (User: jbwharris)
Beat Connection - Silver Screen (User: jbwharris)
emawk - tea (User: jbwharris)
Nick Drake - Pink Moon (User: jbwharris)
Matt Berninger - I'll See You In My Dreams (feat. Vince Giordano & The Nighthawks) (User: jbwharris)
Blur - Girls and Boys (User: jbwharris)
múm - Smell Memory (User: jbwharris)
Yum Yuck - Flesh & Bone (User: jbwharris)
Hovvdy - Runner (User: jbwharris)
Omar Apollo - Ignorin (User: jbwharris)
Misty River - Take This Dance (User: jbwharris)
Olivia Escuyos - Ilwy (User: jbwharris)
Iggy Pop - The Passenger (User: jbwharris)
Joni Mitchell - River (User: jbwharris)
Vundabar - Montage Music (User: jbwharris)
SHOTTY HORROH - Dirty Old Town (User: jbwharris)
Julie Benson - Valerie (Deep Piano Mix) (User: jbwharris)
Tessela - Channel (User: jbwharris)
The Purrs - Waiting For The Asteroid (User: jbwharris)
The Bravery - Out Of Line (User: jbwharris)
The 2 Bears - Get Out (User: jbwharris)
The Bangles - Eternal Flame (User: jbwharris)
Men I Trust - Norton Commander (All We Need) (User: jbwharris)
Craft Spells - Your Tomb (User: jbwharris)
Skegss - Wake Up (User: jbwharris)
Ralph Stanley - O Death (User: jbwharris)
Middle Kids - Questions (User: jbwharris)
Jon Batiste - I NEED YOU (User: jbwharris)
Rage Against the Machine - People of the Sun (User: jbwharris)
Ryan and Pony - Start Making Sense (User: jbwharris)
Carm - Land feat. Justin Vernon (User: jbwharris)
Fleet Foxes - Can I Believe You (User: jbwharris)
Tame Impala - Lost in Yesterday (User: jbwharris)
Foushee - Deep End (User: jbwharris)
Loretta Lynn - High On A Mountain Top (User: jbwharris)
Dead Man Winter - Nicotine (User: jbwharris)
Remi Wolf - Hello Hello Hello (User: jbwharris)
Red Hot Chili Peppers - Higher Ground (User: jbwharris)
Barry Gibb - Run To Me Feat. Brandi Carlile (User: jbwharris)
TV on the Radio - Halfway Home (User: jbwharris)
Jeff Tweedy - Guess Again (User: jbwharris)
U2 - Ultraviolet (Light My Way) (User: jbwharris)
Wolf Alice - The Last Man on Earth (User: jbwharris)
Samm Henshaw - All Good (User: jbwharris)
New Order - Be a Rebel (User: jbwharris)
Kurtis Blow - The Breaks (Part 1) (User: jbwharris)
Rhye - Black Rain (User: jbwharris)
Tower of Power - What Is Hip (User: jbwharris)
Julien Baker - Hardline (User: jbwharris)
Chance the Rapper - Work Out (User: jbwharris)
Clap Your Hands Say Yeah - Thousand Oaks (User: jbwharris)
King Gizzard And The Lizard Wizard - Bone (User: jbwharris)
Anjimile - Baby No More (User: jbwharris)
Bob Dylan - I Contain Multitudes (User: jbwharris)
Rhett Miller - Wreck Of The Old 97 (User: jbwharris)
Jungle - The Heat (User: jbwharris)
Hippo Campus - Think it Over (User: jbwharris)
Kurt Vile - How Lucky with John Prine (User: jbwharris)
Foo Fighters - Waiting on a War (User: jbwharris)
Loretta Lynn - Don't Come Home a' Drinkin' (With Lovin' on Your Mind) (User: jbwharris)
Frances Forever - Space Girl (User: jbwharris)
Passion Pit - Sleepyhead (User: jbwharris)
Jose Gonzalez - El Invento (User: jbwharris)
Hüsker Dü - Pink Turns to Blue (User: jbwharris)
Arlo Parks - Hurt (User: jbwharris)
Rainbow Kitten Surprise - Fever Pitch (User: jbwharris)
Django Django - Glowing in the Dark (User: jbwharris)
The Smashing Pumpkins - The Celestials (User: jbwharris)
SZA - Good Days (User: jbwharris)
My Morning Jacket - Feel You (User: jbwharris)
Tune-Yards - hold yourself (User: jbwharris)
The Replacements - Sixteen Blue (User: jbwharris)
Black Pumas - Colors (User: jbwharris)
Ani DiFranco - Simultaneously (User: jbwharris)
EOB - Shangri-La (User: jbwharris)
Kiss the Tiger - Starting to See You (User: jbwharris)
Kaleo - Break My Baby (User: jbwharris)
The Staves - Good Woman (User: jbwharris)
The Jon Spencer Blues Explosion - Bellbottoms (User: jbwharris)
Dinosaur Jr - I Ran Away (User: jbwharris)
Kiwi Jr. - Cooler Returns (User: jbwharris)
Sex Pistols - God Save the Queen (User: jbwharris)
Robyn Hitchcock - So You Think You're in Love (User: jbwharris)
ONR - Must Stop feat. Sarah Barthel (User: jbwharris)
Fountains of Wayne - Denise (User: jbwharris)
The Charlatans - Love Is the Key (User: jbwharris)
The Avalanches - The Divine Chord feat. MGMT and Johnny Marr (User: jbwharris)
Parliament - Chocolate City (User: jbwharris)
Lizzo - Like a Girl (User: jbwharris)
Jake Bugg - Two Fingers (User: jbwharris)
Lucero - Back in Ohio (User: jbwharris)
Kings of Leon - The Bandit (User: jbwharris)
Painted Shield - Knife Fight (User: jbwharris)
Lord Huron - Not Dead Yet (User: jbwharris)
Loretta Lynn - Who's Gonna Miss Me? (User: jbwharris)
The Breeders - Safari (User: jbwharris)
Turn Turn Turn - Cold Hard Truth (User: jbwharris)
Nick Cave and Warren Ellis - Albuquerque (User: jbwharris)
Johnyboy - VVV (User: jbwharris)
The Raconteurs - Now That You're Gone (User: jbwharris)
Low Cut Connie - Private Lives (User: jbwharris)
Modest Mouse - Autumn Beds (User: jbwharris)
Flock of Dimes - Two (User: jbwharris)
Neil Young - Rockin' in the Free World (User: jbwharris)
Cannons - Fire For You (User: jbwharris)
Depeche Mode - Never Let Me Down Again (User: jbwharris)
Japanese Breakfast - Be Sweet (User: jbwharris)
Sunflower Bean - Moment in the Sun (User: jbwharris)
Creedence Clearwater Revival - Commotion (User: jbwharris)
Superchunk - What a Time to Be Alive (User: jbwharris)
Miss Grit - Grow Up To (User: jbwharris)
Nathaniel Rateliff - Redemption (User: jbwharris)
Clairo - Sofia (User: jbwharris)
Jane's Addiction - Had a Dad (User: jbwharris)
Kathleen Edwards - Hard On Everyone (User: jbwharris)
Aimee Mann - Going Through the Motions (User: jbwharris)
Middle Kids - Questions (User: jbwharris)
Bessie Smith - Need a Little Sugar in My Bowl (User: jbwharris)
Tash Sultana - Sweet and Dandy (User: jbwharris)
Angel Olsen - What It Is (User: jbwharris)
Gorillaz - The Valley of The Pagans feat. Beck (User: jbwharris)
Arlo Parks - Green Eyes (User: jbwharris)
David Huckfelt - Bury Me Not (The Dying Cowboy) (User: jbwharris)
Loretta Lynn - Fist City (User: jbwharris)
Tai Verdes - Stuck in the Middle (User: jbwharris)
The Runaways - Cherry Bomb (User: jbwharris)
Brittany Howard - You And Your Folks, Me And My Folks (User: jbwharris)
Cherry Glazerr - Rabbit Hole (User: jbwharris)
Cat Power - Good Woman (User: jbwharris)
No Doubt - Just a Girl (User: jbwharris)
Christine and the Queens - I disappear in your arms (User: jbwharris)
Dylan Cartlidge - Molasses (Walk The Walk) (User: jbwharris)
Remi Wolf - Hello Hello Hello (User: jbwharris)
Blondie - Heart of Glass (User: jbwharris)
The New Pornographers - Your Hands (Together) (User: jbwharris)
Foushee - Deep End (User: jbwharris)
St. Vincent - Masseduction (User: jbwharris)
Anjimile - Baby No More (User: jbwharris)
Siouxsie and the Banshees - Dear Prudence (User: jbwharris)
Jose Gonzalez - El Invento (User: jbwharris)
The Staves - Satisfied (User: jbwharris)
Janis Joplin - Move Over (User: jbwharris)
Blu Detiger - Figure It Out (User: jbwharris)
Iceage - Vendetta (User: jbwharris)
Lykke Li - I Follow Rivers (User: jbwharris)
Seratones - Over You (User: jbwharris)
Ela Minus - dominique (User: jbwharris)
Loretta Lynn - Have Mercy (User: jbwharris)
Dessa - Rome (User: jbwharris)
Feist - Secret Heart (User: jbwharris)
Q - Take Me Where Your Heart Is (User: jbwharris)
The Hold Steady - Family Farm (User: jbwharris)
Elle King - Shame (User: jbwharris)
Pixies - Gigantic (User: jbwharris)
Wolf Alice - The Last Man on Earth (User: jbwharris)
FKA twigs - Don't Judge Me feat. Headie One and Fred Again (User: jbwharris)
HAIM - Now I'm in It (User: jbwharris)
Peggy Lee - Fever (User: jbwharris)
Kaleo - Break My Baby (User: jbwharris)
Lesley Gore - You Don't Own Me (User: jbwharris)
Helen Reddy - I Am Woman (User: jbwharris)
Queen Latifah - U.N.I.T.Y. (User: jbwharris)
Deap Vally - Smile More (User: jbwharris)
Chastity Brown - Golden (User: jbwharris)
Joan Jett and the Blackhearts - Bad Reputation (User: jbwharris)
Fiona Apple - Under the Table (User: jbwharris)
X-Ray Spex - Oh Bondage, Up Yours! (User: jbwharris)
Björk - Army of Me (User: jbwharris)
Disq - Daily Routine (User: jbwharris)
Queens of the Stone Age - I Sat by the Ocean (User: jbwharris)
Nur-D - BandAid prod. Cxdy (User: jbwharris)
Barry Gibb - Run To Me Feat. Brandi Carlile (User: jbwharris)
Phish - Bouncing Around the Room (User: jbwharris)
Margo Price - Pay Gap (User: jbwharris)
Monowhales - All Or Nothing (User: jbwharris)
Orbital - The Box (User: jbwharris)
Jenny Lewis - Red Bull & Hennessy (User: jbwharris)
Christine and the Queens - Damn (what must a woman do) (User: jbwharris)
Janet Jackson - Rhythm Nation (User: jbwharris)
Robyn - Dancing on My Own (User: jbwharris)
Tori Amos - God (User: jbwharris)
Florence + the Machine - Girl With One Eye (User: jbwharris)
Connection - Elastica (User: jbwharris)
Garbage - Stupid Girl (User: jbwharris)
Ibeyi - I Wanna Be Like You (User: jbwharris)
Beyoncé - BLACK PARADE (User: jbwharris)
Missy Elliott - The Rain (Supa Dupa Fly) (User: jbwharris)
Stevie Nicks - Edge of Seventeen (User: jbwharris)
Japanese Breakfast - Be Sweet (User: jbwharris)
Wolf Alice - Don’t Delete the Kisses (User: jbwharris)
Courtney Barnett - Nameless, Faceless (User: jbwharris)
Savages - I Am Here (User: jbwharris)
Björk - There’s More To Life Than This (Recorded live at the Milk Bar toilets) (User: jbwharris)
Neneh Cherry - Natural Skin Deep (User: jbwharris)
Goldfrapp - Strict Machine (User: jbwharris)
The Cardigans - My Favourite Game (User: jbwharris)
Siouxsie and the Banshees - Kiss Them for Me (User: jbwharris)
Blondie - Rapture (User: jbwharris)
Logic1000 - Like My Way (User: jbwharris)
Chromatics - Lady (User: jbwharris)
Empress Of - When I'm with Him (User: jbwharris)
The Resonaires - Standing With You (User: jbwharris)
Tierra Whack - Dora (User: jbwharris)
Mura Masa & Georgia - Live Like We’re Dancing (User: jbwharris)
Jackie Lynn - Casino Queen (User: jbwharris)
St. Panther - B.O.M.B. (User: jbwharris)
Mustafa - Air Forces (User: jbwharris)
The Rural Alberta Advantage - The Air (User: jbwharris)
Ben Folds Five - Air (User: jbwharris)
Good Times Ahead - Help Me! (User: jbwharris)
Vampire Weekend - This Life (User: jbwharris)
Phoenix - Courtesy Laughs (User: jbwharris)
The Verve - Blue (2016 Remastered) (User: jbwharris)
Arthur & Yu - The Ghost Of Old Bull Lee (User: jbwharris)
Keith Jarrett - Köln, January 24, 1975, Part II c (User: jbwharris)
Laraaji - Feeling Lovely (User: jbwharris)
Hideyuki Hashimoto - Melody (User: jbwharris)
Dave Depper - Copenhagen One (User: jbwharris)
Lonnie Liston Smith & The Cosmic Echoes - Colors of the Rainbow (User: jbwharris)
Noel Brass Jr. - Prism Jousting (User: jbwharris)
Lionmilk - good things happen, too (User: jbwharris)
Dezron Douglas & Brandee Younger - This Woman's Work (User: jbwharris)
Nils Frahm - O I End (User: jbwharris)
Ólafur Arnalds - Spiral (Sunrise Session) (User: jbwharris)
Teen Daze - The Frequency of the Universe (User: jbwharris)
Hollie Kenniff - Threshold II (User: jbwharris)
Harold Budd - Little Heart (User: jbwharris)
Billie Eilish - Therefore I Am (User: jbwharris)
The Strokes - Last Nite (User: jbwharris)
The Wild Feathers - Blue (User: jbwharris)
Franz Ferdinand - I'm Your Villain (User: jbwharris)
Tina Arena - Burn (User: jbwharris)
Yum Yuck - Flesh & Bone (User: jbwharris)
The Hold Steady - Family Farm (User: jbwharris)
Thundercat - Innerstellar Love (User: jbwharris)
Cage the Elephant - Spiderhead (User: jbwharris)
Arcade Fire - No Cars Go (User: jbwharris)
Francisco the Man - It's True, It's You (User: jbwharris)
Samm Henshaw - All Good (User: jbwharris)
Nat King Cole - The Game of Love (Mixed By Salaam Remi) (User: jbwharris)
Godspeed You! Black Emperor - Sleep (User: jbwharris)
Skegss - Wake Up (User: jbwharris)
Tessela - Channel (User: jbwharris)
MANU GRACE - Waiting for a Change (waiting, for a change) (User: jbwharris)
Tune-Yards - hold yourself. (User: jbwharris)
Oasis - Don't Look Back in Anger (User: jbwharris)
Rheostatics - Claire (User: jbwharris)
Queens of the Stone Age - I Never Came (User: jbwharris)
The Rapture - I Need Your Love (User: jbwharris)
The National - I Need My Girl (Live at Berkeley 9/24/18) (User: jbwharris)
The National - I Need My Girl (User: jbwharris)
Cracker - I Need Better Friends (User: jbwharris)
Grace Jones - I Need A Man (User: jbwharris)
The Marías - Jupiter (User: jbwharris)
The National - About Today (User: jbwharris)
The Comet Is Coming - Timewave Zero (User: jbwharris)
Car Seat Headrest - Times To Die (User: jbwharris)
Foo Fighters - Times Like These (User: jbwharris)
OutKast - The Times (User: jbwharris)
Jayda G - Both of Us (Edit) (User: jbwharris)
Snow Patrol - Chasing Cars (User: jbwharris)
Kylie Minogue vs. Paula Abdul - Cold Hearted Head (User: jbwharris)
East Village - Vibrato (User: jbwharris)
Noel Gallagher's High Flying Birds - Come On Outside (User: jbwharris)
Devon Gilfillian - Get Out And Get It (User: jbwharris)
Caesars - Candy Kane (User: jbwharris)
Hank Snow - I've Been Everywhere (Remastered) (User: jbwharris)
Andy Mason - Robin In The Rain (User: jbwharris)
Teletubbies - Teletubbies Theme (User: jbwharris)
The Funsize Guys - Jammin' In My Jammies (User: jbwharris)
Riders in the Sky - Jessie, the Yodelin' Cowgirl (User: jbwharris)
Steven Universe - Other Friends (User: jbwharris)
Sesame Street - There's A Big Heap Of Trash At The End Of The Rainbow (User: jbwharris)
Ray Parker Jr. - Ghostbusters (User: jbwharris)
Billy Kelly - Thank You For Joining The Happy Club (User: jbwharris)
Danny Kaye - There's a Hole in the Bottom of the Sea (User: jbwharris)
Jack Hartmann - Whole Lotta Love (User: jbwharris)
Sonya Issacs - Since I Gave My Heart Away (Single Version) (User: jbwharris)
Bob McGrath - Somebody Come & Play (User: jbwharris)
Adam Bryant - The Crabby Song (User: jbwharris)
Brian Doser - The ABC Medley (User: jbwharris)
Music Man - Silent 'e' (User: jbwharris)
Sebastian - Under The Sea (User: jbwharris)
Reading Rainbow - Reading Rainbow Theme Song (User: jbwharris)
Steve Blunt & Joseph Carringer - Kookaburra (User: jbwharris)
Gunnar Madsen - There's a Bowl of Milk in the Moonlight (User: jbwharris)
Pat Benatar - Future's So Bright I Gotta Wear Shades (User: jbwharris)
Peter Pan - Never Smile at a Crocodile (User: jbwharris)
Little Richard - On Top Of Spaghetti (User: jbwharris)
One Direction - What Makes You Beautiful (User: jbwharris)
Wayne Potash - Constantinople (User: jbwharris)
David S Polansky - Camel (User: jbwharris)
Elton John - Just Can't Wait To Be King (User: jbwharris)
Hockey Dad - Good Eye (User: jbwharris)
Cracker - Get Off This (User: jbwharris)
Arab Strap - The First Big Weekend (User: jbwharris)
Bombay Bicycle Club - How Can You Swallow So Much Sleep (User: jbwharris)
Ash - Girl From Mars (User: jbwharris)
Spiritualized - Ladies and Gentlemen We Are Floating in Space (User: jbwharris)
Willie Nelson - Hello Walls (User: jbwharris)
Tina Turner - I Don't Wanna Fight (User: jbwharris)
Lake Trout - Street Fighting Man (User: jbwharris)
Local H - All The Kids Are Right (User: jbwharris)
Kasabian - Shoot the Runner (User: jbwharris)
SLANDER, Said The Sky & JT Roach - Potions (User: jbwharris)
The Ruralists - Your Bones Get Old (User: jbwharris)
The National - Sorrow (User: jbwharris)
Elton John - Sixty Years On (User: jbwharris)
Billy Bragg - Levi Stubbs' Tears (User: jbwharris)
Jackson Browne - The Pretender (User: jbwharris)
Goldfinger - Superman (User: jbwharris)
Mitski - Two Slow Dancers (User: jbwharris)
The Dirty Nil - Blunt Force Concussion (User: jbwharris)
Forester - Undercover (User: jbwharris)
David Ellis - Misty Heights (User: jbwharris)
Fløris - Guns For Hire (User: jbwharris)
Chotto Ghetto - New Horror (User: jbwharris)
Tei Shi - Bassically (User: jbwharris)
Khruangbin - Shida (User: jbwharris)
Jessie Reyez - ROOF (User: jbwharris)
Thin Lizzy - Whiskey in the Jar (User: jbwharris)
The Raveonettes - I Wanna Be Adored (User: jbwharris)
Bob Marley & The Wailers - Is This Love (User: jbwharris)
Dawes - Who Do You Think You're Talking To? (User: jbwharris)
Joan Armatrading - Love And Affection (User: jbwharris)
Kelsey Waldon - Anyhow (User: jbwharris)
Jimmy Eat World - Get It Faster (User: jbwharris)
Sofía Valdés - The Sweet Escape (User: jbwharris)
Phoenix - Rome (User: jbwharris)
Arcade Fire - No Cars Go (User: jbwharris)
Born Gold - End of Days (User: jbwharris)
Emily Haines & The Soft Skeleton - Winning (User: jbwharris)
Eels - On the Ropes (User: jbwharris)
Luwten - Airport (User: jbwharris)
Brutus - Sand (User: jbwharris)
Harry Styles - Adore You (User: jbwharris)
Plaid - Mfaus (User: jbwharris)
The Dirty Nil - One More and the Bill (User: jbwharris)
