Gwen McCrae - Keep the Fire Burning (User: melons)
Jimmy Ray - Are You Jimmy Ray? (User: melons)
ARZ - Alone with You (User: melons)
Honey Dijon - Not About You (feat. Hadiya George) (User: melons)
Swedish House Mafia - Don't You Worry Child - Radio Edit (User: melons)
Chaka Khan - I Feel For You (User: melons)
Diane Birch - Nite Time Talking (User: melons)
Logic1000 - Therapy (User: melons)
Carl Carlton - She's A Bad Mama Jama (She's Built, She's Stacked) (User: melons)
Midas Hutch - I'm Really Hot (Midas Hutch Remix) (User: melons)
Patrice Rushen - Forget Me Nots (12' Remix) (User: melons)
Theon Cross - Forward Progression II (User: melons)
Bomba Estéreo - Agua (User: melons)
Crudo Means Raw - Maria (User: melons)
Bomba Estéreo - Conexión Total (feat. Yemi Alade) (User: melons)
Bomba Estéreo - Deja (User: melons)
Bomba Estéreo - Say Yo (User: melons)
The Chemical Brothers - Hey Boy Hey Girl (User: melons)
Bomba Estéreo - Tombarero (User: melons)
Los Gaiteros de San Jacinto - Un fuego de sangre pura (User: melons)
Willie Colón & Rubén Blades - Plastico (User: melons)
The Rolling Stones - Emotional Rescue (User: melons)
Bomba Estéreo - Amor Amor (User: melons)
David Holmes - Hope The Last Thing To Die (Timmy Stewart 11th Hour Mix) (User: melons)
Anthony B - Intro (User: melons)
Hey Colossus - The Mirror (User: melons)
Tsha - Power (Floorplan Remix) (User: melons)
Port Noise Complaint - St. Crispins Eve (User: melons)
ANZ - Real Enough To Feel Good (User: melons)
Hagan - Porto's Groove (User: melons)
Pahua & Barzo - El Traketeo (User: melons)
Daniel Casimir - Safe (Part 3) (User: melons)
BADBADNOTGOOD - Talk Meaning (User: melons)
Crooked Sound - Where's the Duffel Bag (User: melons)
Tirzah - Hips (User: melons)
Sangre Nueva - Sola (User: melons)
Colloboh - Reason (feat. Bahdboi Ena) (User: melons)
Tiawa - Soldiers (WheelUp Remix) (User: melons)
Disclosure - In My Arms (User: melons)
Talk Talk - Inheritance (User: melons)
Maya Jane Coles - Night Creature (User: melons)
Superstate - Uncle Sam (User: melons)
Folly Group - Butt No Rifle (User: melons)
Squarepusher - U.F.O.'s Over Leytonstone (User: melons)
The Flirtations - Nothing But A Heartache (User: melons)
ishmael ensemble - The Gift (User: melons)
A Tribe Called Quest - Bonita Applebum (User: melons)
Bruce Springsteen - Thunder Road (User: melons)
CHVRCHES - Recover (User: melons)
The Wild Swans - Bringing Home the Ashes (User: melons)
The Darling Buds - Burst (User: melons)
Secret Affair - My World (User: melons)
The Tourists - So Good To Be Back Home Again (User: melons)
Mi-Sex - People - 2007 Remastered (User: melons)
The Men They Couldn't Hang - Rain, Steam And Speed (User: melons)
The Quick - The Rhythm of the Jungle (User: melons)
Spliff - Sweet As Radio (User: melons)
The Outfield - Your Love (User: melons)
Eurogliders - Heaven (Must Be There) (User: melons)
The Only Ones - Baby's Got A Gun - 2008 re-mastered version (User: melons)
New Musik - Living By Numbers (User: melons)
Care - Flaming Sword (User: melons)
Gazebo - I Like Chopin - Single Edit (User: melons)
The Vibrators - Jesus Always Lets You Down (User: melons)
John Farnham - Pressure Down (User: melons)
Far Corporation - Rainy Days (User: melons)
Latin Quarter - No Ordinary Return (User: melons)
Bruce Woolley & The Camera Club - Video Killed The Radio Star (User: melons)
The Photos - Irene (User: melons)
Gary Myrick - She Talks In Stereo (User: melons)
Herman Brood & His Wild Romance - Stay Alive (User: melons)
Bruce Foxton - Freak (User: melons)
The Romantics - Talking in Your Sleep (User: melons)
The Sinceros - Disappearing (User: melons)
Lisa Marie - Something's Jumpin' in Your Shirt (with Malcolm McLaren & The Bootzilla Orchestra) (User: melons)
The Sinceros - Disappearing (User: melons)
The Hooters - And We Danced (User: melons)
The Godfathers - Birth, School, Work, Death (User: melons)
Alvvays - Archie, Marry Me (User: melons)
Hanoi Rocks - Up Around the Bend (User: melons)
UNiiQU3 - Microdosing (User: melons)
H2O - Dream To Sleep (User: melons)
Wax - Bridge to Your Heart (User: melons)
Django Django - Default (User: melons)
Spear of Destiny - Liberator (User: melons)
Sweatson Klank - Mista Linen (User: melons)
Hurrah! - Sweet Sanity (User: melons)
Metronomy - 405 (feat. Biig Piig) (User: melons)
Romeo Void - A Girl In Trouble (Is A Temporary Thing) (User: melons)
The Only Ones - Another Girl, Another Planet (User: melons)
Poly Styrene - Dreaming (User: melons)
Burhan Öçal - Yenilik, Pt. 8 (User: melons)
Burhan Öçal - Yenilik, Pt. 8 (User: melons)
BDRMM - Gush (User: melons)
White Denim - Ha Ha Ha Ha Yeah! (6 Music Session, 15 Feb 2016) (User: melons)
Squadrum - Rumors - Angelo Raguso Remix (User: melons)
Pip Blom - You Don't Want This (User: melons)
Lantern - Bleed Me Dry (User: melons)
Main Source - Fakin' The Funk (Remix) (User: melons)
SIX - Six (User: melons)
Ars Amandi - Tu Ley (User: melons)
Remi Wolf - Quiet On Set (User: melons)
Barzak - Tahader Ghrina Kori (User: melons)
Cat Power - Bad Religion (User: melons)
DJ ORCUN - Riddim Up (User: melons)
ukiyo - Something Like This (User: melons)
Unknown Mortal Orchestra - That Life (User: melons)
Daft Punk - Technologic (User: melons)
Os Ritmistas - Abeue (User: melons)
Greg Koch - Miramannee (User: melons)
Bend the sky - Intro (User: melons)
New Order - Temptation (User: melons)
Paul Oakenfold - Starry Eyed Surprise (feat. Shifty Shellshock) (User: melons)
She Drew the Gun - Behave Myself (User: melons)
Sufjan Stevens & Angelo De Augustine - Back To Oz (User: melons)
Gwen McCrae - All This Love That I'm Giving (User: melons)
She Drew the Gun - Cut Me Down (User: melons)
Johnny Marr - Spirit, Power & Soul (User: melons)
The Allergies - Move On Baby (User: melons)
Leftfield - Release the Pressure (User: melons)
Eels - Good Night On Earth (User: melons)
Jordan Rakei - Send My Love (User: melons)
Stealing Sheep - Jokin' Me (User: melons)
The Pogues - Fiesta (User: melons)
Hole - Celebrity Skin (User: melons)
Yard Act - The Overload (User: melons)
The Lounge Society - Last Breath (User: melons)
Bessie Turner - Rushing (User: melons)
Simian Mobile Disco - Audacity of Huge (User: melons)
White Lies - As I Try Not To Fall Apart (User: melons)
The Beach Boys - Good Vibrations (User: melons)
ishmael ensemble - The Gift (User: melons)
The Open - Elevation (User: melons)
Sports Team - Camel Crew (User: melons)
John - Sibensko Powerhouse (User: melons)
Oasis - Acquiesce (User: melons)
Kraftwerk - Computer Love (User: melons)
Bizarre Inc - Playing With Knives (User: melons)
Elbow - Leaders of the Free World (User: melons)
M.I.A. - Galang '05 (User: melons)
Peter Gabriel - Sledgehammer (User: melons)
The Maccabees - Marks To Prove It (User: melons)
Shaft - Roobarb & Custard (User: melons)
The Beloved - The Sun Rising (User: melons)
Martha Reeves And The Vandellas - Heat Wave (User: melons)
The Beat - Tears of a Clown (User: melons)
R.E.M. - It's the End of the World as We Know It (and I Feel Fine) (User: melons)
The Hives - Hate to Say I Told You So (User: melons)
Arrested Development - People Everyday (User: melons)
Riton & Kah‐Lo - Fake ID (User: melons)
Omni Trio - Renegade Snares (User: melons)
Penelope Isles - Iced Gems (User: melons)
Queen Latifah - She's A Queen (feat. Tha Rayne) (User: melons)
The Allergies - New Thing (User: melons)
Nation of Language - This Fractured Mind (User: melons)
Aphex Twin - Windowlicker (User: melons)
Mood II Swing - Move Me (User: melons)
Chaos in the CBD - Echolocation (User: melons)
Melancholy Man - Precaution (Unreleased Mix 3) (User: melons)
QX-1 - On A Journey (Journey Mental Mix) (User: melons)
2 Da Rhythm - A Special Groove (2 Da Rhythm dub) (User: melons)
The Language - 1990 (Unreleased Demo 1) (User: melons)
Lost - Baz De Conga (User: melons)
Phil Stroud - Yemaja (Chaos In The CBD Remix) (User: melons)
Ron Trent - Welcome "1984" (User: melons)
Dip In The Pool - What About This Love (Chaos In The CBD Remix) (User: melons)
Floating Points - LesAlpx (User: melons)
Flore - Monroe (User: melons)
Salt‐N‐Pepa - My Mike Sounds Nice (User: melons)
Kojey Radical - War Outisde (feat. Lex Amor) (User: melons)
Radiohead - If You Say the Word (User: melons)
Desmond Dekker & The Aces - Israelites (User: melons)
Queens of the Stone Age - No One Knows (User: melons)
Joan As Police Woman, Tony Allen & Dave Okumu - Take Me To Your Leader (User: melons)
Sweat - What Men Want (Loraine James Remix) (User: melons)
The Specials - Freedom Highway (User: melons)
Moses Boyd - 2 Far Gone (User: melons)
ANZ - Real Enough To Feel Good (User: melons)
Susanna Kwan - 講不出聲 - (劇集 "溏心風暴" 主題曲) (User: melons)
Maya Jane Coles - Night Creature (User: melons)
Bruno Coulais - Les Choristes (User: melons)
Yazoo - Situation (User: melons)
Pearl Jam - Even Flow (User: melons)
Dele Sosimi - You No Fit Touch Am - Medlar Remix (User: melons)
George Fitzgerald - Roll Back (User: melons)
Self Esteem - How Can I Help You (User: melons)
Drive-By Bukkake - Joe Pesci's Cum Dumpster (User: melons)
Grace Jones - Williams' Blood (User: melons)
DJ M@R - B.Boy Style (User: melons)
Burial - Archangel (User: melons)
Vijay Kannan - Release (User: melons)
The Vichy Government - Make Love to the Camera (User: melons)
Robert Hood - Nothing Stops Detroit (User: melons)
Tesfa-Maryam Kidane - Heywete (User: melons)
Gorillaz - Meanwhile (feat. Jelani Blackman & Barrington Levy) (User: melons)
Liquideep - Alone - Original Mix (User: melons)
Marvin Gaye - Inner City Blues (Make Me Wanna Holler) (User: melons)
Weaver - N.R.G. (User: melons)
The White Stripes - My Doorbell (User: melons)
Mad Dog Fire Department - Cosmic Funk (User: melons)
Smith & Mighty - Anyone (feat. Jackie Jackson) (User: melons)
Hiatus Kaiyote - Red Room (User: melons)
Warmduscher - Wild Flowers (User: melons)
The Moody Blues - Go Now! (User: melons)
Folly Group - Butt No Rifle (User: melons)
Andrea True Connection - More, More, More, Pt. 1 - "A Tom Moulton Mix" (User: melons)
Bow Wow Wow - C30 C60 C90 Go (User: melons)
Curtis Harding - Can't Hide It (User: melons)
Barrie - Dig (User: melons)
Beck - Debra (User: melons)
Cat Power - Bad Religion (User: melons)
Hembree - Operators (feat. Bodye) (User: melons)
Charlotte Adigéry & Bolis Pupul - Thank You (User: melons)
Holy F & Sarah Bonito - Airport Dreams (User: melons)
Boys Noize & Abra - Affection (User: melons)
Iraina Mancini - Do It (You Stole the Rhythm) (User: melons)
Swine Tax - Kestrel Of Sticking Dreams (User: melons)
KUUNATIC - Desert Empress Part 1 (User: melons)
Deap Vally - Magic Medicine (User: melons)
The Bug Club - The Fixer (User: melons)
Odd Morris - Silhouette (User: melons)
Bleach Lab - Violet Light (User: melons)
The Mysterines - Hung Up (User: melons)
DAMEFRISØR - Do You Think I'm Special? (User: melons)
Dirty Nice - Paint Your Nails Blue (User: melons)
Phoebe Green - So Grown Up (User: melons)
TV Priest - Lifesize (User: melons)
The Specials - Black, Brown And White (User: melons)
The Lathums - I Won't Lie (User: melons)
Suep - Domesticated Dream (User: melons)
Yard Act - The Overload (User: melons)
Curtis Amy - Mustang (User: melons)
Tom Waits - Big Black Mariah (User: melons)
Nervous Norvus - Transfusion (User: melons)
Brigitte Bardot - Harley Davidson (User: melons)
Stornoway - Fuel Up (User: melons)
Kraftwerk - Autobahn (User: melons)
Black Box Recorder - The English Motorway System (User: melons)
John Shuttleworth - Y Reg (User: melons)
UK Subs - Live in a Car (User: melons)
Deep Purple - Highway Star (User: melons)
The Skatalites - Road Block (User: melons)
The Teen Rockers - Road Block (User: melons)
Billy Bragg - A13 - BBC Session 27/07/1983 (User: melons)
Nat King Cole - Route 66 (User: melons)
Dave Dudley - Six Days On The Road (User: melons)
Michel Legrand - The Race, First Laps (User: melons)
Lalo Schifrin - Shifting Gears (User: melons)
Saint Etienne - Like a Motorway (User: melons)
DJ Shadow - Mashin' on the Motorway (User: melons)
Gary Numan - Cars (Radio 1 John Peel Session, 29 May 1979) (User: melons)
Joni Mitchell - Car on a Hill (User: melons)
Curtis Gordon - Draggin' (User: melons)
The Fall - Container Drivers (User: melons)
Ministry - Jesus Built My Hot Rod (User: melons)
Charlie Ryan & The Livingston Brothers - Hot Rod Lincoln (User: melons)
Martha Reeves And The Vandellas - Motoring (User: melons)
Richard Thompson - 1952 Vincent Black Lightning (User: melons)
Yo La Tengo - Speeding Motorcycle (User: melons)
Stereolab - Speedy Car (User: melons)
Mickey Jupp - Chevrolet (User: melons)
Bo Diddley - Cadillac (User: melons)
Vince Taylor - Brand New Cadillac (User: melons)
The Rapiers - Breakfast At the Ace (User: melons)
Woody Guthrie - Car Song (User: melons)
Marcos Valle - Mustang Cor de Sangue (User: melons)
Chuck Berry - My Mustang Ford (User: melons)
Lucinda Williams - Car Wheels On A Gravel Road (User: melons)
The Rockingbirds - Time Drives The Truck (Radio 1 Session, 29 Jul 1992) (User: melons)
Julian Cope - Drive, She Said (User: melons)
my bloody valentine - Drive It All Over Me (User: melons)
The Deuce Coupes - Gear Masher (User: melons)
The Wave Pictures - Long Black Cars (User: melons)
The Crestones - She's a Bad Motorcycle (User: melons)
The Revillos - Motor Bike Beat (User: melons)
L.A. Witch - Motorcycle Boy (User: melons)
Adam and the Ants - Car Trouble (User: melons)
Mighty Mighty - Built Like A Car (Radio 1 Session, 4th Jan 1987) (User: melons)
Big Audio Dynamite - Medicine Show (User: melons)
Psychic TV - Godstar (User: melons)
Half Man Half Biscuit - The Trumpton Riots (User: melons)
The Godfathers - Lonely Man (User: melons)
Tom Petty & The Heartbreakers - Learning to Fly (User: melons)
Sea Power - Two Fingers (User: melons)
Bas Jan - You Have Bewitched Me (User: melons)
Jon Langford's Men of Gwent - Dirty Grey River (User: melons)
Slow Club - Come On Poet (6 Music session for Marc Riley 170816) (User: melons)
christian fitness - male guitarist (User: melons)
AC/DC - Highway to Hell (User: melons)
Rufus Wainwright - Alone Time (User: melons)
Richard Dawson & Circle - Lily (User: melons)
Unknown Mortal Orchestra - That Life (User: melons)
Chaka Khan - I Feel For You (User: melons)
Marissa Nadler - Couldn't Have Done The Killing (User: melons)
Slow Club - Ancient Rolling Sea (6 Music session for Marc Riley 170816) (User: melons)
The Bug Club - My Baby Loves Rock And Roll Music (User: melons)
Warmduscher - Wild Flowers (User: melons)
Ty Segall - Pictures (User: melons)
Everything But the Girl - Missing - Todd Terry Club Mix / US Radio Edit (User: melons)
The Three Johns - Death of the European (User: melons)
The Lounge Society - Last Breath (User: melons)
Tony Scott - What Am I to Do (User: melons)
Sufjan Stevens & Angelo De Augustine - Back To Oz (User: melons)
Pa Salieu - Style & Fashion (feat. Obongjayar) (User: melons)
The Underdogs - East of Dachau (User: melons)
Cheryl Lynn - Got to Be Real - single version (User: melons)
First Class - Beach Baby - Re-Recorded (User: melons)
Metronomy - 405 (feat. Biig Piig) (User: melons)
Sammy Johns - Chevy Van (User: melons)
Menswear - I'll Manage Somehow (User: melons)
OMC - How Bizarre (User: melons)
Vanity Fare - Hitchin' A Ride - Re-Recorded (User: melons)
Faithless - Insomnia (User: melons)
Vanity Fare - Hitchin' A Ride - Re-Recorded (User: melons)
Yard Act - The Overload (User: melons)
Carl Douglas - Kung Fu Fighting (User: melons)
Sinéad O'Connor - Nothing Compares 2 U (User: melons)
The Wiseguys - Start the Commotion (User: melons)
Urge Overkill - Girl, You'll Be a Woman Soon (User: melons)
Marc Anthony - You Sang To Me (User: melons)
IDLES - The Beachland Ballroom (User: melons)
Talking Heads - Once in a Lifetime (User: melons)
Hum - Stars (User: melons)
The Buggles - Video Killed the Radio Star (User: melons)
EERA - Ladder (User: melons)
The System - You Are in My System (User: melons)
Teena Marie - Behind the Groove (User: melons)
The Georgia Satellites - Keep Your Hands to Yourself (User: melons)
The Main Ingredient - Everybody Plays the Fool (User: melons)
Atari Teenage Riot - Speed (User: melons)
The Ataris - Make it Last (User: melons)
Duncan Sheik - Wishful Thinking - 45 Version (User: melons)
Jimmy Somerville - Comment Te Dire Adieu (With June Miles Kingston) (User: melons)
New Kids on the Block - This One's for the Children (User: melons)
Halo James - Could Have Told You So (User: melons)
Bruce Hornsby - The Way It Is (User: melons)
Geno Washington & The Ram Jam Band - If This Is Love (I'd Rather Be Lonely) (User: melons)
King Tubby - Keep On Dubbing (User: melons)
Thurston Harris - Little Bitty Pretty One (User: melons)
The Beatles - Michelle - Remastered 2009 (User: melons)
Cocktail Martino - Se mi vuoi (User: melons)
The Beatles - Michelle - Remastered 2009 (User: melons)
Pixies - St. Nazaire (User: melons)
Mac DeMarco - Baby You're Out (User: melons)
The Magnetic Fields - Busby Berkeley Dreams (User: melons)
Public Enemy - Shut Em Down - Pe-te Rock Mixx (User: melons)
Chic - I Want Your Love - 2018 Remaster (User: melons)
The Lowest Pair - Sweet Breath (User: melons)
My Auxiliary Ego - Frozen Statuette (User: melons)
Latoya Jackson - Bet'cha Gonna Need My Lovin' (User: melons)
Peacefield - Warmer Side of the Street (User: melons)
Son, Ambulance - The Invention of Beauty (User: melons)
Normani - Wild Side (feat. Cardi B) (User: melons)
Little Brother - The Way You Do It (User: melons)
Indigo De Souza - Take Off Ur Pants (User: melons)
Boon - Don't Worry (User: melons)
Taggy Matcher - Lonely Boy (User: melons)
Babe the Blue Ox - D Boon (User: melons)
Boon - Don't Worry (User: melons)
Babe the Blue Ox - D Boon (User: melons)
Andy Hodder - Flying (User: melons)
Hopeton Lewis - Cool Collie (User: melons)
The Alan Parsons Project - Old And Wise (User: melons)
Morrissey - Billy Budd - 2014 Remaster (User: melons)
Barry Manilow - Mandy (User: melons)
The Spinto Band - Oh Mandy (User: melons)
Desireless - Voyage voyage (User: melons)
Scrilla - Sp!N (User: melons)
Renegade Soundwave - Renegade Soundwave (User: melons)
Dungen - Fredag (User: melons)
Jim Noir - I Me You I'M Your (User: melons)
Thee Oh Sees - Toe Cutter - Thumb Buster (User: melons)
See See Rider - She Sings Alone (User: melons)
Ocean Grove - Sway (User: melons)
languid.oceans - sway in the morn (User: melons)
Esther Phillips - The Crying Blues (User: melons)
Say Ocean - Amnesia (User: melons)
The Jazz Butcher - Nothing Special (User: melons)
Mr Twin Sister - Meet the Frownies (User: melons)
The Emotionals - Cheat On Me (User: melons)
The Ammonites - Missing You (User: melons)
Hey Paulette - I Really Do Love You Penelope (User: melons)
Horse Latitudes - What Is More Than Life (User: melons)
Little Red Schoolhouse - When I Find You (User: melons)
The Chrysalids - My Heart Is Where My Home Is (User: melons)
Debby Boone - You Light up My Life (User: melons)
Hindu Love Gods - Raspberry Beret (User: melons)
AVO-8 - Out Of My Mind (User: melons)
The Ogdens - She Made Everything Groovy (User: melons)
The Montgomery Clifts - Lovesville USA (User: melons)
How Many Beans Make Five - Learning To Keep My Mouth Shut (User: melons)
The Physics House Band - Titan (User: melons)
Jane Pow - Good morning (User: melons)
Po! - Sunday Never Comes Around (User: melons)
Jane From Occupied Europe - Little Valley Town (User: melons)
The Kennedy Pill - Beside The Sea (User: melons)
The Sunflowers - Twenty-Fifteen (User: melons)
The Steamkings - Dead Like You (User: melons)
Shakespears Sister - I Don't Care (User: melons)
Penelope's web - Potboiler (User: melons)
DJ Shadow - Scale It Back (User: melons)
Bark Psychosis - I Know (User: melons)
Saint Etienne - Only Love Can Break Your Heart (User: melons)
All Over The Place - Strange (User: melons)
Mousefolk - Crazy Mixed Up Kid (User: melons)
Robiq - Game Over (User: melons)
Greenhouse - Mad As Love (User: melons)
The Hectics - Bath Mat (User: melons)
Sandkings - Earthwheel (User: melons)
Something Pretty Beautiful - Amnesia (User: melons)
The Charlatans - Polar Bear (User: melons)
Raintree County - Take (User: melons)
James Dean Driving Experience - Sean Connery (User: melons)
Milltown Brothers - Seems to Me (User: melons)
Honey Smugglers - Listen (User: melons)
The Seers - Sun is in the Sky (User: melons)
The Telescopes - To Kill a Slow Girl Walking (User: melons)
Ned's Atomic Dustbin - Aim (User: melons)
The Boo Radleys - Swansong (User: melons)
Moonflowers - Get Higher (User: melons)
Kamura Obscura - Nina Bargain (Disco Remix) (User: melons)
Blue Orchids - Bad Education (User: melons)
Pete Astor - Really Something (User: melons)
Northside - My Rising Star (User: melons)
Barrington Levy - Here I Come (User: melons)
Sega Bodega - Angel On My Shoulder (User: melons)
The Nightingales - Gales Doc (User: melons)
ishmael ensemble - The Gift (User: melons)
Sigrid - Strangers (User: melons)
Anderson Rocio - Paradise (User: melons)
Mogwai - Richie Sacramento (Other Two Remix) (User: melons)
The Weather Station - Better Now (User: melons)
Clairo - Hello? (User: melons)
Gustaf - The Motions (User: melons)
Senser - Age of Panic (User: melons)
Its amazing - Karl Heinz Loges and His Music (User: melons)
Radiohead - If You Say the Word (User: melons)
Miriam Makeba - Pata Pata (User: melons)
Kate Bush - Cloudbusting (User: melons)
Kevin Macleod - Local Forecast - Elevator (User: melons)
Desire Marea - You Think I'm Horny (planningtorock's planningtobehorny version) (User: melons)
Jack Seymour - Birds Of Aston (User: melons)
Samantha Crain - Pick Apart (User: melons)
David Rose Project Orchestra - Holiday for Strings (User: melons)
Cocktail Martino - Se mi vuoi (User: melons)
Piero Umiliani - Città Amica - Original Version (User: melons)
Four Tet - Two Thousand And Seventeen (User: melons)
Clay Pitts - Caribbean Sunrise (User: melons)
ANZ - Real Enough To Feel Good (User: melons)
Dave Grusin - The Girl From U.N.C.L.E. (User: melons)
John - Sibensko Powerhouse (User: melons)
Piero Piccioni - North Pole Penguin (User: melons)
Walter Wanderley Trio - A Man And A Woman (User: melons)
black midi - Talking Heads (User: melons)
Tyrone Davis - Can I Change My Mind (User: melons)
Bebel Gilberto - So Nice (Summer Samba) (User: melons)
Robert Glasper - Shine (feat. D Smoke & Tiffany Gouché) (User: melons)
Oregon Bike Trails - Cayucas (User: melons)
The Clash - Janie Jones - Remastered (User: melons)
Kay Starr - Comes Along a Love (User: melons)
Pete Astor - Almost Falling In Love (User: melons)
Blue Orchids - Bad Education (User: melons)
my bloody valentine - Soon (User: melons)
Antônio Carlos Jobim - Águas de março (User: melons)
Astrud Gilberto - How Insensitive (User: melons)
Bonobo - Rosewood (User: melons)
Sergio Mendes & Brasil '66 - Mais Que Nada (User: melons)
Tin Machine - I Can't Read - 1999 Remaster (User: melons)
Metronomy - 405 (feat. Biig Piig) (User: melons)
Paul Desmond - Take Ten (User: melons)
Shygirl - FREAK (User: melons)
Herb Alpert & The Tijuana Brass - A Taste Of Honey (User: melons)
United Guitar Players - Mas Que Nada (In The Style Of Sergio Mendes Jorge Ben Marc Antoine) [Instrumental Version] (User: melons)
Flying Lotus - Do the Astral Plane (User: melons)
Guitar Duo - Mas Que Nada (User: melons)
Wes Montgomery - Tequila (User: melons)
Janet Jackson - Feedback (User: melons)
Bob Brookmeyer - A Felicidade (User: melons)
Lalo Schifrin - Danube Incident (User: melons)
LoneLady - (There Is) No Logic (User: melons)
Tamba Trio - Influência Do Jazz (User: melons)
Strangers In Eden - Twist of the Knife (User: melons)
The Time - 777-9311 (User: melons)
Naughty Boy - La La La (User: melons)
N*E*R*D - She Wants to Move (User: melons)
Josin - In The Blank Space (User: melons)
IDLES - The Beachland Ballroom (User: melons)
Ólafur Arnalds - The Bottom Line (feat. Josin) (User: melons)
Gang of Youths - Go Farther in Lightness (User: melons)
Led Zeppelin - Rock and Roll (User: melons)
Brentford All Stars - Greedy G (User: melons)
Disclosure - In My Arms (User: melons)
Antônio Carlos Jobim - Wave (User: melons)
Walter Wanderley - Meditation (User: melons)
Snoop Dogg - Vapors (User: melons)
Roberto Menescal E Seu Conjunto - Surfboard (User: melons)
Bozambo - Kombissé (User: melons)
Beastie Boys - Shadrach (User: melons)
Marvin Gaye - Give A Little Love (User: melons)
System of a Down - Toxicity (User: melons)
Bay City Rollers - Give a Little Love - U.S. Version (User: melons)
She Drew the Gun - Behave Myself (User: melons)
GoGo Penguin - Hopopono (User: melons)
Paul Williams - An Old Fashioned Love Song (User: melons)
Blondie - Rapture (User: melons)
Manfred Mann - My Name Is Jack (User: melons)
Pharrell Williams - Frontin' (feat. Jay-Z) (User: melons)
Gary Numan - My Name Is Ruin (User: melons)
King Sporty & The Root Rockers - Get On Down (User: melons)
Prince - My Name Is Prince (User: melons)
The Bar‐Kays - Shake Your Rump To The Funk (User: melons)
Silvery - You Give A Little Love (User: melons)
Scratcha DVA & :3lon - Flex (User: melons)
Weezer - My Name Is Jonas (User: melons)
Titanic - Macumba (User: melons)
Deap Vally - Magic Medicine (User: melons)
Paul Williams - My Name Is Tallulah - From "Bugsy Malone" Original Motion Picture Soundtrack (User: melons)
Bessie Turner - Rushing (User: melons)
Supergrass - Lenny (User: melons)
Paul Williams - You Give A Little Love - From "Bugsy Malone" Original Motion Picture Soundtrack (User: melons)
The Specials - Everybody Knows (User: melons)
The Selecter - On My Radio (User: melons)
Camera Obscura - Lloyd, I'm Ready To Be Heartbroken (User: melons)
The Zombies - Care of Cell 44 (User: melons)
Neal Francis - Can't Stop The Rain (User: melons)
Gorillaz - Meanwhile (feat. Jelani Blackman & Barrington Levy) (User: melons)
Marcia Aitken - I'm Still In Love (With You) (User: melons)
Afroman - Because I Got High (User: melons)
Bran Van 3000 - Drinking in L.A. (User: melons)
Freak Power - Turn On, Tune In, Cop Out (User: melons)
Small Faces - Lazy Sunday (User: melons)
Simon & Garfunkel - The 59th Street Bridge Song (Feelin' Groovy) (User: melons)
Virginia Astley - From Gardens Where We Feel Secure (User: melons)
Jordan Rakei - Send My Love (User: melons)
Caribou - Can't Do Without You (User: melons)
Gustaf - Best Behavior (User: melons)
Self Esteem - How Can I Help You (User: melons)
Sleaford Mods - Mork n Mindy (feat. Billy Nomates) (User: melons)
Mungo's Hi Fi & Pupajim - Bike Rider (User: melons)
Maya Jane Coles - Night Creature (User: melons)
Conquering Lion - Code Red (User: melons)
Orange Juice - Rip It Up (User: melons)
Pearl & The Oysters & Kuo-Hung Tseng - Soft Science (User: melons)
Penelope Isles - Iced Gems (User: melons)
The Beta Band - Assessment (User: melons)
Robert Plant & Alison Krauss - High and Lonesome (User: melons)
Unknown Mortal Orchestra - That Life (User: melons)
Cymande - Bra (User: melons)
The Lovin' Spoonful - Daydream (User: melons)
Sufjan Stevens & Angelo De Augustine - Back To Oz (User: melons)
Fana Hues - Icarus (User: melons)
Sans Soucis & Cécile Kyenge - Games (User: melons)
Q‐Tip - Breathe and Stop (User: melons)
Nation of Language - This Fractured Mind (User: melons)
Gary Numan - Cars (User: melons)
Crosby, Stills & Nash - Marrakesh Express (User: melons)
OutKast - Ghetto Musick (User: melons)
Yard Act - The Overload (User: melons)
Rocket from the Crypt - On a Rope (User: melons)
Pet Shop Boys - West End Girls (User: melons)
Radiohead - If You Say the Word (User: melons)
M83 - Kim & Jessie (User: melons)
Weezer - Buddy Holly (User: melons)
Los Bitchos - Las Panteras (User: melons)
Liz Lawrence - Drive (User: melons)
Zero 7 - Destiny (User: melons)
Metronomy - 405 (feat. Biig Piig) (User: melons)
Toots & The Maytals - 54-46 Was My Number (User: melons)
The Districts - I Want to Feel It All (User: melons)
Sharon Van Etten - Give Out (User: melons)
Johnny Marr - Spirit, Power & Soul (User: melons)
Joan as Police Woman - Holy City (User: melons)
Public Image Ltd - Rise (User: melons)
John - Sibensko Powerhouse (User: melons)
Four Tet - As Serious as Your Life (User: melons)
De La Soul - Eye Know (User: melons)
John Grant - Down Here (6 Music Session, 1 Oct 2015) (User: melons)
Pa Salieu - Style & Fashion (feat. Obongjayar) (User: melons)
Underworld - Born Slippy (User: melons)
IDLES - The Beachland Ballroom (User: melons)
Black Rebel Motorcycle Club - Spread Your Love (User: melons)
Culture - Lion Rock (User: melons)
The Monkees - Cuddly Toy - 2007 Remaster (User: melons)
John Lennon - Peggy Sue - Remastered 2010 (User: melons)
The Charlatans - Just When You're Thinkin' Things Over (User: melons)
Doris - Did You Give the World Some Love Today, Baby (User: melons)
Julian Cope - World Shut Your Mouth (User: melons)
Paul Young - Wonderland (User: melons)
Imfromull - DiscoDaze Mix - Show 214 - 08.10.21 (User: melons)
Don Johnson - Heartbeat (User: melons)
Mouse on Mars - Presence (Radio 1 Session, 2 May 2001) (User: melons)
girl with the replaceable head - Ghost Rider (User: melons)
The Jazz Butcher - Girlfriend (User: melons)
Jerry Reed - Endless Miles Of Highway (User: melons)
Real Lies - North Circular (User: melons)
Groove Farm - Turning Me Upside Down (Radio 1 Session, 25th Mar 1987) (User: melons)
Groove Farm - Baby Blue Marine (Radio 1 Session, 25th Mar 1987) (User: melons)
Can - Spoon (User: melons)
Hotmood - Miami Disco (User: melons)
Laura Lee & the Jettes - Caterpillar (User: melons)
Phonk d - Jam To The Mother (User: melons)
Cabaret Voltaire - Kino (Radio 1 Janice Long Session, 10 Oct 1984) (User: melons)
Saison - Top Bunk Boogie (User: melons)
Barry Adamson - Broken Moments (User: melons)
Sartorial - Sartorial's Day Off (User: melons)
Tommy McCook Quartet - Dynamite (User: melons)
Parquet Courts - Walking At A Downtown Pace (User: melons)
Neil Young & Crazy Horse - Like a Hurricane (User: melons)
Groovemasta - Right Behind You (User: melons)
Disco Lust - Feel The Beat (User: melons)
Ezra Furman - Trans Mantra (User: melons)
The Magic Track - Run Deep (User: melons)
Metronomy & Sorry - Out of Touch (User: melons)
Kristoff MX - About A Woman (User: melons)
Your Twenties - Billionaires (User: melons)
KS FRENCH - She like to funk (User: melons)
Teleman - Sweet Morning (User: melons)
Drop Out Orchestra - Crome (User: melons)
John Carpenter - Unkillable (User: melons)
The Larry Page Orchestra - You Really Got Me (User: melons)
Anna B Savage - Since We Broke Up (User: melons)
a-ha - I've Been Losing You - 2004 Remaster (User: melons)
The Mothers of ınvention - Concentration Moon (User: melons)
Bikini Kill - Rebel Girl (User: melons)
Frank Zappa - Who Needs the Peace Corps? (User: melons)
Blue Orchids - The Lad That Time Forgot (6 Music Session, 12 Sep 2018) (User: melons)
Sufjan Stevens - Jacksonville (User: melons)
The Surfing Magazines - I Dreamed When I Was Young (User: melons)
A Certain Ratio - Down and Dirty (User: melons)
Gang of Four - At Home He's a Tourist (User: melons)
Naeleck - All my Heroes - Radio Edit (User: melons)
Aztec Camera - Oblivious (User: melons)
Big Mama Thornton - Hound Dog (User: melons)
Field Music - Endlessly (User: melons)
The Rubinoos - I Think We're Alone Now (User: melons)
Blue Orchids - Incandescent Artillery (6 Music Session, 12 Sep 2018) (User: melons)
Gustaf - Dream (User: melons)
Dalida - Love in portofino (User: melons)
Warmduscher - Wild Flowers (User: melons)
The Beach Boys - Darlin' (User: melons)
The Jazz Butcher - Southern Mark Smith (Big Return) (User: melons)
Portishead - Glory Box (User: melons)
Portishead - Biscuit (User: melons)
Pete Jinks - Lux Interior (User: melons)
Portishead - Pedestal (User: melons)
Pascal Comelade - the return of lux interior the magician (User: melons)
Airportman - Lux Interior (User: melons)
Portishead - Roads (User: melons)
Oliver Tree - Life Goes On (User: melons)
Human Nature - Eternal Flame (User: melons)
Portishead - Numb (User: melons)
Human Nature - Nobody Just Like You (User: melons)
Gary Clail - 2 Thieves And A Liar (User: melons)
Portishead - Wandering Star (User: melons)
Imfromull - DiscoDaze Mix - Show 214 - 08.10.21 (User: melons)
Portishead - It Could Be Sweet (User: melons)
Sean Finn - The Rhythm of the Night (User: melons)
Portishead - Strangers (User: melons)
The Original - I Luv U Baby - Edit (User: melons)
Portishead - Sour Times (User: melons)
Nashville Kids' Sound - What Is Thunder And Lightning? (User: melons)
Spike Milligan - The Q5 Piano Tune (User: melons)
Mouse and the Traps - A Public Execution (User: melons)
Imfromull - DiscoDaze Mix - Show 214 - 08.10.21 (User: melons)
Paul Bellini - Long Dark Twenties (User: melons)
Odds - Eat My Brain (User: melons)
Stereolab - How To Play Your Internal Organs Overnight (User: melons)
The Raincoats - No One's Little Girl (User: melons)
Subway Sect - Stop That Girl (User: melons)
The Streets - Blinded by the Lights (User: melons)
Tom Petty and The Heartbreakers - Christmas All Over Again (User: melons)
Easterhouse - Whistling in the Dark (User: melons)
Arthur Russell - Let's Go Swimming - Coastal Dub (User: melons)
The Woodentops - Move Me (User: melons)
The Stars Of Heaven - Lights Of Tetouan (User: melons)
Girls At Our Best! - Politics! (User: melons)
Shelleyan Orphan - Anatomy of Love (User: melons)
Sugar Minott - Good Thing Going (User: melons)
Rick Danko - Sip The Wine (User: melons)
Madrugada - I Don't Fit (User: melons)
Ennio Morricone - L’Ultima Volta (User: melons)
Christophe - Aline (User: melons)
Alexandre Desplat - Obituary (User: melons)
The Clash - Pressure Drop (User: melons)
The Cure - Killing an Arab (User: melons)
Alain Delon - Laetitia - Bof Les Aventuriers (User: melons)
Dalida - Paroles Paroles (User: melons)
Laetitia Sadier - Un Soir, Un Chien (User: melons)
Giorgio Tuma - Through Your Hands Love Can Shine - Turbotito Remix (User: melons)
Studebaker John - Without You (User: melons)
Ronnie Hawkins - Who Do You Love (User: melons)
Killdozer - Knuckles the Dog (Who Helps People) (User: melons)
Meeting Of Important People - I Know Every Street (User: melons)
Wild Abandon - Mercury Skies (User: melons)
Scott Stein - Wild Abandon (User: melons)
Chris McFarland - Wild Abandon (User: melons)
Daniel Quasar - Wild Abandon (User: melons)
Hawksley Workman - Wild Abandon (User: melons)
Matthew Sweet - Sick of Myself (User: melons)
Joe Sealy - You're Gonna' Miss Me (feat. Barbra Lica & Richard Ring) (User: melons)
Matthew Sweet - Sick of Myself (User: melons)
William Butler Yeats - The Lake Isle Of Innisfree (User: melons)
May Sarton - My Sisters, O My Sisters (User: melons)
William Butler Yeats - The Lake Isle Of Innisfree (User: melons)
William Stafford - Scars (User: melons)
Anne Waldman - Uh Oh Plutonium (User: melons)
David Ignatow - Here I Am With Mike in Hand, Shooting Down the Rapids... (User: melons)
Michael S. Harper - Dear John, Dear Coltrane (User: melons)
Donald Revell - The Children's Undercroft (User: melons)
Erica Jong - Ode To My Shoes (User: melons)
Carolyn Forche - The Colonel (User: melons)
Lesel Mueller - Monet Refuses The Operation (User: melons)
Dylan Thomas - Do Not Go Gentle Into That Good Night (User: melons)
Al Young - Lester Leaps In (User: melons)
Real Lies - Seven Sisters (User: melons)
Levi the Poet - Sanctuary Cities (User: melons)
Gene Vincent - Rip It Up (User: melons)
The Cramps - Human Fly (User: melons)
Sami Switch - Oh Why (User: melons)
Dean Atta - I Am Nobody's Nigger (User: melons)
Anthony Anaxagorou - For The Girl Who Asked What I Was Thinking (User: melons)
Fred V & Grafix - Together We’re Lost (User: melons)
Juls - Temperature Rising (User: melons)
Afrikan Boy - LITW (User: melons)
Scroobius Pip - Introdiction (User: melons)
Kojey Radical - No Photos (User: melons)
Jarvis Cocker - Paroles Paroles (User: melons)
Fashion - Love Shadow (User: melons)
Jacobites - It'll All End Up In Tears - 2019 Remaster (User: melons)
The Hawks - It's All Right, It's O.K. (User: melons)
Patrick Hernandez - Born to Be Alive (User: melons)
The Last Skeptik - Trouble (User: melons)
Azekel - England Is A... (User: melons)
Krept & Konan - Young Kingz Part 1 (User: melons)
George the Poet - Follow The Leader (User: melons)
Josh Osho - The Voice (User: melons)
The Books - Cello Song feat. Jose Gonzales (User: melons)
Make Up - Do You Like Gospel Music?? (User: melons)
Paris Angels - Perfume (User: melons)
Incubus - Drive (User: melons)
Clawfinger - Do What I Say (User: melons)
Thea Gilmore - Ever Fallen In Love (User: melons)
Bodhi - My City (Bodhi Vs. George The Poet) (User: melons)
Joshua Luke Smith - Carry Me Radio Edit (User: melons)
Nego True - The Break up Poem (User: melons)
Keel Her - Riot Grrrl (User: melons)
Palma Violets - Best Of Friends (User: melons)
Henry Purcell - Dido & Aeneas, Z. 626, Act III: When I am laid in earth (User: melons)
The Pains of Being Pure at Heart - Young Adult Friction (User: melons)
The Soundcarriers - Let It Ride (User: melons)
Girls - Lust For Life (User: melons)
Dent May - Meet Me In The Garden (User: melons)
The Love Language - Lalita (User: melons)
Let's Wrestle - Crushing Nerves (User: melons)
Let's Wrestle - Rain Ruins Revolution (User: melons)
Kojey Radical - Open Hand (User: melons)
Real Lies - North Circular (User: melons)
Guided by Voices - Game of Pricks (User: melons)
The Tragically Hip - Bobcaygeon (User: melons)
Cibo Matto - Beef Jerky (User: melons)
Pell Mell - Saucer (User: melons)
They Might Be Giants - Spiralling Shape (User: melons)
Scott Thompson - I'm Gay (User: melons)
Matthew Sweet - Happiness (User: melons)
Ty - the scheme of things (User: melons)
Pavement - Painted Soldiers (User: melons)
Death Lurks - Some Days It's Dark (User: melons)
Nego True - Pick Your Poison (User: melons)
George the Poet - Search Party (User: melons)
Hollie Poetry - What’s Wrong With Touching? (Touch) (User: melons)
MJ Cole - Soak It Up (User: melons)
Suli Breaks - Adulthood (User: melons)
Jack Kerouac - Deadbelly (with Steve Allen) (User: melons)
William S. Burroughs - Cities of the Red Night (User: melons)
Juan Felipe Herrera - Logan Heights And The World (User: melons)
Edna St. Vincent Millay - Recuerdo (User: melons)
Walt Whitman - America (User: melons)
Robert Frost - The Road Not Taken (User: melons)
Langston Hughes - Ballad Of The Gypsy (User: melons)
E.E. Cummings - next to of course god america (User: melons)
Above & Beyond - Great Falls - Spoken Word with Elena Brower (User: melons)
Charles Bukowski - The Secret of My Endurance (User: melons)
Kurt Vonnegut - Slaughterhouse 5, Pt. 4 (User: melons)
Pig - Hopelessly Devoted to You (User: melons)
Juliana Hatfield - Mouthful of Blood (User: melons)
Juliana Hatfield - Hopelessly Devoted To You (User: melons)
Knxwledge - kometostai.aintreallynootherwaytoputitro (User: melons)
Liz Phair - Supernova (User: melons)
Arliss Nancy - Vonnegut (User: melons)
Born Ruffians - Kurt Vonnegut (User: melons)
Sage Francis - Vonnegut Busy (User: melons)
Dreamers - Palm Reader (User: melons)
Caroline Polachek - So Hot You're Hurting My Feelings (User: melons)
Chairlift - Look Up (User: melons)
Frankie Cosmos - Sappho (User: melons)
Jeffrey Lewis - Don't Let the Record Label Take You Out to Lunch (User: melons)
Chief Keef - Trust None (User: melons)
Rilo Kiley - Variations on a Theme (Science vs. Romance) (User: melons)
Manic Street Preachers - The Secret He Had Missed (feat. Julia Cumming) (User: melons)
Manic Street Preachers - Orwellian (User: melons)
John Grant - He's Got His Mother's Hips (User: melons)
The Lilac Time - Return To Yesterday (User: melons)
The Lilac Time - Bed Of Roses (User: melons)
Willow - t r a n s p a r e n t s o u l feat. Travis Barker (User: melons)
The Loves - She'll Break Your Heart (User: melons)
The Loves - Xs and Os (User: melons)
The Loves - December Boy (User: melons)
Calum Scott - Rise (User: melons)
John Grant - Rhetorical Figure (User: melons)
Universal Love - Moon Ride (User: melons)
John Grant - Rhetorical Figure (User: melons)
Bronski Beat - Smalltown Boy (User: melons)
Nina Kinert - Chapped Lips (User: melons)
VANO 3000 - Running Away (User: melons)
ANZ - You Could Be (feat. George Riley) (User: melons)
Emmanuelle - Premier baiser (User: melons)
49ers - Touch Me (User: melons)
Helado Negro - La Naranja (User: melons)
Karel Fialka - Hey Matthew (User: melons)
John - Sibensko Powerhouse (User: melons)
Melody's Echo Chamber - Some Time Alone, Alone (User: melons)
Madonna - Borderline (User: melons)
UNiiQU3 - Microdosing (User: melons)
Soulwax - Essential Four (User: melons)
J Dilla - E=mc2 (User: melons)
Radiohead - If You Say the Word (User: melons)
Laura Marling - Short Movie (User: melons)
Wolf Alice - The Beach (User: melons)
Frazey Ford - Azad (User: melons)
The Mountain Goats - This Year (User: melons)
The War on Drugs - Red Eyes (User: melons)
Nation of Language - This Fractured Mind (User: melons)
The Human League - Love Action (I Believe in Love) (User: melons)
Wayne Snow - Silly Games (User: melons)
ishmael ensemble - The Gift (User: melons)
Nubya Garcia - Source (User: melons)
Parquet Courts - Black Widow Spider (User: melons)
The Slits - Shoplifting (Radio 1 Session,19 Sep 1977) (User: melons)
Jordan Rakei - Send My Love (User: melons)
Prince - Sign 'O' The Times (User: melons)
Sans Soucis & Cécile Kyenge - Games (User: melons)
Remi Wolf - Quiet On Set (User: melons)
De La Soul - Say No Go (User: melons)
Babeheaven - The Hours (User: melons)
Metronomy - 405 (feat. Biig Piig) (User: melons)
Graham Coxon - Bittersweet Bundle Of Misery (User: melons)
The B‐52s - Roam (User: melons)
Curtis Harding - Can't Hide It (User: melons)
The Concretes - You Can't Hurry Love (User: melons)
David Holmes - Hope Is The Last Thing To Die (feat. Violet Raven) (User: melons)
The Source - You Got The Love (feat. Candi Staton) (User: melons)
IDLES - The Beachland Ballroom (User: melons)
Arcade Fire - Neighborhood #3 (Power Out) (User: melons)
Fleet Foxes - He Doesn't Know Why (User: melons)
System of a Down - Chop Suey (User: melons)
Villagers - Circles In The Firing Line (User: melons)
Songhoy Blues - Bon Bon (Mike Lindsay Remix) (User: melons)
The Roots - The OtherSide (User: melons)
She Drew the Gun - Behave Myself (User: melons)
Ash - Girl From Mars (User: melons)
Lee "Scratch" Perry - I Am A Madman (User: melons)
Wesley Gonzalez - A Taste of Something New (User: melons)
Self Esteem - How Can I Help You (User: melons)
Graham Parker - The New York Shuffle (User: melons)
Paris Angels - All on You (Perfume) (User: melons)
Gorillaz - Meanwhile (feat. Jelani Blackman & Barrington Levy) (User: melons)
Bush Tetras - Can't Be Funky (User: melons)
Sam & Dave - Hold On, I'm Comin' (User: melons)
Totally Enormous Extinct Dinosaurs - The Distance (User: melons)
The House of Love - Beatles and the Stones (User: melons)
Disclosure - In My Arms (User: melons)
Redman - RUSH THE SECURITY (User: melons)
Sleaford Mods - TCR (User: melons)
Bessie Turner - Rushing (User: melons)
Aretha Franklin - The House That Jack Built (User: melons)
Beastie Boys - She's Crafty (User: melons)
Elbow - Grounds for Divorce (User: melons)
DoFlame - All Out (User: melons)
Ralphi Rosario - You Used To Hold Me (User: melons)
Unknown Mortal Orchestra - That Life (User: melons)
Skinny Pelembe - I Just Wanna Be Your Prisoner (feat. Hejira) (User: melons)
Goldfrapp - Pilots (User: melons)
Foals - Inhaler (User: melons)
The Specials - Freedom Highway (User: melons)
Chumbawamba - Tubthumping (User: melons)
The Family Stand & Jazzy B - Ghetto Heaven (User: melons)
Mitski - Working for the Knife (User: melons)
Maya Jane Coles - Night Creature (User: melons)
Bloc Party - So Here We Are (User: melons)
Adam and the Ants - Dog Eat Dog (User: melons)
George Fitzgerald - Nobody But You (6 Music Session, 26 Mar 2018) (User: melons)
Hiatus Kaiyote - Red Room (User: melons)
Madvillain - All Caps (User: melons)
Inspiral Carpets - Saturn 5 (User: melons)
Sufjan Stevens & Angelo De Augustine - Back To Oz (User: melons)
Harry J Allstars - Liquidator (User: melons)
Radiohead - If You Say the Word (User: melons)
The Cure - In Between Days (User: melons)
Stealing Sheep - Show Love (User: melons)
Florence + the Machine - Kiss With a Fist (User: melons)
Folly Group - Butt No Rifle (User: melons)
Thievery Corporation - Lebanese Blonde (User: melons)
Liz Lawrence - Drive (User: melons)
Childhood - Californian Light (BBC Introducing Session, 24 Jul 2017) (User: melons)
Digital Underground - The Humpty Dance (User: melons)
John - Sibensko Powerhouse (User: melons)
Julia Jacklin - Coming of age (User: melons)
Grace Jones - Williams' Blood (User: melons)
Grace Jones - I've Seen That Face Before (Libertango) (User: melons)
Australian Crawl - Reckless (Dont Be So) (User: melons)
This Mortal Coil - Kangaroo (User: melons)
Andy Summers & Robert Fripp - Image and Likeness (User: melons)
Dan Lambert - Charley Town (User: melons)
Ivor Cutler Trio - I'm Going In A Field (User: melons)
Hania Rani - Eden (User: melons)
Carla dal Forno - Dry In The Rain (User: melons)
Sarah Davachi - Buhrstone (User: melons)
Brian Eno - Julie With... (User: melons)
Stephan Beneking - 24 Petits Reves Bizarres: No. 5 in F sharp major (User: melons)
Michael Hauber - Prelude Fantaisie No. 5 (User: melons)
Claude Debussy - Preludes, Book 1: No. 5. Les collines d'Anacapri (User: melons)
Carlos Marquez - Piano Sonata in B Minor - No. II (User: melons)
Erik Satie - 3 Sarabandes: No. 2 (User: melons)
Carlos Marquez - Adieu Nocturne No. 3 in G Minor -Goodbye- (User: melons)
Romeo Wecks - Petit Rêve Bizarre No. 3 (User: melons)
Carlos Marquez - Valse melancolique No. 1 in C Minor -for the left hand- (User: melons)
Stephan Beneking - Nocturne No. 4 in C Sharp Minor (User: melons)
Claude Debussy - Preludes, Book 1: No. 4. Les sons et les parfums tournent dans l'air du soir (User: melons)
Stephan Beneking - Adveniat IIII in E Minor (User: melons)
Michael Hauber - Prelude Fantaisie No. 3 (User: melons)
Erik Satie - Gnossiennes: No. 4 (User: melons)
Stephan Beneking - 24 Petits Reves Bizarres: No. 2 in C minor (User: melons)
Carlos Marquez - Petit Rêve No. 3 in B Minor (User: melons)
Stephan Beneking - Nocturne No. 3 in C Sharp Major (User: melons)
Erik Satie - Gnossiennes: No. 3 - Lent (User: melons)
Carlos Marquez - Adieu Nocturne No. 2 in D Minor -Ade- (User: melons)
Saison - Top Bunk Boogie (User: melons)
Stephan Beneking - Le Côte de Guermantes (User: melons)
Romeo Wecks - Petit Rêve Bizarre No. 1 (User: melons)
Carlos Marquez - Valse melancolique No. 1 in C Minor -for the right hand- (User: melons)
Felix Mendelssohn - Lieder ohne Worte, Op. 102/6: Andante (User: melons)
Carlos Marquez - Glasperlenspiel No. 1 (User: melons)
Frédéric Chopin - Preludes, Op. 28: No. 6 in B Minor, Lento Assai (User: melons)
Romeo Wecks - Prélude for the Left Hand No. 1 (User: melons)
Drop Out Orchestra - Crome (User: melons)
Erik Satie - Gnossiennes: No. 2 - Avec étonnement (User: melons)
Stephan Beneking - A l`ombre des jeunes filles en fleurs (User: melons)
Frédéric Chopin - Preludes, Op. 28: No. 2 in A Minor, Lento (User: melons)
Carlos Marquez - Valse Melancolique No. IV - The Black Swan (User: melons)
Stephan Beneking - Nocturne No. 2 in C Minor (User: melons)
Felix Mendelssohn - Lieder ohne Worte, Op. 120/1: Andante - un poco agitato (User: melons)
Stephan Beneking - Petit Reve triste (User: melons)
Carlos Marquez - minimal nocturne no. 1 (User: melons)
Hal Freedman - Petr Ginz (User: melons)
Carlos Marquez - Piano Sonata in B Minor - No. I (User: melons)
Erik Satie - Gnossiennes: No. 1 - Lent (User: melons)
Carlos Marquez - Adieu Nocturne No. 1 in A Minor -Adieu- (User: melons)
Romeo Wecks - Prélude for the Right Hand No. 1 (User: melons)
Johann Sebastian Bach - Das Wohltemperierte Klavier: Book 1, BWV 846-869: Prelude In C Sharp Minor BWV 849 (User: melons)
Stephan Beneking - Nocturne No. 1 in C Major (User: melons)
Claude Debussy - Preludes, Book 1: No. 1. Danseuses de Delphes (User: melons)
Stephan Beneking - Du côte de chez Swann (User: melons)
Frédéric Chopin - Preludes, Op. 28: No. 4 in E Minor, Largo (User: melons)
Erik Satie - 3 Gymnopedies: No. 1. Lent et douloureux (User: melons)
Tarkan - Verme (User: melons)
Tarkan - Her Nerdeysen (User: melons)
Tarkan - Taş (User: melons)
Tarkan - Sen Başkasın (User: melons)
Tarkan - Hüp (User: melons)
Tarkan - O'na Sor (User: melons)
Tarkan - Yandım (User: melons)
Tarkan - Uzak (User: melons)
Tarkan - Gitti Gideli (User: melons)
Tarkan - Kuzu Kuzu (User: melons)
Tarkan - Ay (User: melons)
Tarkan - Aşk (User: melons)
Groovemasta - Right Behind You (User: melons)
Ural Thomas - Pain Is The Name Of Your Game (User: melons)
Peggy Sue - Fools Rush In (User: melons)
salami rose joe louis - i miss you so (User: melons)
Alabaster Deplume - Visit Croatia (User: melons)
Hemlock Ernst - Down (User: melons)
cat song - Meow! (User: melons)
The Gaslamp Killer - The Cat's Meow (User: melons)
Imagination Movers - Watermelon Meow Meow (User: melons)
lvusm - meow (User: melons)
chahi - Cat Meow (User: melons)
7 Year Bitch - Cats Meow (User: melons)
Miaowser - Некоторые парни милые (User: melons)
Ultra Orange - Don't Kiss Me Goodbye (User: melons)
Black Country, New Road - Sunglasses (User: melons)
Floyd Cramer - On the Rebound (User: melons)
The Beatles - Martha My Dear - Remastered 2009 (User: melons)
Unloved - Heartbreak (User: melons)
Good Sad Happy Bad - Blessed (User: melons)
Fontaines D.C. - You Said (User: melons)
Smog - Ex-Con (User: melons)
The Nerves - When You Find Out (User: melons)
Anthony Moore - Stitch In Time (User: melons)
Lost Horizons - In Quiet Moments (User: melons)
