Kate Nash - Pumpkin Soup (User: jbwharris)
FM Belfast - Underwear (User: jbwharris)
Firefox AK - Harvey (User: jbwharris)
Donovan Woods - Portland, Maine (User: jbwharris)
Lenny Kravitz - It Ain't Over 'til It's Over (User: jbwharris)
XTC - Making Plans for Nigel (User: jbwharris)
Limp Bizkit - Nookie (User: jbwharris)
Surf Mesa - Somewhere (feat. Gus Dapperton) (User: jbwharris)
History Kids - Can You Save Me? (User: jbwharris)
Hot Butter - Popcorn (User: jbwharris)
The Beatles - Don’t Let Me Down (First Rooftop Performance) (User: jbwharris)
Dory Previn - Atlantis (User: jbwharris)
The All-American Rejects - Dirty Little Secret (User: jbwharris)
Oneness of Juju - Liberation Dues (User: jbwharris)
Kool & the Gang - Let The Music Take Your Mind (User: jbwharris)
The Dears - Instant Nightmare! (User: jbwharris)
Out Hud - One Life to Leave (User: jbwharris)
Bad Bad Hats - Shame (User: jbwharris)
Kaiser Chiefs - Ruby (User: jbwharris)
Jonathan Richman & The Modern Lovers - New England (User: jbwharris)
xavley - Eat the Son (feat. SAKURA) (User: jbwharris)
Shawn Colvin - This Must Be The Place (Naive Melody) (User: jbwharris)
Ant Saunders - Yellow Hearts (User: jbwharris)
Dum Dum Girls - I Got Nothing (User: jbwharris)
Kenny Rogers - Crazy In Love (User: jbwharris)
Plants and Animals - Good Friend (User: jbwharris)
Johnny Flynn - Einstein's Idea (User: jbwharris)
Texas - Say What You Want (User: jbwharris)
Ride - Vapour Trail (User: jbwharris)
Radiohead - The National Anthem (User: jbwharris)
SG Lewis - Chemicals (User: jbwharris)
Ritt Momney - Put Your Records On (User: jbwharris)
Alabama Shakes - I Ain’t the Same (User: jbwharris)
Shawn James - The Curse of the Fold (User: jbwharris)
Jurdan Bryant - My Life (User: jbwharris)
Ramones - Do You Remember Rock 'n' Roll Radio? (User: jbwharris)
Dirty Projectors - Lose Your Love (Chromeo Remix) (User: jbwharris)
Crosby, Stills & Nash - Helplessly Hoping (User: jbwharris)
Mad Hawkes - Face Pnch (User: jbwharris)
Brendan Benson - Don't Wanna Talk (User: jbwharris)
Pearl Jam - Last Kiss (User: jbwharris)
Stompin' Tom Connors - The Hockey Song (User: jbwharris)
The Kinks - You Really Got Me (User: jbwharris)
POP ETC - Dreams (User: jbwharris)
Spoon - Hot Thoughts (User: jbwharris)
The 1975 - TOOTIMETOOTIMETOOTIME (User: jbwharris)
The Record Company - How High (User: jbwharris)
Catherine Wheel - I Want To Touch You (User: jbwharris)
JON VINYL - Storm (User: jbwharris)
Gary Clark Jr. - Ain't Messin 'Round (User: jbwharris)
Aretha Franklin - Spanish Harlem (User: jbwharris)
Paul Simon - Duncan (User: jbwharris)
Blur - She's So High (User: jbwharris)
Tamar Aphek - Drive (User: jbwharris)
Olwh - Happy (feat. Freak Slug) (User: jbwharris)
Trampled by Turtles - Codeine (User: jbwharris)
Catherine Feeny - Mr Blue (User: jbwharris)
Youssou N'Dour - 7 Seconds (feat. Neneh Cherry) (User: jbwharris)
Mac Miller - Everybody (User: jbwharris)
Foster, Sody & Sarcastic Sounds - fools (can't help falling in love) (User: jbwharris)
Mk.gee - Priorities (User: jbwharris)
The Replacements - Kiss Me on the Bus (User: jbwharris)
Ana Egge - Wait a Minute (User: jbwharris)
Clap Your Hands Say Yeah - Ketamine and Ecstasy (User: jbwharris)
HAIM - The Wire (User: jbwharris)
Fleet Foxes - Montezuma (User: jbwharris)
Vic Chesnutt - You Are Never Alone (User: jbwharris)
Thee Oh Sees - Tidal Wave (User: jbwharris)
Sleigh Bells - Bitter Rivals (User: jbwharris)
The Staple Singers - Washington We're Watching You (User: jbwharris)
Pool Surfers - Indulge (User: jbwharris)
Patches & Gretchen - Time of the Lilacs (User: jbwharris)
Firewoodisland - Sprinter (User: jbwharris)
Less Than Jake - History of a Boring Town (User: jbwharris)
Fountains of Wayne - All Kinds Of Time (User: jbwharris)
Cage the Elephant - Whole Wide World (Unpeeled) (User: jbwharris)
The Ballroom Thieves - Tenebrist (User: jbwharris)
Makaya McCraven - Black Rhythm Happening (User: jbwharris)
Confidence Man - Holiday (User: jbwharris)
Better Oblivion Community Center, Conor Oberst & Phoebe Bridgers - Sleepwalkin' (User: jbwharris)
Townes Van Zandt - My Proud Mountains (User: jbwharris)
Poolside - Harvest Moon (User: jbwharris)
X - Burning House Of Love (User: jbwharris)
White Zombie - More Human Than Human (User: jbwharris)
Wet Leg - Too Late Now (User: jbwharris)
A Silver Mt. Zion - Stumble Then Rise on Some Awkward Morning (User: jbwharris)
Kraftwerk - The Robots (User: jbwharris)
Imaginary Cities - Ride This Out (User: jbwharris)
The Dears - The Worst In Us (User: jbwharris)
Joel Plaskett Emergency - Nowhere With You (User: jbwharris)
New West - Kids Who Stole The World (User: jbwharris)
Leroy Sanchez - Perfect (User: jbwharris)
Wally Cox - I Need A Love (I Need Your Love) (User: jbwharris)
Underworld - Born Slippy (Nuxx) (User: jbwharris)
Underworld - Born Slippy (Nuxx) (User: jbwharris)
Memphis Bleek - Do My... (feat. Jay-Z) (User: jbwharris)
Leon Bridges - Smooth Sailin' (User: jbwharris)
La Fleur - Aphelion (Adeline Remix) (User: jbwharris)
Eric Clapton - I Shot The Sheriff (User: jbwharris)
Maisie Peters - Blinding Lights (Apple Music Home Session) (User: jbwharris)
Belle and Sebastian - Step Into My Office, Baby (User: jbwharris)
Tristan Psionic - 3:00 AM (User: jbwharris)
Joel Hatch & 'Come From Away' Company - Welcome To the Rock (User: jbwharris)
Dua Saleh - fitt (feat. Amaarae) (User: jbwharris)
ABBA - Don't Shut Me Down (User: jbwharris)
Digable Planets - Slowes' Comb / The May 4th Movement Starring Doodlebug (User: jbwharris)
Vampire Weekend - Oxford Comma (User: jbwharris)
Blur - Girls and Boys (User: jbwharris)
Blur - Girls and Boys (User: jbwharris)
Béla Fleck - Help On The Way (User: jbwharris)
Buffy Sainte-Marie - The Vampire (User: jbwharris)
Thank You, I'm Sorry - Follow Unfollow (User: jbwharris)
The National - Bloodbuzz Ohio (User: jbwharris)
Wizkid - Smile (feat. H.E.R.) (User: jbwharris)
Lucero - Outrun the Moon (User: jbwharris)
The National - Carin at the Liquor Store (User: jbwharris)
Northcote - Let Me Roar (User: jbwharris)
Interpol - Obstacle 1 (User: jbwharris)
Harrison Brome - Midnight Island (User: jbwharris)
Rah Rah - Good Winter (User: jbwharris)
K-OS - Holy Cow (User: jbwharris)
CHVRCHES - Good Girls (User: jbwharris)
blink-182 - What's My Age Again? (User: jbwharris)
The Verve - Love Is Noise (User: jbwharris)
The Stone Roses - Love Spreads (User: jbwharris)
Nine Inch Nails - The Perfect Drug (User: jbwharris)
Nine Inch Nails vs. Nelly - Closer To Grillz (User: jbwharris)
Xenia Rubinos - Sacude (User: jbwharris)
Don't Sleep - No Other Way (User: jbwharris)
Tokyo Police Club - Be Good (User: jbwharris)
spill tab - Indecisive (feat. Tommy Genesis) (User: jbwharris)
Marika Hackman - the one (User: jbwharris)
Spoon - Don't You Evah (User: jbwharris)
Sudan Archives - Confessions (User: jbwharris)
Parra for Cuva - Manila Palm (User: jbwharris)
Sun Kil Moon - I Can't Live Without My Mother's Love (User: jbwharris)
X - See How We Are (User: jbwharris)
Kool & The Gang - Celebration (User: jbwharris)
The Offspring - Original Prankster (Feat. Redman) (User: jbwharris)
Ruby Waters - Difficult (User: jbwharris)
Sylvan Esso - Frequency (User: jbwharris)
The Glorious Sons - Hold Steady (User: jbwharris)
The Subways - Rock & Roll Queen (User: jbwharris)
Bachelor, Jay Som & Palehound - Stay in the Car (User: jbwharris)
Linkin Park - In the End (User: jbwharris)
The Virginia Sil'hooettes - Telephone (User: jbwharris)
Seapony - What You See (User: jbwharris)
Amon Tobin - Slowly (User: jbwharris)
Darkside - The Limit (User: jbwharris)
The Roots & Erykah Badu - You Got Me (User: jbwharris)
Boz Scaggs - Payday (User: jbwharris)
Sly & The Family Stone - Que Sera, Sera (Whatever Will Be, Will  Be) (User: jbwharris)
Jade Bird - Lottery (User: jbwharris)
Local H - "Cha!" Said The Kitty (User: jbwharris)
Sharon Van Etten - Seventeen (User: jbwharris)
St. Vincent - Surgeon (User: jbwharris)
Graham Nash - Simple Man (User: jbwharris)
Pet Shop Boys - Domino Dancing (User: jbwharris)
The Bangles - The Real World (User: jbwharris)
The Kinks - This Time Tomorrow (User: jbwharris)
Disq - Daily Routine (User: jbwharris)
King Gizzard & The Lizard Wizard - Interior People (User: jbwharris)
The Florets - Tip Toe (User: jbwharris)
Grimes - Artangels (User: jbwharris)
Rachael Yamagata - Even If I Don't (User: jbwharris)
The Champs - Tequila (User: jbwharris)
Juana Molina - Un Día Punk (User: jbwharris)
Ben Westbeech - Same Thing (User: jbwharris)
Barry Manilow - Who's Been Sleeping In My Bed (User: jbwharris)
Kaleo - Break My Baby (User: jbwharris)
Tommy James & The Shondells - Draggin' the Line (User: jbwharris)
Ramsey Lewis - Cry Baby Cry (User: jbwharris)
Cannons - Love Chained (User: jbwharris)
Modest Mouse - Fire It Up (User: jbwharris)
Eels - Lone Wolf (User: jbwharris)
The Selecter - Too Much Pressure (User: jbwharris)
Empire of the Sun - We Are the People (User: jbwharris)
Vicetone - I Hear You (User: jbwharris)
The 2 Bears - Get Out (User: jbwharris)
Amp Fiddler - If You Can't Get Me Off Your Mind (User: jbwharris)
Mini Mansions - Works Every Time (User: jbwharris)
Beirut - No No No (User: jbwharris)
Angus & Julia Stone - Mango Tree (User: jbwharris)
Glacier - Neos (User: jbwharris)
Death Cab for Cutie - A Lack of Color (User: jbwharris)
Incubus - Nimble Bastard (User: jbwharris)
Coldplay - The Scientist (User: jbwharris)
Stevie Wonder - Where Is Our Love Song (feat. Gary Clark Jr.) (User: jbwharris)
Blondie - Heart of Glass (User: jbwharris)
The Lumineers - Angela (User: jbwharris)
The Clash - Police & Thieves (User: jbwharris)
Aluna, Princess Nokia & Jada Kingdom - Get Paid (User: jbwharris)
Sara Bareilles - Armor (User: jbwharris)
Fischerspooner - Emerge (User: jbwharris)
Magic Fight - Legs (User: jbwharris)
Beck - Sexx Laws (User: jbwharris)
Gillian Welch - Look at Miss Ohio (User: jbwharris)
Rilo Kiley - Spectacular Views (User: jbwharris)
J Mascis - Several Shades of Why (User: jbwharris)
Beady Eye - Off at the Next Exit (User: jbwharris)
Quasimoto - Boom Music (User: jbwharris)
Warren Zevon vs. Creedence Clearwater Revival - Rise Of the Werewolves (User: jbwharris)
Four Tet - Baby (User: jbwharris)
typical girls - Las Palmas (User: jbwharris)
The National - Fake Empire (Live in Brussels) (User: jbwharris)
The Rolling Stones - You Got the Silver (User: jbwharris)
Stars - Going, Going, Gone (User: jbwharris)
Big Sugar - Dear Mr. Fantasy (User: jbwharris)
City and Colour - The Girl (User: jbwharris)
A Flock of Seagulls - I Ran (User: jbwharris)
Arkells - 11:11 (User: jbwharris)
Pearl Jam - Better Man (User: jbwharris)
Our Lady Peace - Is Anybody Home? (User: jbwharris)
Leila Dey - Passenger (User: jbwharris)
Harlow Monroe - Christmas Time Is Here (User: jbwharris)
The Sheepdogs - Rock and Roll (User: jbwharris)
Styles P, Havoc - Nightmares 2 Dreams (User: jbwharris)
Fabolous, Dave East - Make Some Money (User: jbwharris)
Zeus - Heavy On Me (User: jbwharris)
Stars - Ageless Beauty (User: jbwharris)
The Interrupters - She's Kerosene (User: jbwharris)
Mark Ronson - Oh My God (User: jbwharris)
Tears for Fears - Head Over Heels (User: jbwharris)
The Sunny Street - Pottery & Glass (User: jbwharris)
Weston Estate - Saturday Nights (User: jbwharris)
Big Red Machine - Latter Days (feat. Anaïs Mitchell) (User: jbwharris)
Collective Soul - Where the River Flows (User: jbwharris)
Goldfrapp - Black Cherry (User: jbwharris)
Blondie - Dreaming (User: jbwharris)
Mr. Oizo - Flat Beat (User: jbwharris)
Flume - The Difference (feat. Toro y Moi) (User: jbwharris)
Water From Your Eyes - My Love's (User: jbwharris)
Begonia - Juniper (User: jbwharris)
Dolly Parton - Jolene (User: jbwharris)
Willie Nelson - Georgia on My Mind (User: jbwharris)
Guided by Voices - Hot Freaks (User: jbwharris)
Julien Baker - Sour Breath (User: jbwharris)
Everything Everything - Arch Enemy (User: jbwharris)
The Go-Go's - Our Lips Are Sealed (User: jbwharris)
Matthew Good - Weapon (User: jbwharris)
Odie - Slowly (User: jbwharris)
OutKast - Roses (User: jbwharris)
Twan Ray - We Could Start a Thing (User: jbwharris)
Born Ruffians - Miss You (User: jbwharris)
Shamir - Other Side (User: jbwharris)
VICTOR INTERNET - I KNO V3 (User: jbwharris)
Beck - Dreams (User: jbwharris)
Pretenders - I'll Stand By You (User: jbwharris)
Whiskey Daredevils - God Save The Queen / Sex Pistols (User: jbwharris)
Fantastic Negrito - I'm so Happy I Cry (feat. Tank and the Bangas & Tarriona 'Tank' Ball) (User: jbwharris)
Greatest Hits - Phil, Slow It Down (User: jbwharris)
Mura Masa & Tirzah - Today (User: jbwharris)
Rise Against - Nowhere Generation (User: jbwharris)
The Smiths - This Charming Man (User: jbwharris)
Dan Deacon - Build Voice (Allez-Allez remix) (User: jbwharris)
Oasis - Wonderwall (User: jbwharris)
Cream - Sunshine of Your Love (User: jbwharris)
Strawbs - Benedictus (User: jbwharris)
The Birthday Party - Release the Bats (User: jbwharris)
Galaxie 500 - Ceremony (User: jbwharris)
Basia Bulat - Your Girl (User: jbwharris)
Sloan - People Of The Sky (User: jbwharris)
Ween - I Can't Put My Finger on It (User: jbwharris)
My Morning Jacket - Regularly Scheduled Programming (User: jbwharris)
Tom Waits - The Good Old World (Waltz) (User: jbwharris)
Ryan Murgatroyd - iKalimba (User: jbwharris)
Javier Santiago - Dream (feat. Taylor Johnson) (User: jbwharris)
Tiga - Hot in Herre (User: jbwharris)
Ben Harper - Fade Into You (User: jbwharris)
Tanita Tikaram - Twist In My Sobriety (User: jbwharris)
Curtis Harding - Explore (User: jbwharris)
Walter Martin - October (User: jbwharris)
Hillsburn - Low Light (User: jbwharris)
Stars - No One Is Lost (User: jbwharris)
Bob Marley & The Wailers - Lively Up Yourself (User: jbwharris)
Full On Mone't - Masc 4 Masc (User: jbwharris)
Gabriela Márcia - Land of Dreams (User: jbwharris)
Limp Bizkit - Rollin' (User: jbwharris)
Metric - Breathing Underwater (User: jbwharris)
Michie Mee - Bahdgyal Bubble (User: jbwharris)
Kygo & Whitney Houston - Higher Love (User: jbwharris)
The Style Council - Shout To The Top (User: jbwharris)
Greta Lindholm - born (User: jbwharris)
Faces - Ooh La La (User: jbwharris)
Stardust - Music Sounds Better With You (User: jbwharris)
Otis Redding - I Can't Turn You Loose (User: jbwharris)
Aerosmith - Dream On (User: jbwharris)
David Bowie - 1984 (2016 Remastered Version) (User: jbwharris)
The Lytics - Last Bit (Lovely Words) (User: jbwharris)
Boy Golden - KD and Lunch Meat (User: jbwharris)
Massive Attack - Be Thankful for What You've Got (User: jbwharris)
Yum Yuck - During The Heatwave (User: jbwharris)
Les Trois Etrangers - Luna (User: jbwharris)
Moist - Push (User: jbwharris)
Social Distortion - Ring of Fire (User: jbwharris)
LaVern Baker - Bumble Bee (User: jbwharris)
Buckwheat Zydeco - Beast Of Burden (User: jbwharris)
The Sadies - It's Easy (Like Walking) [feat. Kurt Vile] (User: jbwharris)
The Royal Foundry - Hopefully (User: jbwharris)
Johnny Marr - Tenement Time (User: jbwharris)
Leonard Cohen - Everybody Knows (User: jbwharris)
Cul de Sac - Dust Of Butterflies (User: jbwharris)
Telekinesis - 50 Ways (User: jbwharris)
Lil Nas X & Jack Harlow - INDUSTRY BABY (User: jbwharris)
Bryan Ferry - Don't Stop the Dance (User: jbwharris)
Sinead O Brien - Strangers in Danger (User: jbwharris)
Diana Ross & The Supremes - Reflections (User: jbwharris)
Frankenfido - Some Little Way (User: jbwharris)
The Charlatans - Can't Get Out of Bed (User: jbwharris)
Young the Giant - My Body (User: jbwharris)
Radiohead - Optimistic (User: jbwharris)
Stef Chura - Degrees (User: jbwharris)
Walk the Moon - Shut Up and Dance (User: jbwharris)
Rufus Wainwright - Out Of The Game (User: jbwharris)
The Darcys - Ocean Eyes (User: jbwharris)
Wilco - You and I (User: jbwharris)
Wilco - You and I (User: jbwharris)
Julie Doiron - You Gave Me The Key (User: jbwharris)
Drama - Don't Hold Back (User: jbwharris)
Kendrick Lamar - Alright (User: jbwharris)
Mumford & Sons - I Will Wait (User: jbwharris)
Terry Uyarak - Igloolik (User: jbwharris)
Loony - be cool (User: jbwharris)
Wintersleep - Weighty Ghost (User: jbwharris)
Boy Golden - KD and Lunch Meat (User: jbwharris)
Wintersleep - Weighty Ghost (User: jbwharris)
The Chemical Brothers - The Darkness That You Fear (User: jbwharris)
Ultravox - Vienna (User: jbwharris)
Blue Rodeo - Hasn't Hit Me Yet (User: jbwharris)
Prefab Sprout - When Love Breaks Down (User: jbwharris)
K-OS - Sunday Morning (User: jbwharris)
James - Sit Down (User: jbwharris)
Erasure - Chains of Love (User: jbwharris)
Lightning Bolt - 30,000 Monkies (User: jbwharris)
Cake - Never There (User: jbwharris)
Pukka Orchestra - Listen To The Radio (User: jbwharris)
Blondie - Call Me (User: jbwharris)
The Tragically Hip - 38 Years Old (User: jbwharris)
The Smiths - Bigmouth Strikes Again (User: jbwharris)
Whitehorse - I'm On Fire (User: jbwharris)
Yellow House - I Can't Get Through to You (User: jbwharris)
Gary Numan & Tubeway Army - Are 'Friends' Electric? (User: jbwharris)
Lon Moshe, Southern Freedom Arkestra & Black Fire - Ballad for Bobby Hutcherson (User: jbwharris)
JJ Wilde & Billy Raffoul - Born To Die (User: jbwharris)
Kings of Leon - Wait for Me (User: jbwharris)
Gram Parsons - In My Hour of Darkness (User: jbwharris)
Rose Cousins - The Expert (User: jbwharris)
orion sun - Ne Me Quitte Pas (Don't Leave Me) (User: jbwharris)
The War on Drugs - Under the Pressure (User: jbwharris)
Bright Eyes - Persona Non Grata (User: jbwharris)
Arcade Fire - Rebellion (Lies) (User: jbwharris)
Joe Strummer & The Mescaleros - Get Down Moses (User: jbwharris)
Yoste - Arc - Stripped (User: jbwharris)
Vagabon - Every Woman (User: jbwharris)
Léonie Gray - Power (User: jbwharris)
Miles Davis - Miles Runs the Voodoo Down (User: jbwharris)
Szlachetka - Cutting The Firelines (User: jbwharris)
The Glorious Sons - Panic Attack (User: jbwharris)
Mazzy Star - Unreflected (User: jbwharris)
Fatboy Slim - Going Out of My Head (User: jbwharris)
Leo Nocentelli - Riverfront (User: jbwharris)
Lo Fidelity Allstars - Battleflag (feat. Pigeonhed) (User: jbwharris)
Cinnamon Chasers - Luv Deluxe (User: jbwharris)
Sam Most - Keep Moving (feat. Kenny Barron, George Mraz, Walter Bolden & Warren Smith) (User: jbwharris)
Retirement Party - Compensation (User: jbwharris)
Horsegirl - Ballroom Dance Scene (User: jbwharris)
Firedrill! - Easy Lover (User: jbwharris)
Stereo MC's - Connected (User: jbwharris)
KAYTRANADA - Intimidated (User: jbwharris)
rochester - Perseverance (User: jbwharris)
Kero Kero Bonito - The Sneaker Dance (User: jbwharris)
DJ Zinc - Emanate (User: jbwharris)
The Presidents of the United States of America - Peaches (User: jbwharris)
Primal Scream - Don't Fight It, Feel It (User: jbwharris)
ILA Orbis - Where Do We Go (User: jbwharris)
The xx - Islands (User: jbwharris)
International Music System - Nonline (User: jbwharris)
Sam Roberts - Don't Walk Away Eileen (User: jbwharris)
Kim Gordon - Sketch Artist (User: jbwharris)
Doves - Catch the Sun (User: jbwharris)
The Beaches - Want What You Got (User: jbwharris)
MAYE - My Love (User: jbwharris)
Beck - Loser (User: jbwharris)
Alicia Drayton - Siren (User: jbwharris)
Kon Kan - I Beg Your Pardon (I Never Promised You a Rose Garden) (User: jbwharris)
Jake Holmes - Dazed and Confused (User: jbwharris)
Al Green - Take Me To The River (User: jbwharris)
Arkells - Knocking At The Door (User: jbwharris)
Ween - Voodoo Lady (User: jbwharris)
The Sheepdogs - I've Got a Hole Where My Heart Should Be (User: jbwharris)
The Wombats - Oceans (User: jbwharris)
Alessia Cara - Scars to Your Beautiful (User: jbwharris)
Aldous Harding - The Barrel (User: jbwharris)
Dan Mangan - In The Aeroplane Over The Sea (User: jbwharris)
beabadoobee - Last Day on Earth (User: jbwharris)
Kathleen Edwards - Hard On Everyone (User: jbwharris)
Dinosaur Jr. - Repulsion (User: jbwharris)
Lou Barlow - All You People Suck (User: jbwharris)
Adam Ant - Goody Two Shoes (User: jbwharris)
of Montreal - Fugitive Air (User: jbwharris)
Anamanaguchi - Lorem Ipsum (Arctic Anthem) (User: jbwharris)
Fiona Apple - Shadowboxer (User: jbwharris)
Weeping Tile - Dogs and Thunder (User: jbwharris)
Palm Ghosts - The Hound (User: jbwharris)
Madonna - Bad Girl (User: jbwharris)
Jenny Lewis - Puppy and a Truck (User: jbwharris)
Doomsquad - Pyramids on Mars (User: jbwharris)
Lene Lovich - Say When (User: jbwharris)
Nick Cave & the Bad Seeds - The Ship Song (User: jbwharris)
Love - Maybe The People Would Be The Times Or Between Clark And Hilldale (2015 Remastered Version) (User: jbwharris)
Parra for Cuva - Manila Palm (User: jbwharris)
The Feeling - Never Be Lonely (User: jbwharris)
Chance the Rapper - Do You Remember (feat. Death Cab for Cutie) (User: jbwharris)
Chiiild - Hold On Till We Get There (User: jbwharris)
Willie Dunn - I Pity The Country (User: jbwharris)
wildes - Don't Think Twice, It's All Right (User: jbwharris)
The Stills - I'm With You (User: jbwharris)
Foo Fighters - Love Dies Young (User: jbwharris)
DWI - Good Friend (User: jbwharris)
The Flatlanders - Love, Please Come Home (feat. Joe Ely, Butch Hancock & Jimmie Dale Gilmore) (User: jbwharris)
The Killers - All These Things That I've Done (User: jbwharris)
Annie Mack - Testify (User: jbwharris)
Tegan and Sara - I Know I Know I Know (User: jbwharris)
The Lumineers - BRIGHTSIDE (User: jbwharris)
VICTOR INTERNET - Unfair (User: jbwharris)
Cut Copy - Free Your Mind (User: jbwharris)
Endless Boogie - The Offender (User: jbwharris)
The Who - Pictures of Lily (User: jbwharris)
Leanne Betasamosake Simpson - I Pity The Country (User: jbwharris)
Hollerado - So It Goes (User: jbwharris)
The Rolling Stones - Gimme Shelter (User: jbwharris)
INXS - Suicide Blonde (User: jbwharris)
Yazoo - Don't Go (2008 Remaster) (User: jbwharris)
Tavi Montelle - Standin' Out (User: jbwharris)
Great Lake Swimmers - Swimming Away (User: jbwharris)
Cornershop - Brimful of Asha (User: jbwharris)
Snow Patrol - Spitting Games (User: jbwharris)
The Tea Party - Temptation (User: jbwharris)
Rezz & Metric - Paper Walls (User: jbwharris)
The Paragons - The Tide Is High (User: jbwharris)
The Doors - Soul Kitchen (User: jbwharris)
Mantronix - Simple Simon (You Gotta Regard) (User: jbwharris)
Joy Crookes - When You Were Mine (User: jbwharris)
The Avalanches - We Go On (feat. Cola Boyy & Mick Jones) (User: jbwharris)
The Franklin Electric - I Know the Feeling (User: jbwharris)
Sarah Vaughan - Inner City Blues (Make Me Want To Holler) (User: jbwharris)
Steve Lacy - Dark Red (User: jbwharris)
Muse - Supermassive Black Hole (User: jbwharris)
Hüsker Dü - Flip Your Wig (User: jbwharris)
Run River North - Hands Up (User: jbwharris)
Justice - D.A.N.C.E (Radio Edit) (User: jbwharris)
Justice - D.A.N.C.E (User: jbwharris)
Mr. Big - To Be With You (User: jbwharris)
Roxy Music - A Really Good Time (User: jbwharris)
Burns Twins - Day by Day (feat. Sam Hudgens & Omar Apollo) (User: jbwharris)
Meyru - Running Day Dreams (User: jbwharris)
The Grapes Of Wrath - Fishing Tale, A (User: jbwharris)
The Sadies - Hold On, Hold On (User: jbwharris)
Blur - Music Is My Radar (User: jbwharris)
Echo & the Bunnymen - Bring On The Dancing Horses (User: jbwharris)
MGMT - Little Dark Age (User: jbwharris)
Stompin' Tom Connors - Merry Christmas Everybody (User: jbwharris)
Cat Power - Maybe Not (User: jbwharris)
Syko Friend - Hassle (User: jbwharris)
Breeze - Hard Boiled Wonderland (Korea Town Acid Mix) (User: jbwharris)
Eula Cooper - I Can't Help If I Love You (User: jbwharris)
Hylan Starr - Fool (User: jbwharris)
Little Esther Phillips - Sit Back Down (07-15-53) (User: jbwharris)
Robyn - Ever Again (User: jbwharris)
Bobby Hutcherson - Pompeian (User: jbwharris)
Karen Dalton - It Hurts Me Too (User: jbwharris)
Mason Jennings - On the Brink (User: jbwharris)
Billy Lemos - Rain (feat. Kopano) (User: jbwharris)
Ramones - I Wanna Be Sedated (User: jbwharris)
Jungle - Romeo (feat. Bas) (User: jbwharris)
Little Daylight - No One Else but You (Feat. Atlas Genius) (User: jbwharris)
Dead or Alive - You Spin Me 'Round (Like A Record) (User: jbwharris)
The Snuts - Glasgow (User: jbwharris)
Spllit - Darlene (User: jbwharris)
Nick Cave & Warren Ellis - Albuquerque (User: jbwharris)
Lewis Furey - Closing The Door (User: jbwharris)
The Hollies - Carrie Anne (2003 Remastered Version) (User: jbwharris)
Walk Off the Earth - Home We'll Go (User: jbwharris)
Kano - I'm Ready (User: jbwharris)
Queen Latifah - Ladies First (feat. Monie Love) [Lp Version] (User: jbwharris)
Ellie Goulding - Lights (User: jbwharris)
The Strokes - Last Nite (User: jbwharris)
Anderson .Paak - Fire In The Sky (User: jbwharris)
Billy Bragg & Wilco - At My Window Sad and Lonely (User: jbwharris)
Metric - Black Sheep (User: jbwharris)
Metric - Black Sheep (User: jbwharris)
Smoke Bellow - Night Light (User: jbwharris)
Boyce Avenue - Drops of Jupiter (User: jbwharris)
Disq - Daily Routine (User: jbwharris)
Sloan - The Good In Everyone (User: jbwharris)
The Age Of Electric - Remote Control (User: jbwharris)
Cold War Kids - What You Say (User: jbwharris)
Michael Franti & Spearhead - Hello Bonjour (User: jbwharris)
The Beaches - Money (User: jbwharris)
Ann Vriend - Anything I Know (User: jbwharris)
Alien Weaponry - Ahi Kā (User: jbwharris)
Kurt Vile - Stranger Than Kindness (User: jbwharris)
Sea Of Troubles - Regicide (User: jbwharris)
Pearl Jam - Elderly Woman Behind the Counter in a Small Town (User: jbwharris)
Slow Pulp - Idaho (User: jbwharris)
Jungle Brothers - Freakin' You (Buffalo Bunch Remix) (User: jbwharris)
Che Ecru - FALLING (User: jbwharris)
Dolly Parton - Jolene (User: jbwharris)
Brian English - The True Shepherd (User: jbwharris)
Elbow - Grounds for Divorce (User: jbwharris)
The Decemberists - Sons & Daughters (User: jbwharris)
Willie Dunn - I Pity The Country (User: jbwharris)
David Nail - In the Ghetto (User: jbwharris)
Wagon Christ - Toomorrow (User: jbwharris)
Arrested Development - Vibe (feat. Big Daddy Kane, Cleveland P. Jones, Speech, Tasha LaRae & Configa) (User: jbwharris)
Nino Moschella - Are You For Real (User: jbwharris)
Kenny Rogers & The First Edition - Ruby, Don't Take Your Love To Town (User: jbwharris)
Thad Cockrell & Brittany Howard - Higher (feat. Brittany Howard) (User: jbwharris)
Graham Brown - Haunted (User: jbwharris)
Chromeo - Come (User: jbwharris)
The White Stripes - Apple Blossom (User: jbwharris)
The Doors - When the Music's Over (User: jbwharris)
Leonard Cohen - Suzanne (User: jbwharris)
Dennis Brown - Westbound Train (User: jbwharris)
MoonLove - Cast Your Troubles and Dreams Away (User: jbwharris)
Evanescence - Bring Me to Life (User: jbwharris)
The Who - I'm Free (User: jbwharris)
Pixies - I Bleed (User: jbwharris)
U2 - Zoo Station (User: jbwharris)
Big Audio Dynamite II - Rush (User: jbwharris)
Hiroki Tanaka - Eternal Host (User: jbwharris)
Richard Fairlie - THE FIRST TIME EVER I SAW YOUR FACE (User: jbwharris)
Pretty Lights - We Must Go On (User: jbwharris)
The Charlatans - The Only One I Know (User: jbwharris)
R.E.M. - First We Take Manhattan (User: jbwharris)
The Stranglers - No Mercy (User: jbwharris)
Crash Parallel - Rain Delays (User: jbwharris)
Massive Attack - Teardrop (User: jbwharris)
Pet Shop Boys - West End Girls (User: jbwharris)
Perfume Genius - Borrowed Light (User: jbwharris)
Vincent Vallières - On Va S'aimer Encore (User: jbwharris)
Sweet Alibi - Confetti (User: jbwharris)
Dave Matthews & Tim Reynolds - Crash Into Me (User: jbwharris)
AWOLNATION - Woman Woman (User: jbwharris)
Nash The Slash - Dead Man's Curve (2016 Remaster) (User: jbwharris)
Matthew Good - A Momentary Truth (User: jbwharris)
Braids - Letting Go (User: jbwharris)
The B-52's - Dance This Mess Around (User: jbwharris)
Born Ruffians - Needle (User: jbwharris)
Third Eye Blind - Jumper (User: jbwharris)
Christine Fellows, John K. Samson & Sandro Perri - Bruce Beckons (Bruce Peninsula, ON) (User: jbwharris)
Big Sugar - Dear Mr. Fantasy (User: jbwharris)
Foo Fighters - This Is a Call (User: jbwharris)
Elvis Costello - Brilliant Mistake (User: jbwharris)
Adele - Oh My God (User: jbwharris)
Cowboy Junkies - Sweet Jane (User: jbwharris)
Drake - Hotline Bling (User: jbwharris)
Sonic Youth - Bull In The Heather (User: jbwharris)
The Strokes - Reptilia (User: jbwharris)
Elsa Hewitt - IFM (User: jbwharris)
Mumford & Sons - I Will Wait (User: jbwharris)
Bat for Lashes - Daniel (User: jbwharris)
Harry Styles - Watermelon Sugar (User: jbwharris)
Aron Blom - King Kong (User: jbwharris)
Reuben And The Dark & AG - Shiny Happy People (User: jbwharris)
Elvis Presley - Love Me Tender (First 'STAND-UP' show) (User: jbwharris)
The Cult - Rain (User: jbwharris)
The Offspring - The Kids Aren't Alright (User: jbwharris)
Depeche Mode - People Are People (User: jbwharris)
Four Tet - Parallel Jalebi (User: jbwharris)
Abhinav Sarswat - Fake Tiger vs. Real Dog (User: jbwharris)
Marisa Anderson & William Tyler - News About Heaven (User: jbwharris)
The Comet Is Coming - Timewave Zero (User: jbwharris)
Big Wreck - Albatross (User: jbwharris)
Mazzy Star - Fade Into You (User: jbwharris)
Grant Lee Buffalo - Mockingbirds (User: jbwharris)
Greta Van Fleet - My Way, Soon (User: jbwharris)
The Far Removed - Gone (feat. Maro Lytra & Dimmys Kontorousis Remix) [feat. Maro Lytra, Dimmys Kontorousis Remix] (User: jbwharris)
Melanie Fiona - Give It To Me Right (User: jbwharris)
Franz Ferdinand - Take Me Out (User: jbwharris)
HOMESHAKE - Vacuum (User: jbwharris)
Carter Ace - Baggage (User: jbwharris)
The National - Never Tear Us Apart (User: jbwharris)
Goldfrapp - Train (User: jbwharris)
The Beautiful South - Song For Whoever (User: jbwharris)
Ya Tseen - Close the Distance (User: jbwharris)
MANU GRACE - Waiting for a Change (waiting, for a change) (User: jbwharris)
Ted Leo and the Pharmacists - Where Have All the Rude Boys Gone? (User: jbwharris)
Built to Spill - Big Dipper (User: jbwharris)
James Blake - Godspeed (User: jbwharris)
U2 - Until the End of the World (User: jbwharris)
Ride - Leave Them All Behind (User: jbwharris)
Arthur Alexander - Thank God He Came (User: jbwharris)
The Dream Academy - The Love Parade (LP Version) (User: jbwharris)
Bill Withers - Lovely Day (User: jbwharris)
Miles Kane - Nothings Ever Gonna Be Good Enough (User: jbwharris)
Delachute - Caligula (User: jbwharris)
Arkells - Making Due (User: jbwharris)
Sniff 'n' the Tears - Driver's Seat (User: jbwharris)
HighSchool - Forever at Last (User: jbwharris)
Dylan Cox - Animals in the Kitchen (User: jbwharris)
Mobile - The Killer (User: jbwharris)
EVE 6 - Inside Out (User: jbwharris)
The Elwins - Hey! Ya, You (User: jbwharris)
Images In Vogue - Call It Love (User: jbwharris)
The Diodes - Red Rubber Ball (User: jbwharris)
Pixies - Dig for Fire (User: jbwharris)
Royal Wood - Brand New Life (User: jbwharris)
The Staple Singers - Freedom Highway (User: jbwharris)
Naming The Twins - One Storm from Home (User: jbwharris)
Alex Mali - Hoity Toity (feat. Melo-X) (User: jbwharris)
Parquet Courts - Homo Sapien (User: jbwharris)
Cher - SOS (User: jbwharris)
The Sugarhill Gang - Rapper's Delight (User: jbwharris)
Smashing Pumpkins - Today (User: jbwharris)
Thundercat - Funny Thing (User: jbwharris)
Kris Kristofferson - Just the Other Side of Nowhere (User: jbwharris)
Kevin Holliday - Every Single Time (User: jbwharris)
Radiohead - Knives Out (User: jbwharris)
Interpol - Evil (User: jbwharris)
One Direction - What Makes You Beautiful (User: jbwharris)
Elvis Costello & The Attractions - Pump It Up (User: jbwharris)
The Four Tops - Reach Out, I'll Be There (Montez Payton & Taurus Braxton Remix) (User: jbwharris)
U2 - Love Is Blindness (User: jbwharris)
CHVRCHES - Recover (User: jbwharris)
Cut Copy - In These Arms Of Love (User: jbwharris)
The Super Friendz - 10 Lbs. (User: jbwharris)
Jasmine Thompson - Pompeii (User: jbwharris)
LCD Soundsystem - North American Scum (User: jbwharris)
Mike Lundy - Love One Another (User: jbwharris)
Arlo Parks - Cola (User: jbwharris)
Modest Mouse - The Sun Hasn't Left (User: jbwharris)
Dear Rouge - Boys & Blondes (User: jbwharris)
Our Lady Peace - Life (User: jbwharris)
DMA's - The Glow (User: jbwharris)
The Struts - Could Have Been Me (User: jbwharris)
The Ruralists - Your Bones Get Old (User: jbwharris)
George McCrae - Rock Your Baby (User: jbwharris)
The Telescopes - And Let Me Drift Away (User: jbwharris)
Queens of the Stone Age - I Sat by the Ocean (User: jbwharris)
Whale - Hobo Humpin' Slobo Babe (User: jbwharris)
Skinny Living - Let Go (User: jbwharris)
Portishead - Glory Box (User: jbwharris)
Foo Fighters - Times Like These (User: jbwharris)
Buddy Guy - Ten Years Ago (User: jbwharris)
d'Eon - Recession Proof ($40 Paycheque) (User: jbwharris)
Big Thief - Shark Smile (User: jbwharris)
Yukon Blonde - Love the Way You Are (User: jbwharris)
Foo Fighters - Miracle (User: jbwharris)
Shout Out Louds - The Comeback (User: jbwharris)
Blue Rodeo - Trust Yourself (User: jbwharris)
Tegan and Sara - The Cure (User: jbwharris)
Big Star - Back Of A Car (User: jbwharris)
Turnstile - BLACKOUT (User: jbwharris)
Christian Lee Hutson - Talk (User: jbwharris)
Neko Case - People Got a Lotta Nerve (User: jbwharris)
Talking Heads - And She Was (User: jbwharris)
Chocolate Snow - It's Like Heaven (User: jbwharris)
Bleeker - Give A Little Bit More (Disaster) (User: jbwharris)
Blossoms - The Keeper (User: jbwharris)
Hurray For The Riff Raff - RHODODENDRON (User: jbwharris)
Jelani Blackman - Lockjaw (User: jbwharris)
PJ Harvey - Sheela-Na-Gig (User: jbwharris)
SonReal - My Friend (User: jbwharris)
Eli Keszler - Static Doesn’t Exist (User: jbwharris)
Hop Along - Waitress (User: jbwharris)
The Beaches - T-Shirt (User: jbwharris)
Florence + the Machine - Moderation (User: jbwharris)
Arkells & K.Flay - You Can Get It (User: jbwharris)
Queen - Stone Cold Crazy (User: jbwharris)
The Gaslight Anthem - The '59 Sound (User: jbwharris)
DJ Shadow - Rocket Fuel (feat. De La Soul) (User: jbwharris)
Arcade Fire - Signs of Life (User: jbwharris)
amindi - Eggs Aisle (User: jbwharris)
James Blake - Life Round Here (feat. Chance The Rapper) (User: jbwharris)
Thalia Zedek Band - Cranes (User: jbwharris)
Yukon Blonde - Saturday Night (User: jbwharris)
Dinosaur Jr. - Feel the Pain (2019 Remaster) (User: jbwharris)
Kondi Band & Sweatson Klank - It's God's World (So Don't Do Bad) (User: jbwharris)
Bruce Springsteen - I'm on Fire (User: jbwharris)
MUNA - Silk Chiffon (feat. Phoebe Bridgers) (User: jbwharris)
The Roches - Hammond Song (User: jbwharris)
Peter Elkas - Melody (User: jbwharris)
foxwood - Butter (User: jbwharris)
Nick Lowe - (What's So Funny 'Bout) Peace, Love And Understanding (User: jbwharris)
Shotgun Jimmie - Late Last Year (User: jbwharris)
Tamaryn - Choirs of Winter (User: jbwharris)
The Replacements - Here Comes A Regular (User: jbwharris)
Ashton McCreight - Million (feat. Love Mansuy & Kaiya Crawford) (User: jbwharris)
The Jayhawks - I'm Gonna Make You Love Me (User: jbwharris)
Little Eva - The Locomotion (User: jbwharris)
Simon & Garfunkel - The Sound of Silence (User: jbwharris)
The Coronas & Gabrielle Aplin - Lost in The Thick Of It (User: jbwharris)
Gord Downie & the Sadies - Budget Shoes (User: jbwharris)
Attack In Black - Young Leaves (User: jbwharris)
Kiss the Tiger - Motel Room (User: jbwharris)
Misty River - Take This Dance (User: jbwharris)
PJ Harvey - You Said Something (User: jbwharris)
The Kooks - Naïve (User: jbwharris)
Florence + the Machine - Dog Days Are Over (User: jbwharris)
Vance Joy - Missing Piece (User: jbwharris)
Flesh For Lulu - I Go Crazy (User: jbwharris)
The Rural Alberta Advantage - White Lights (User: jbwharris)
Haïm - The Wire (User: jbwharris)
Sam Roberts - Where Have All The Good People Gone? (User: jbwharris)
Cage the Elephant - Mess Around (User: jbwharris)
Imagine Dragons - Thunder (User: jbwharris)
The Hives - Wait a Minute (User: jbwharris)
Echo And The Bunnymen - Bring On The Dancing Horses (User: jbwharris)
Joe Jackson - I'm The Man (User: jbwharris)
The Killers - All These Things That I've Done (User: jbwharris)
Big Sugar - Diggin' A Hole (User: jbwharris)
Elliott BROOD - The Valley Town (User: jbwharris)
The Stone Roses - She Bangs the Drums (User: jbwharris)
Peter Schilling - Major Tom (User: jbwharris)
Bahamas - Whole Wide World (User: jbwharris)
The Blue Stones - Be My Fire (User: jbwharris)
Royal Blood - Little Monster (User: jbwharris)
The Record Company - Baby I'm Broken (User: jbwharris)
Jack White - I'm Shakin' (User: jbwharris)
The White Stripes - Icky Thump (User: jbwharris)
July Talk - Paper Girl (User: jbwharris)
Des Rocs - Outta My Mind (feat. The Cobra) (User: jbwharris)
Royal Blood - How Did We Get So Dark? (User: jbwharris)
The Stone Foxes - Patience (User: jbwharris)
Goodbye June - Oh No (User: jbwharris)
July Talk - The Garden (User: jbwharris)
Black Rebel Motorcycle Club - Beat the Devil's Tattoo (User: jbwharris)
The Glorious Sons - Spirit to Break (User: jbwharris)
The Temperance Movement - Oh Lorraine (User: jbwharris)
The Fumes - Automobile (User: jbwharris)
The Black Keys - Lo/Hi (User: jbwharris)
Bleeker - Every Time You Call (User: jbwharris)
Jack White - That Black Bat Licorice (User: jbwharris)
Rival Sons - Do Your Worst (User: jbwharris)
Quaker City Night Hawks - Crack at the Bottle (User: jbwharris)
Bleeker - Highway (User: jbwharris)
The Stone Foxes - Everybody Knows (User: jbwharris)
The Blue Stones - One by One (User: jbwharris)
Black Rebel Motorcycle Club - Spread Your Love (User: jbwharris)
The Pack A.D. - Take (User: jbwharris)
The Glorious Sons - Closer to the Sky (User: jbwharris)
Royal Blood - Ten Tonne Skeleton (User: jbwharris)
Band of Skulls - H*****e Coochie (User: jbwharris)
Jack White - Lazaretto (User: jbwharris)
Royal Blood - Out of the Black (User: jbwharris)
Death from Above 1979 - Losing Friends (User: jbwharris)
The Glorious Sons - S.O.S. (Sawed Off Shotgun) (User: jbwharris)
The White Stripes - I Just Don't Know What to Do With Myself (User: jbwharris)
Rival Sons - Tied Up (User: jbwharris)
Cage the Elephant - Cold Cold Cold (User: jbwharris)
July Talk - Guns+Ammunition (User: jbwharris)
The Blue Stones - Black Holes (Solid Ground) (User: jbwharris)
July Talk - Picturing Love (User: jbwharris)
The Glorious Sons - A War on Everything (User: jbwharris)
Cage the Elephant - Mess Around (User: jbwharris)
Royal Blood - Come on Over (User: jbwharris)
The Steepwater Band - Collision (User: jbwharris)
The Blue Stones - Rolling with the Punches (User: jbwharris)
The Blackwater Fever - Breakdown (User: jbwharris)
The Black Keys - Gotta Get Away (User: jbwharris)
Reignwolf - Son of a Gun (User: jbwharris)
Tyler Bryant & The Shakedown - Fools Gold (User: jbwharris)
Bloc Party - Traps (User: jbwharris)
Black Pistol Fire - Lost Cause (User: jbwharris)
Dj Quads - I Got A Story (User: jbwharris)
Nathaniel Rateliff & the Night Sweats - Survivor (User: jbwharris)
Black Pistol Fire - Level (User: jbwharris)
Young the Giant - My Body (User: jbwharris)
Milky Chance - Colorado (User: jbwharris)
Jack White - Connected by Love (User: jbwharris)
The Royal Foundry - Hopefully (User: jbwharris)
Collective Soul - December (User: jbwharris)
The Smiths - How Soon Is Now? (User: jbwharris)
Hollerado - So It Goes (User: jbwharris)
Boy Golden - KD and Lunch Meat (User: jbwharris)
The Sheepdogs - I've Got a Hole Where My Heart Should Be (User: jbwharris)
Greta Van Fleet - When The Curtain Falls (User: jbwharris)
Rise Against - Nowhere Generation (User: jbwharris)
Nathaniel Rateliff & the Night Sweats - Survivor (User: jbwharris)
The All-American Rejects - Dirty Little Secret (User: jbwharris)
Rezz - Paper Walls (User: jbwharris)
Lord Huron - Mine Forever (User: jbwharris)
Courtney Barnett - Write a List of Things to Look Forward To (User: jbwharris)
Confidence Man - Holiday (User: jbwharris)
Johnny Marr - Tenement Time (User: jbwharris)
Modest Mouse - The Sun Hasn't Left (User: jbwharris)
Kero Kero Bonito - The Sneaker Dance (User: jbwharris)
Band of Horses - Crutch (User: jbwharris)
Anamanaguchi - Lorem Ipsum (User: jbwharris)
Tiga - Hot in Herre (User: jbwharris)
Christine and the Queens - Damn, dis-moi (User: jbwharris)
Ladytron - The Animals (User: jbwharris)
Cut Copy - Free Your Mind (User: jbwharris)
John Grant - Love Is Magic (User: jbwharris)
Shout Out Out Out Out - Forever Indebted (User: jbwharris)
Dan Deacon - Build Voice - remix (User: jbwharris)
Perfume Genius - Describe (User: jbwharris)
Marina and the Diamonds - Froot (User: jbwharris)
Jamie xx - I Know There's Gonna Be (User: jbwharris)
Ryan Murgatroyd - iKalimba (User: jbwharris)
Jes - We Belong To The Night (User: jbwharris)
Joseph Keevill - It Was Written - 1 (User: jbwharris)
Zinc - Emanate (User: jbwharris)
DJ Zinc - Emanate (User: jbwharris)
Fort Romeau - Lately (User: jbwharris)
Yaz - Don't Go (User: jbwharris)
Yazoo - Don't Go (User: jbwharris)
Prince - 1999 (User: jbwharris)
Level 42 - Lessons in Love (User: jbwharris)
New Order - Bizarre Love Triangle (User: jbwharris)
Pet Shop Boys - It's a Sin (User: jbwharris)
Underworld - Born Slippy (User: jbwharris)
Kraftwerk - Computer Love (User: jbwharris)
Hot Butter - Popcorn (User: jbwharris)
The Venus Fly Trap - Puppet (User: jbwharris)
Frankenfido - Some Little Way (User: jbwharris)
Nala Blu - Nothing Lasts Forever (User: jbwharris)
Vinyl Arch Rodeo - Everyone (User: jbwharris)
Palm Ghosts - The Hound (User: jbwharris)
The Far Removed - Gone (User: jbwharris)
Ohtis - Schatze (User: jbwharris)
Dum Dum Girls - I Got Nothing (User: jbwharris)
Sex Pistols - God Save the Queen (User: jbwharris)
The Cramps - Human Fly (User: jbwharris)
Echo And The Bunnymen - Never Stop (User: jbwharris)
Band of Horses - In Need of Repair (User: jbwharris)
Lykke Li - Get Some (User: jbwharris)
Sharon Van Etten - Seventeen (User: jbwharris)
The The - This Is The Day (User: jbwharris)
Indigo De Souza - Hold U (User: jbwharris)
Modest Mouse - The Sun Hasn't Left (User: jbwharris)
Julien Baker - Faith Healer (User: jbwharris)
Nick Drake - Northern Sky (User: jbwharris)
Michael Kiwanuka - Beautiful Life - From The Netflix Documentary "Convergence" (User: jbwharris)
Caribou - Home (User: jbwharris)
Muse - Supermassive Black Hole (User: jbwharris)
Tony Modicano - Supermassive Black Hole (User: jbwharris)
Dua Saleh - Fitt feat. Amaarae (User: jbwharris)
Deep Purple - Smoke on the Water (User: jbwharris)
Parquet Courts - Walking At A Downtown Pace (User: jbwharris)
Sleater-Kinney - Worry With You (User: jbwharris)
FPA - Baby (User: jbwharris)
Martin Courtney - Northern Highway (User: jbwharris)
Tori Amos - Spies (User: jbwharris)
Depeche Mode - Just Can't Get Enough (User: jbwharris)
Sunflower Bean - Baby Don't Cry (User: jbwharris)
Mother Mother - Bit By Bit (User: jbwharris)
AWOLNATION - Woman Woman (User: jbwharris)
Dennis Brown - Westbound Train (User: jbwharris)
Stompin' Tom Connors - Merry Christmas Everybody (User: jbwharris)
Born Ruffians - Miss You (User: jbwharris)
My Morning Jacket - Love Love Love (User: jbwharris)
Robert Plant, Alison Krauss - Can't Let Go (User: jbwharris)
Reuben And The Dark - Heart in Two (User: jbwharris)
Adia Victoria - Dead Eyes (User: jbwharris)
Jet - Are You Gonna Be My Girl (User: jbwharris)
Mason Jennings - On the Brink (User: jbwharris)
Christine and the Queens - People, I've been sad (User: jbwharris)
Mixtape for the Milky Way - No Sidewalks (User: jbwharris)
Foals - Wake Me Up (User: jbwharris)
JD McPherson - North Side Gal (User: jbwharris)
Spoon - The Hardest Cut (User: jbwharris)
Adele - All Night Parking Interlude (User: jbwharris)
The Avett Brothers - Laundry Room (User: jbwharris)
Cat Power - Bad Religion (User: jbwharris)
Lana Del Rey - If You Lie Down With Me (User: jbwharris)
Frank Turner - Blackout (User: jbwharris)
The Cure - Fascination Street (User: jbwharris)
Dijon - Many Times (User: jbwharris)
St. Paul & The Broken Bones - The Last Dance (User: jbwharris)
Bleachers - Stop Making This Hurt (User: jbwharris)
Longshot - Where's The Peace (User: jbwharris)
Trampled by Turtles - Western World (User: jbwharris)
Jack White - Taking Me Back (User: jbwharris)
Bad Bad Hats - Write It on Your Heart (User: jbwharris)
The Vaccines - Dream Lover (User: jbwharris)
Beach Bunny - Oxygen (User: jbwharris)
The Beatles - Only a Northern Song (User: jbwharris)
The Beatles - Only a Northern Song (User: jbwharris)
The Killers - Quiet Town (User: jbwharris)
Sharon Jones and the Dap-Kings - Just Another Christmas Song (User: jbwharris)
A Tribe Called Quest - Can I Kick It? (User: jbwharris)
Coin - Chapstick (User: jbwharris)
The Joy Formidable - Into The Blue (User: jbwharris)
Moby - South Side (User: jbwharris)
Moby - South Side (User: jbwharris)
Moby - South Side (User: jbwharris)
ROSALÍA - MALAMENTE (User: jbwharris)
Night Moves - Fallacy Actually (User: jbwharris)
CHVRCHES - Good Girls (User: jbwharris)
Adele - Hold On (User: jbwharris)
Anderson East - Madelyn (User: jbwharris)
Alabama Shakes - Hang Loose (User: jbwharris)
Fujiya & Miyagi - Collarbone (User: jbwharris)
Fujiya & Miyagi - Collarbone (User: jbwharris)
Fujiya & Miyagi - Collarbone (User: jbwharris)
Curtis Harding - Can't Hide It (User: jbwharris)
Tom Waits - Goin' Out West (User: jbwharris)
Foo Fighters - Making a Fire (User: jbwharris)
Tears for Fears - Mad World (User: jbwharris)
Tears for Fears - Mad World (User: jbwharris)
RAFFAELLA - Bardot (User: jbwharris)
Damon Albarn - Royal Morning Blue (User: jbwharris)
The War on Drugs - Old Skin (User: jbwharris)
Best Coast - This Lonely Morning (User: jbwharris)
Lo Moon - Dream Never Dies (User: jbwharris)
Kacey Musgraves - justified (User: jbwharris)
Lucy Dacus - Hot & Heavy (User: jbwharris)
Talking Heads - Girlfriend Is Better (User: jbwharris)
IDLES - The Beachland Ballroom (User: jbwharris)
Leon Bridges - If It Feels Good (User: jbwharris)
Urge Overkill - Girl, You'll Be a Woman Soon (User: jbwharris)
Durry - Who's Laughing Now (User: jbwharris)
Martin Zellar - East Side Boys (User: jbwharris)
Jade Bird - Now Is The Time (User: jbwharris)
Tame Impala - Is It True (User: jbwharris)
Humbird - Plum Sky (User: jbwharris)
Reigning Sound - North Cackalacky Girl (User: jbwharris)
Band of Horses - Crutch (User: jbwharris)
The Psychedelic Furs - Heaven (User: jbwharris)
Cannons - Bad Dream (User: jbwharris)
The Velvet Underground - Foggy Notion (User: jbwharris)
Courtney Barnett - Write a List of Things to Look Forward To (User: jbwharris)
Matt Berninger - One More Second (User: jbwharris)
Elvis Costello, The Imposters - Magnificent Hurt (User: jbwharris)
The Charlatans - The Only One I Know (User: jbwharris)
Franz Ferdinand - Billy Goodbye (User: jbwharris)
John Hiatt - Drive South (User: jbwharris)
Margo Price - Letting Me Down (User: jbwharris)
Seratones - Gotta Get To Know Ya (User: jbwharris)
Johnny Marr - Spirit Power and Soul (User: jbwharris)
The Lumineers - Cleopatra (User: jbwharris)
Foals - Wake Me Up (User: jbwharris)
Arcade Fire - Creature Comfort (User: jbwharris)
The 1975 - Love It If We Made It (User: jbwharris)
Disturbed - The Sound of Silence (User: jbwharris)
Franz Ferdinand - Always Ascending (User: jbwharris)
Our Lady Peace - Automatic Flowers (User: jbwharris)
Cleopatrick - Hometown (User: jbwharris)
Live - Lightning Crashes (User: jbwharris)
Gob - I Hear You Calling (User: jbwharris)
The Tragically Hip - Little Bones (User: jbwharris)
Phantogram - You Don’t Get Me High Anymore (User: jbwharris)
Trouble - 3 (User: jbwharris)
Led Zeppelin - Good Times Bad Times (User: jbwharris)
Orgy - Blue Monday (User: jbwharris)
Arcade Fire - Neighbourhood #3 (User: jbwharris)
Queen - We Will Rock You (User: jbwharris)
Queen - We Are the Champions (User: jbwharris)
Buffalo Gals Band - I'd Just as Soon Stay Home (User: jbwharris)
Pharrell Williams - Happy (User: jbwharris)
Sesame Street - I Love Trash (User: jbwharris)
Rolie Polie Guacamole - Jungle Friends (User: jbwharris)
Guster - I've Got to Be Clean (User: jbwharris)
Spongebob Squarepants - Ripped Pants (User: jbwharris)
Tom Chapin - Good Garbage (User: jbwharris)
Ziggy Marley - ABC (User: jbwharris)
Ziggy Marley - ABC (User: jbwharris)
Peppa Pig - Bing Bong Zoo (User: jbwharris)
chris propfe - Roy G. Biv (User: jbwharris)
Joel Frankel - Bubble Gum Baby (User: jbwharris)
Charles Fox - Wonder Woman (User: jbwharris)
Wayne Potash - Constantinople (User: jbwharris)
The Board of Education - Volcanoes and You (User: jbwharris)
Phineas and the Ferbtones - Gitchee Gitchee Goo (User: jbwharris)
Rani Arbo & Daisy Mayhem - The Green Grass Grows All Around (User: jbwharris)
Bob McGrath - Somebody Come and Play (User: jbwharris)
Tegan and Sara - I Couldn't Be Your Friend (User: jbwharris)
Fall Out Boy - Uma Thurman (User: jbwharris)
Lizzo - Bother Me (User: jbwharris)
The Treble - No Secrets (User: jbwharris)
Jackson Browne - Here Come Those Tears Again (User: jbwharris)
Simple Minds - Promised You a Miracle (User: jbwharris)
Southern Culture On The Skids - 8 Piece Box (User: jbwharris)
The Silos - For Always (User: jbwharris)
The Silos - For Always (User: jbwharris)
Tommy Conwell - I'm Not Your Man (User: jbwharris)
Warpaint - New Song (User: jbwharris)
Amos Lee - Shout Out Loud (User: jbwharris)
Steve Miller Band - Fly Like an Eagle (User: jbwharris)
Mitski - The Only Heartbreaker (User: jbwharris)
Wolf Alice - Don’t Delete the Kisses (User: jbwharris)
Essaie Pas - Complet Brouillé (User: jbwharris)
Altin Gün - Kısasa Kısas (User: jbwharris)
Depeche Mode - Puppets (User: jbwharris)
Jessie Ware - Soul Control (User: jbwharris)
Thievery Corporation feat. Racquel Jones - Letter To The Editor (User: jbwharris)
Jessy Lanza - It Means I Love You (User: jbwharris)
Riki - Marigold (User: jbwharris)
Beach House - Through Me (User: jbwharris)
RJD2 - Smoke & Mirrors (User: jbwharris)
The Dukes Of Stratosphear - Your Gold Dress (User: jbwharris)
Parquet Courts - Black Widow Spider (User: jbwharris)
My Morning Jacket - Love Love Love (User: jbwharris)
A Tribe Called Quest - Push It Along (User: jbwharris)
Blood Orange - E.V.P. (User: jbwharris)
Xeno & Oaklander - Afar (User: jbwharris)
Lady Wray - Under The Sun (User: jbwharris)
Talking Heads - Girlfriend Is Better (User: jbwharris)
