Thomas Oliver - Coffee (User: jbwharris)
The Glorious Sons - Closer to the Sky (User: jbwharris)
Dayglow - Close to You (User: jbwharris)
Danny Michel - Click Click (User: jbwharris)
Calum Jones - Change For the Better (User: jbwharris)
Airstream Futures - Cemetery Sparrow (User: jbwharris)
Pixies - Caribou (User: jbwharris)
Caribou - Can't Do Without You (User: jbwharris)
Amelia Curran - Bye Bye Montreal (User: jbwharris)
Ellis - Buried Myself (User: jbwharris)
Christine Fellows, John K. Samson & Sandro Perri - Bruce Beckons (Bruce Peninsula, ON) (User: jbwharris)
Dear Rouge - Boys & Blondes (User: jbwharris)
Underworld - Born Slippy (Nuxx) (User: jbwharris)
Body Count - Body Count's in the House (User: jbwharris)
The Tragically Hip - Bobcaygeon (User: jbwharris)
The Dirty Nil - Blunt Force Concussion (User: jbwharris)
Martha Wainwright - Bloody Mother F***ing A**hole (User: jbwharris)
The New Pornographers - The Bleeding Heart Show (User: jbwharris)
Pixies - Bird of Prey (User: jbwharris)
Uss - Big Life (26 Letters) (User: jbwharris)
Blood Orange - Best to You (User: jbwharris)
Vertical Horizon - Best I Ever Had (Grey Sky Morning) (User: jbwharris)
Radiohead - The Bends (User: jbwharris)
Imaginary Cities - Bells Of Cologne (User: jbwharris)
Weezer - Beginning of The End (Wyld Stallyns Edit) (User: jbwharris)
The Dirty Nil - Bathed in Light (User: jbwharris)
The Black Crowes - Ballad In Urgency (2010 Acoustic Version) (User: jbwharris)
Rusty - Balance (User: jbwharris)
The Offspring - Bad Habit (User: jbwharris)
Madonna - Bad Girl (User: jbwharris)
Sam Roberts Band - Ascension (User: jbwharris)
Justin Bieber - Anyone (User: jbwharris)
The Sadies - Another Year Again (User: jbwharris)
Ray LaMontagne - Another Day (User: jbwharris)
The Menzingers - Anna (User: jbwharris)
Jelani Aryeh - Angels (User: jbwharris)
Big Sugar - All Hell For A Basement (User: jbwharris)
My Life with the Thrill Kill Kult - After the Flesh (User: jbwharris)
Devo - Satisfaction (User: jbwharris)
Destroyer - Tinseltown Swimming in Blood (User: jbwharris)
Fountains of Wayne - Radiation Vibe (User: jbwharris)
Kate Bush - Running Up That Hill (User: jbwharris)
Incubus - Drive (User: jbwharris)
The Beaches - Blow Up (User: jbwharris)
Jeremy Dutcher - Mehcinut (User: jbwharris)
The Blue Stones - Let It Ride (User: jbwharris)
warner case & Jean Tonique - I Miss New York (User: jbwharris)
The Beaches - Want What You Got (User: jbwharris)
TOPS - Party Again (User: jbwharris)
Teenage Head - Somethin' Else (User: jbwharris)
Sam Roberts - Where Have All The Good People Gone? (User: jbwharris)
Ted Jasper - Do Something (feat. Kay Young & Shaquille-Aaron Keith) (User: jbwharris)
Sunrom - You Don't Know (User: jbwharris)
Spaceface - Happens All the Time (User: jbwharris)
slenderbodies - favorable colours (User: jbwharris)
Nuela Charles - Crumbling Down (User: jbwharris)
salami rose joe louis - Nostalgic Montage (User: jbwharris)
Waxlimbs - Watercolour Sun (User: jbwharris)
Oasis - Champagne Supernova (User: jbwharris)
RÜFÜS DU SOL - Next To Me (User: jbwharris)
Big Wreck - Albatross (User: jbwharris)
Rohne - Circles (User: jbwharris)
Remi Wolf - Liquor Store (User: jbwharris)
QUICKLY, QUICKLY - Shee (User: jbwharris)
Polo & Pan - Magic (User: jbwharris)
Pizzagirl - Sugar Ray (User: jbwharris)
Patrick Watson - A Mermaid in Lisbon (feat. Teresa Salgueiro) (User: jbwharris)
Patagon - LOST INSIDE (User: jbwharris)
NASAYA & MARO - TEMPO (User: jbwharris)
Most Akin - All The While (User: jbwharris)
Modest Mouse - The Sun Hasn't Left (User: jbwharris)
Mild High Club - Me Myself and Dollar Hell (User: jbwharris)
Massane - Wild (feat. Colouring) (User: jbwharris)
Lunar Vacation - Shrug (User: jbwharris)
Liam Mour - If We Only Had (User: jbwharris)
Klaz - Give In (User: jbwharris)
Justin Bieber - Peaches (feat. Daniel Caesar & GIVĒON) (User: jbwharris)
Jungle - Romeo (feat. Bas) (User: jbwharris)
José González - Head On (User: jbwharris)
Jordan Rakei - Family (User: jbwharris)
The Haunted Youth - Coming Home (User: jbwharris)
Fred Paa Jord - Bommer På Alt (User: jbwharris)
Franc Moody - Let It Kick In (User: jbwharris)
Eliza Shaddad - Fine & Peachy (User: jbwharris)
CONDITIONER - Terms of Surrender (User: jbwharris)
Chet Faker - Feel Good (User: jbwharris)
Chet Faker - Oh Me Oh My (User: jbwharris)
Bee Gees - More Than A Woman (From "Saturday Night Fever" Soundtrack) (User: jbwharris)
Barry Can't Swim - Jazz Club After Hours (User: jbwharris)
Aquilo - Out in LA (User: jbwharris)
Andrew Applepie - Fool (User: jbwharris)
Future Islands - Peach (User: jbwharris)
James BKS - New Breed (feat. Q-Tip, Idris Elba & Little Simz) (User: jbwharris)
Billie Eilish - Your Power (User: jbwharris)
Cassowary - She Funked Me (User: jbwharris)
When In Rome - The Promise (User: jbwharris)
chris propfe - Roy G. Biv (User: jbwharris)
Bob McGrath - Put Down the Duckie (User: jbwharris)
Caroline Polachek - Bunny Is a Rider (User: jbwharris)
Azalyne - E-Girl (User: jbwharris)
Jerry Jones - Compared to What (User: jbwharris)
Björk - It's in Our Hands (User: jbwharris)
Sault - Trap Life (User: jbwharris)
Jack Peñate - Torn on the Platform (User: jbwharris)
The Velvet Underground - Foggy Notion (User: jbwharris)
Kraftwerk - The Robots (User: jbwharris)
Elyse Saunders - Free (User: jbwharris)
Sleater-Kinney - A New Wave (User: jbwharris)
Lake Street Dive - Know That I Know (User: jbwharris)
Beastie Boys - So What'cha Want (User: jbwharris)
Margo Price - Stone Me (User: jbwharris)
Dizzee Rascal - Fix Up, Look Sharp (User: jbwharris)
Ambar Lucid - Space Cowgirl (User: jbwharris)
Lori Nuic - Dark Side of the Moon (User: jbwharris)
Fishbone - Ma and Pa (User: jbwharris)
Aretha Franklin - Chain of Fools (User: jbwharris)
Jenn Beaupre - YaYa (User: jbwharris)
Billy Bragg - I Will Be Your Shield (User: jbwharris)
The Primitives - Sick Of It (User: jbwharris)
Front 242 - Headhunter V1.0 (User: jbwharris)
The Brothers Macklovitch & A-Trak - Give Love to Get Some (feat. Leven Kali) (User: jbwharris)
Haviah Mighty - Thirteen (User: jbwharris)
Andrew Bird - Measuring Cups (User: jbwharris)
Jordan Rakei - Send My Love (User: jbwharris)
Tim Hardin - If I Were A Carpenter (User: jbwharris)
Madonna - Music (User: jbwharris)
Young Empires - Sunshine (User: jbwharris)
Beck - Sexx Laws (User: jbwharris)
Willie Nelson - Georgia on My Mind (User: jbwharris)
Joe Jackson - Get That Girl (User: jbwharris)
The Maccabees - Toothpaste Kisses (User: jbwharris)
Jenn Champion & OYSTER KIDS - Push (User: jbwharris)
Nine Inch Nails - Came Back Haunted (User: jbwharris)
Kool & the Gang - Let The Music Take Your Mind (User: jbwharris)
Sugar - Helpless (User: jbwharris)
Anjulie - You And I (User: jbwharris)
Chelsea Stewart - Do You Love Me (User: jbwharris)
Merle Haggard - The Bottle Let Me Down (Re-Recorded) (User: jbwharris)
Dan Auerbach - The Prowl (User: jbwharris)
Joy Oladokun - breathe again (User: jbwharris)
Desperate Journalist - Everything You Wanted (User: jbwharris)
Stereophonics - Handbags and Gladrags (User: jbwharris)
Matthew E. White - Genuine Hesitation (User: jbwharris)
The Smithereens - Too Much Passion (User: jbwharris)
Mountain - Long Red (User: jbwharris)
X - The New World (User: jbwharris)
Chris Farren - Surrender (User: jbwharris)
Maria McKee - I Can't Make It Alone (User: jbwharris)
Wanda Jackson - Rock Your Baby (User: jbwharris)
beabadoobee - He Gets Me So High (User: jbwharris)
Amyl and the Sniffers - Security (User: jbwharris)
Guided by Voices - Motor Away (User: jbwharris)
Imperial Teen - Baby (User: jbwharris)
Tyler, the Creator - LUMBERJACK (User: jbwharris)
Samm Henshaw - Church (feat. EARTHGANG) (User: jbwharris)
Boogie Belgique - Goodnight Moon (User: jbwharris)
The Howl & The Hum - Hostages (Alternate) (User: jbwharris)
Celeste - Stop This Flame (User: jbwharris)
Modest Mouse - Back To The Middle (User: jbwharris)
The Parrots - You Work All Day And Then You Die (User: jbwharris)
Black Rebel Motorcycle Club - Mercy (User: jbwharris)
Jamiroquai - Cloud 9 (User: jbwharris)
Belle and Sebastian - If She Wants Me (User: jbwharris)
Muppet Rockers & R.E.M. - Shiny Happy People (User: jbwharris)
James Blunt - Fall at Your Feet (User: jbwharris)
The Sheepdogs - Keep on Loving You (User: jbwharris)
Télépopmusik - Breathe (feat. Angela McCluskey) (User: jbwharris)
Slash - World On Fire (Feat. Myles Kennedy & The Conspirators) (User: jbwharris)
VHS or Beta - Love In My Pocket (User: jbwharris)
Lou Barlow - Too Much Freedom (User: jbwharris)
Feist - One Evening (User: jbwharris)
Spoon - You Got Yr. Cherry Bomb (User: jbwharris)
The White Stripes - The Hardest Button to Button (User: jbwharris)
Lindi Ortega - To Love Somebody (User: jbwharris)
Ivan & Alyosha - Everybody Breaks (User: jbwharris)
Jean Knight - What One Man Won't Do Another Will (User: jbwharris)
Lana Del Rey - Blue Jeans (User: jbwharris)
The White Stripes - Fell in Love With a Girl (User: jbwharris)
Kirsty MacColl - A New England (User: jbwharris)
U2 - I Will Follow (User: jbwharris)
Sandbox - Collide (User: jbwharris)
Inspiral Carpets - This Is How It Feels (User: jbwharris)
Talking Heads - Swamp (User: jbwharris)
The Strumbellas - Spirits (User: jbwharris)
Eels - Novocaine for the Soul (User: jbwharris)
Wall of Voodoo - Mexican Radio (User: jbwharris)
Pearl Jam - Just Breathe (User: jbwharris)
Antonioni - Strange 2 Them (User: jbwharris)
Beastie Boys - Make Some Noise (User: jbwharris)
Aimee Mann - Wise Up (User: jbwharris)
Apollo 440 - Stop the Rock (User: jbwharris)
Cage the Elephant - Mess Around (User: jbwharris)
Head Automatica - Beating Heart Baby (Chris Lord-Alge Mix) (User: jbwharris)
IDLES - Mr. Motivator (User: jbwharris)
Lizzo & Cardi B - Rumors (User: jbwharris)
Kate Bush - Running Up That Hill (A Deal With God) [Remix] (User: jbwharris)
Oasis - Wonderwall (User: jbwharris)
J Roddy Walston and The Business - Sweat Shock (User: jbwharris)
Enya - Orinoco Flow (User: jbwharris)
Fatboy Slim - Going Out of My Head (User: jbwharris)
Parliament - Mothership Connection (Star Child) (User: jbwharris)
Guns N' Roses - Civil War (User: jbwharris)
My Chemical Romance - Welcome to the Black Parade (User: jbwharris)
Mas Aya - Momento Presente (User: jbwharris)
Incubus - Wish You Were Here (User: jbwharris)
JJ Wilde - Off The Rails (User: jbwharris)
Glass Animals - Heat Waves (User: jbwharris)
Spoon - Do I Have To Talk You Into It (User: jbwharris)
Black Pistol Fire - Look Alive (User: jbwharris)
Sigala - Lasting Lover (User: jbwharris)
Puddle of Mudd - She Hates Me (User: jbwharris)
The Tragically Hip - Three Pistols (User: jbwharris)
Arcade Fire - Neighbourhood #3 (User: jbwharris)
Vance Joy - Missing Piece (User: jbwharris)
AWOLNATION - The Best (User: jbwharris)
Radiohead - I Promise (User: jbwharris)
Metric - Too Bad, So Sad (User: jbwharris)
Sloan - The Good In Everyone (User: jbwharris)
Big Sugar - If I Had My Way (User: jbwharris)
Bigod 20 - The Bog (User: jbwharris)
Old Man Luedecke - I Quit My Job (User: jbwharris)
Richard Cheese - nookie/break stuff/limp bizkit (User: jbwharris)
Jamie Lidell - The City (Four Tet Mix) (User: jbwharris)
BENEE - Back To Black (User: jbwharris)
Bon Iver - Faith (User: jbwharris)
Brand New - The Quiet Things That No One Ever Knows (User: jbwharris)
Lucky Boys Confusion - Fred Astaire (acoustic) (User: jbwharris)
First Aid Kit - My Silver Lining (User: jbwharris)
Baio - Sister of Pearl (User: jbwharris)
Alanis Morissette - Ironic (2015 Remaster) (User: jbwharris)
Sloan - I Can Feel It (User: jbwharris)
The World of Birds - First Love (User: jbwharris)
Mystery Machine - Pound for Pound (User: jbwharris)
The Books - Take Time (User: jbwharris)
Creation - Making Time (User: jbwharris)
Oasis - Oasis - Helter Skelter (User: jbwharris)
Rileyy Lanez - I'm Leaving (User: jbwharris)
Will Butler - Promised (User: jbwharris)
DJ Shadow - Six Days (feat. Mos Def) [Remix] (User: jbwharris)
Arkells - Leather Jacket (Acoustic) (User: jbwharris)
Nick Ferrington - Losing Work (Missy Elliott vs. Fisher vs. Enur) (User: jbwharris)
The Stone Roses - Love Spreads (User: jbwharris)
Bloc Party - She's Hearing Voices (User: jbwharris)
SAFETALK - Universal (User: jbwharris)
Bo Burnham - Shit (User: jbwharris)
The Black Keys - Modern Times (User: jbwharris)
The Kooks - She Moves in Her Own Way (User: jbwharris)
The Rolling Stones - She's A Rainbow (User: jbwharris)
Elise LeGrow - Who Do You Love (User: jbwharris)
Beck and Bat For Lashes - Let's Get Lost (User: jbwharris)
The Cure - Boys Don't Cry (User: jbwharris)
Kevin Ayers - Town Feeling (User: jbwharris)
Deradoorian - Violet Minded (User: jbwharris)
Valerie June - You And I (User: jbwharris)
The Record Company - How High (User: jbwharris)
Ted Leo and the Pharmacists - Walking to Do (User: jbwharris)
Inara George - Sex in Cars: Road Angel Project (feat. Dave Grohl) (User: jbwharris)
Jason Mraz - Love Someone (User: jbwharris)
Lala Lala - DIVER (User: jbwharris)
Leon Bridges - Don't Worry (feat. Ink) (User: jbwharris)
Jack Peñate - Second, Minute or Hour (User: jbwharris)
Cyndi Lauper - She Bop (User: jbwharris)
Lorde - Solar Power (User: jbwharris)
El Michels Affair meets Liam Bailey - Walk With Me (feat. El Michels Affair & Liam Bailey) (User: jbwharris)
Beth Ditto - Oo La La (User: jbwharris)
Grails - A Mansion Has Many Rooms (User: jbwharris)
Courtney Barnett - History Eraser (User: jbwharris)
Parquet Courts - Walking At A Downtown Pace (User: jbwharris)
Jade Bird - Lottery (User: jbwharris)
Manchester Orchestra - Keel Timing (User: jbwharris)
TV on the Radio - Wolf Like Me (User: jbwharris)
Christine and the Queens - Tilted (User: jbwharris)
Tasha Angela - Sunlight (User: jbwharris)
Tycho & Benjamin Gibbard - Only Love (User: jbwharris)
The Chemical Brothers - Wide Open (User: jbwharris)
The Rolling Stones - Wild Horses (User: jbwharris)
Jaclyn Kenyon - When We Love (User: jbwharris)
George Clinton - Atomic Dog (User: jbwharris)
Mayday Parade - Kids Of Summer (User: jbwharris)
T. Rex - The Slider (User: jbwharris)
Kero Kero Bonito - The Princess and the Clock (User: jbwharris)
Elvis Costello & The Attractions - Clubland (User: jbwharris)
Big Grams - Lights On (User: jbwharris)
Tommy Dorsey - Opus No. 1 (User: jbwharris)
The La's - There She Goes (User: jbwharris)
H.E.R. - Hold On (User: jbwharris)
Garbage - Special (User: jbwharris)
Beck - Saw Lightning (User: jbwharris)
Iron & Wine - Sunset Soon Forgotten (User: jbwharris)
The Blue Stones - Let It Ride (User: jbwharris)
Bon Iver - Towers (User: jbwharris)
Jain - Makeba (User: jbwharris)
Jenn Grant - Sorry Doesn't Know (User: jbwharris)
Faye Webster - In a Good Way (User: jbwharris)
Depeche Mode - Just Can't Get Enough (User: jbwharris)
Lou Reed - Vicious (User: jbwharris)
Gully Boys - Russian Doll (User: jbwharris)
Nilüfer Yanya - Day 7.5093 (User: jbwharris)
Dan Mangan - Road Regrets (User: jbwharris)
Iron & Wine - Naked as We Came (User: jbwharris)
Kate Bush - The Big Sky (User: jbwharris)
Phantogram - When I'm Small (User: jbwharris)
Melanie Fiona - Gone and Never Coming Back (User: jbwharris)
Flesh For Lulu - Time and Space (User: jbwharris)
R.E.M. - Texarkana (User: jbwharris)
The Housemartins - The People Who Grinned Themselves To Death (User: jbwharris)
The Doors - When the Music's Over (User: jbwharris)
Kellylee Evans - KNOW HIS WORTH (User: jbwharris)
Sara Bareilles - Armor (User: jbwharris)
Michael Franti & Spearhead - Hello Bonjour (User: jbwharris)
Faye Webster - A Dream with a Baseball Player (User: jbwharris)
Robert Palmer - Looking For Clues (User: jbwharris)
Lord Huron - Mine Forever (User: jbwharris)
Peter Gabriel - Heroes (User: jbwharris)
Deadeye Dick - New Age Girl (2021 Edition) (User: jbwharris)
Linn Koch-Emmery - No Place for You (User: jbwharris)
Sneaker Pimps - Low Place Like Home (User: jbwharris)
Cautious Clay & Saba - Strange Love (User: jbwharris)
Janelle Monáe - Stronger (from the Netflix Series "We The People") (User: jbwharris)
The Gits - Another Shot of Whiskey (User: jbwharris)
Erasure - Chains of Love (User: jbwharris)
Iceage - Gold City (User: jbwharris)
Brett Dennen - Wild Child (User: jbwharris)
Terry Callier - You're Goin' Miss Your Candyman (User: jbwharris)
Machinedrum - Only One (feat. Angelica Bess) (User: jbwharris)
Jess Leung - Bloom (User: jbwharris)
Elton John - Saturday Night's Alright For Fighting (User: jbwharris)
PUP - See You At Your Funeral (User: jbwharris)
Irma Thomas - Time Is On My Side (User: jbwharris)
The Godfathers - Birth, School, Work, Death (User: jbwharris)
Underworld - I Exhale (User: jbwharris)
Groove Armada - At the River (User: jbwharris)
Blue Gas - Shadows from nowhere (User: jbwharris)
Music for Aardvarks and Other Mammals - Beach Song (User: jbwharris)
Rogue Wave - In A Big Country (User: jbwharris)
Pet Shop Boys - West End Girls (2001 Remaster) (User: jbwharris)
Onyx Collective - Tango (User: jbwharris)
The Shamen - Move Any Mountain (User: jbwharris)
Mirah - Words Cannot Describe (User: jbwharris)
Pete Yorn - Come Back Home (User: jbwharris)
Lindsay Munroe - I Am Kind (feat. Raffi) (User: jbwharris)
Hollerado - Pick Me Up (User: jbwharris)
Pavement - We Dance (User: jbwharris)
Anderson .Paak - Lockdown (User: jbwharris)
Bad Brains - F.V.K. (Fearless Vampire Killers) (User: jbwharris)
Doves - Ship Of Fools (User: jbwharris)
Left at London - THIS IS A PROTEST FOR YOUR HEART!!! (User: jbwharris)
Margo Price - Stone Me (User: jbwharris)
Malaika Khadijaa - Tears (User: jbwharris)
Fiction Plane - Two Sisters (User: jbwharris)
U2 - Sweetest Thing (B-Side) (User: jbwharris)
INXS - By My Side (User: jbwharris)
Jelani Aryeh - From These Heights (User: jbwharris)
Sylvester - You Make Me Feel (Mighty Real) (User: jbwharris)
The Breeders - Safari (User: jbwharris)
The Rolling Stones - You Can't Always Get What You Want (User: jbwharris)
Your Smith - The Spot (User: jbwharris)
Sarah Tomlinson - In My Hand (User: jbwharris)
Gerard McMann - Cry Little Sister (Theme From "The Lost Boys") (User: jbwharris)
A Flock of Seagulls - I Ran (User: jbwharris)
The Monkees - Last Train to Clarksville (User: jbwharris)
Brandi Carlile - The Things I Regret (User: jbwharris)
Midlake - Core Of Nature (User: jbwharris)
Will Butler - Surrender (User: jbwharris)
Jason Isbell and The 400 Unit - Sad But True (User: jbwharris)
Clem Snide - Me No (User: jbwharris)
Soul Coughing - Circles (User: jbwharris)
Strand of Oaks - Galacticana (User: jbwharris)
Chicano Batman - Dark Star (User: jbwharris)
Hum - Step Into You (User: jbwharris)
Angel Olsen - Shut Up Kiss Me (User: jbwharris)
The Album Leaf - Storyboard (JMJL Rework) (User: jbwharris)
Roxy Music - Same Old Scene (User: jbwharris)
Camille Yarbrough - Take Yo' Praise (User: jbwharris)
Red Grammer - Hello World! (User: jbwharris)
The Sadies - Tell Her What I Said (User: jbwharris)
Japanese Breakfast - Paprika (User: jbwharris)
The Marvelettes - Please Mr. Postman (User: jbwharris)
Howie Beck - I Need Light (User: jbwharris)
Justice - D.A.N.C.E. (WWW) (User: jbwharris)
Conor Gains - Light Shine In (User: jbwharris)
St Germain - Sure Thing (User: jbwharris)
Pinar Toprak - Captain Marvel (User: jbwharris)
True Loves - Objects in Mirror (User: jbwharris)
King Gizzard & The Lizard Wizard - Blue Morpho (User: jbwharris)
Scarce - All Sideways (User: jbwharris)
Crumb - M.R. (User: jbwharris)
Durand Jones & The Indications - Witchoo (feat. Aaron Frazer) (User: jbwharris)
LL Cool J - Mama Said Knock You Out (User: jbwharris)
Patti Page - (How Much Is) That Doggie In The Window (User: jbwharris)
Dean Lewis - Waves (User: jbwharris)
Thin Lear - Maniacs (User: jbwharris)
Richard Reed Parry & Adam Kinner - I Was Calling (User: jbwharris)
Eve Owen - Mother (User: jbwharris)
Nation of Language - Wounds of Love (User: jbwharris)
Eels - Novocaine for the Soul (User: jbwharris)
Jennie Laws - Sabotage (feat. Scipio) (User: jbwharris)
Peaking Lights - Walking with You (User: jbwharris)
Aidan Knight - Sixteen Stares (User: jbwharris)
Inner Circle - Sweat (A La La La La Long) (User: jbwharris)
Liza Anne - I Wanna Be There (User: jbwharris)
Rae Spoon - Ocean Blue (User: jbwharris)
The Age Of Electric - Nothing Happens (User: jbwharris)
Tom Petty and The Heartbreakers - So You Want To Be A Rock & Roll Star (User: jbwharris)
Thor Rixon - Why Don't You Love Me (User: jbwharris)
Ricky Nelson - Waitin' in School (User: jbwharris)
Pure - What It Is (User: jbwharris)
Hey Rosetta! - Harriet (User: jbwharris)
Good Lovelies - I See Gold (User: jbwharris)
Twan Ray - We Could Start a Thing (User: jbwharris)
Lou Reed - Walk on the Wild Side (User: jbwharris)
New Order - Leave Me Alone (User: jbwharris)
Sam Roberts - Detroit '67 (User: jbwharris)
Matthew Good - Sicily (User: jbwharris)
Mykki Blanco - Love Me (feat. Jamila Woods & Jay Cue) (User: jbwharris)
The Goo Goo Dolls - Black Balloon (User: jbwharris)
Sloan - The Lines You Amend (User: jbwharris)
Orchestral Manoeuvres in the Dark - Locomotion (User: jbwharris)
The Dears - You and I Are a Gang of Losers (User: jbwharris)
Sneaker Pimps - 6 Underground (User: jbwharris)
The Proclaimers - I'm Gonna Be (User: jbwharris)
Handsome Furs - All we Want, Baby, is Everything (User: jbwharris)
Catherine Wheel - Black Metallic (User: jbwharris)
Messenjah - Arrested (User: jbwharris)
Barenaked Ladies - Blame It On Me (User: jbwharris)
10,000 Maniacs - What's the Matter Here? (User: jbwharris)
Scott Helman - Old Friends (User: jbwharris)
Olivia Rodrigo - deja vu (User: jbwharris)
Counting Crows - Mr. Jones (User: jbwharris)
Taylor Swift - ...Ready for It? (User: jbwharris)
Stone Temple Pilots - Trippin' On A Hole In A Paper Heart (2021 Remaster) (User: jbwharris)
Bleachers - 91 (User: jbwharris)
Phoebe Bridgers - Garden Song (User: jbwharris)
Pulp - Sorted for E's & Wizz (User: jbwharris)
Doja Cat & The Weeknd - You Right (User: jbwharris)
Billy Idol - Dancing with Myself (User: jbwharris)
The National - Mistaken for Strangers (User: jbwharris)
The Strokes - The Adults Are Talking (User: jbwharris)
America - A Horse With No Name (User: jbwharris)
Jade Bird - Now Is The Time (User: jbwharris)
Jason Derulo - Lifestyle (feat. Adam Levine) (User: jbwharris)
OneRepublic - Run (User: jbwharris)
Echo & the Bunnymen - The Cutter (alternate version) (User: jbwharris)
Marshmello & Jonas Brothers - Leave Before You Love Me (User: jbwharris)
Vance Joy - Riptide (User: jbwharris)
Arcade Fire - Neighborhood #2 (Laika) (User: jbwharris)
Ed Sheeran - Thinking Out Loud (User: jbwharris)
Shawn Mendes - Treat You Better (User: jbwharris)
Elijah Woods - lights (User: jbwharris)
Radiohead - High and Dry (User: jbwharris)
Billie Eilish - Oxytocin (User: jbwharris)
Jean Deaux - Energy (User: jbwharris)
The New Cities - Dead End Countdown (User: jbwharris)
The Killers - The Killers On Pressure Machine (User: jbwharris)
The Killers - The Getting By (User: jbwharris)
The Killers - Pressure Machine (User: jbwharris)
The Killers - Desperate Things (User: jbwharris)
The Killers - In Another Life (User: jbwharris)
The Killers - In the Car Outside (User: jbwharris)
The Killers - Runaway Horses (feat. Phoebe Bridgers) (User: jbwharris)
The Killers - Sleepwalker (User: jbwharris)
The Killers - Cody (User: jbwharris)
The Killers - Terrible Thing (User: jbwharris)
The Killers - Quiet Town (User: jbwharris)
Modest Mouse - The Sun Hasn't Left (User: jbwharris)
Logan Prescott - Online (User: jbwharris)
Chet Faker - Oh Me Oh My (User: jbwharris)
Rufus Du Sol - Next to Me (User: jbwharris)
Liam Mour - If We Only Had (User: jbwharris)
Patrick Watson - A Mermaid in Lisbon (Ft. Teresa Salgueiro) (User: jbwharris)
The Haunted Youth - Coming Home (User: jbwharris)
URL - honey (Phil from Havêa Remix) (User: jbwharris)
Tomos - Together (User: jbwharris)
TOPS - Party Again (User: jbwharris)
Remi Wolf - Liquor Store (User: jbwharris)
Bee Gees - More Than a Woman (SG's Paradise Remix) (User: jbwharris)
Barry Can't Swim - Jazz Club After Hours (User: jbwharris)
Klaz - Give In (User: jbwharris)
Tycho x Benjamin Gibbard - Only Love (User: jbwharris)
Pizzagirl - Sugar Ray (User: jbwharris)
CONDITIONER - Terms of Surrender (User: jbwharris)
QUICKLY, QUICKLY - Shee (User: jbwharris)
Sunrom - You Don't Know (User: jbwharris)
Patagon - LOST INSIDE (User: jbwharris)
warner case & Jean Tonique - I Miss New York (User: jbwharris)
Jungle - Romeo (ft. Bas) (User: jbwharris)
Chet Faker - Feel Good (User: jbwharris)
Ada vs. Fannypack & Missy Elliott - Amoeba Lost Control (User: jbwharris)
Lenka - The Show (User: jbwharris)
etiéne soirée - RunUp (User: jbwharris)
Hey Ocean! - Make a New Dance Up (User: jbwharris)
Loney, dear - I Will Call You Lover Again (User: jbwharris)
Queens of the Stone Age - Feet Don't Fail Me (User: jbwharris)
The Stooges - Ann (Full version) (User: jbwharris)
Voxtrot - Soft & Warm (User: jbwharris)
TV on the Radio - Wolf Like Me (User: jbwharris)
Coltrane Motion - I'm On Fire [Bruce Springsteen Cover] (User: jbwharris)
Dizzy - Primrose Hill (User: jbwharris)
Hole - Miss World (User: jbwharris)
Eliza Shaddad - Fine and Peachy (User: jbwharris)
salami rose joe louis - Nostalgic Montage (User: jbwharris)
Lunar Vacation - Shrug (User: jbwharris)
Billie Eilish - Your Power (GONE Remix) (User: jbwharris)
Spaceface - Happens All the Time (User: jbwharris)
Jordan Rakei - Family (User: jbwharris)
slenderbodies - Favorable Colors (User: jbwharris)
Massane - Wild (Ft. Colouring) (User: jbwharris)
Rohne - Circles (User: jbwharris)
Mokita x Slenderbodies - Speeding Up (User: jbwharris)
Most Akin - All The While (User: jbwharris)
Fred Paa Jord - Bommer På Alt (User: jbwharris)
Franc Moody - Let It Kick In (User: jbwharris)
Polo & Pan - Magic (User: jbwharris)
Manchester Orchestra - Bed Head (Local Natives Remix) (User: jbwharris)
Unknown Mortal Orchestra - Weekend Run (User: jbwharris)
Mild High Club - Me, Myself and Dollar Hell (User: jbwharris)
Andrew Applepie - Fool (User: jbwharris)
Jose Gonzalez - Head On (User: jbwharris)
Justin Bieber - Peaches (Kid Travis Cover) (User: jbwharris)
Aquilo - Out in LA (User: jbwharris)
Ted Jasper - Do Something (Ft. Kay Young & Shaquille-Aaron Keith) (User: jbwharris)
NASAYA & MARO - TEMPO (User: jbwharris)
Charlotte Day Wilson - I Can Only Whisper (ft. BADBADNOTGOOD) (User: jbwharris)
Sweatson Klank - Universal Soul Vibrations (User: jbwharris)
The Sundays - Here's Where the Story Ends (User: jbwharris)
St. Vincent w/ Beck - Never Tear Us Apart (User: jbwharris)
INXS - By My Side (User: jbwharris)
The Godfathers - Birth, School, Work, Death (User: jbwharris)
The Parrots - You Work All Day And Then You Die (User: jbwharris)
Parquet Courts - Walking At A Downtown Pace (User: jbwharris)
Imperial Teen - Baby (User: jbwharris)
The Wrens - Happy (User: jbwharris)
Beck and Bat For Lashes - Let's Get Lost (User: jbwharris)
Tycho & Benjamin Gibbard - Only Love (User: jbwharris)
Future Islands - Peach (User: jbwharris)
Adorable - Homeboy (User: jbwharris)
Sneaker Pimps - Low Place Like Home (User: jbwharris)
Groove Armada - At the River (User: jbwharris)
Godford - Better Place (User: jbwharris)
Nation of Language - Wounds of Love (User: jbwharris)
Matt Bellamy - Unintended (Acoustic Version) (User: jbwharris)
Rogue Wave - In A Big Country (User: jbwharris)
Neil Cicierega - Transmission (User: jbwharris)
Tenacious D - Jb Jr Rap (User: jbwharris)
Depeche Mode - Where's the Revolution (User: jbwharris)
Pavement - We Dance (User: jbwharris)
Sugar - Helpless (User: jbwharris)
Black Rebel Motorcycle Club - Mercy (User: jbwharris)
Fleet Foxes - Your Protector (User: jbwharris)
Aimee Mann - Wise Up (User: jbwharris)
Billy Bragg - I Will Be Your Shield (User: jbwharris)
Massive Attack V Mad Professor - Risingson (Setting Sun Dub Two) (User: jbwharris)
Jerry Jones - Compared to What (User: jbwharris)
Jordan Rakei - Send My Love (User: jbwharris)
Faye Webster - A Dream with a Baseball Player (User: jbwharris)
La Luz - In the Country (User: jbwharris)
El Michels Affair - Walk With Me (User: jbwharris)
Cassowary - She Funked Me (User: jbwharris)
Dirty Projectors - Lose Your Love (User: jbwharris)
Celeste - Stop This Flame (User: jbwharris)
Fatboy Slim - Praise You (User: jbwharris)
Camille Yarbrough - Take Yo' Praise (User: jbwharris)
Janelle Monáe - Stronger (User: jbwharris)
Onyx Collective - Tango (User: jbwharris)
Lord Tariq & Peter Gunz (feat. Big Punisher & Fat Joe) - Still Not a Player (User: jbwharris)
Machinedrum feat. Angelica Bess - Only One (User: jbwharris)
박혜진 - I Need You (User: jbwharris)
Depeche Mode - Route 66 (User: jbwharris)
Elvis Costello - Less Than Zero (User: jbwharris)
The Skydiggers - A Penny More (User: jbwharris)
Orchestral Manoeuvres in the Dark - Secret (User: jbwharris)
Bahamas - Lost In The Light (User: jbwharris)
Oasis - Champagne Supernova (User: jbwharris)
Duran Duran - The Reflex (User: jbwharris)
Tokyo Police Club - Toy Guns (User: jbwharris)
Midnight Oil - The Dead Heart (User: jbwharris)
Sarah McLachlan - Drawn to the Rhythm (User: jbwharris)
The Tragically Hip - At The Hundredth Meridian (User: jbwharris)
R.E.M. - Superman (User: jbwharris)
Blue Rodeo - Til I Am Myself Again (User: jbwharris)
Earth, Wind & Fire - Boogie Wonderland (User: jbwharris)
Garbage - Wolves (User: jbwharris)
Rachel Lime - Voyager 3 (User: jbwharris)
Jenn Grant - Sweet Grass (User: jbwharris)
R.E.M. - Fall on Me (User: jbwharris)
Drama - Nine One One (User: jbwharris)
Unknown Mortal Orchestra - Weekend Run (User: jbwharris)
Shamir - Other Side (User: jbwharris)
BeMyFiasco - SBYFU (User: jbwharris)
Nelly Furtado - Say It Right (User: jbwharris)
Widowspeak - Even True Love (User: jbwharris)
Frith - Pinocchio (User: jbwharris)
Johnny Kidd & The Pirates - Please Don't Touch (User: jbwharris)
Hey Rosetta! - Yer Spring (User: jbwharris)
Mini Trees - Steady Me (User: jbwharris)
my bloody valentine - Sometimes (User: jbwharris)
Colby Dean - Perfect Crime (User: jbwharris)
DJ Koze - Pick Up (User: jbwharris)
Brett Dennen - See The World (User: jbwharris)
Jye - You on My Mind (User: jbwharris)
Sarah Harmer - St. Peter's Bay (User: jbwharris)
Janelle Monáe - Make Me Feel (User: jbwharris)
swsh - Tell Me (User: jbwharris)
Liz Phair - Never Said (User: jbwharris)
Chikaya - Stargazing (User: jbwharris)
Beth Ditto - I'm (User: jbwharris)
The Strokes - Juicebox (User: jbwharris)
products - The Horse (User: jbwharris)
Lord Huron - The Night We Met (User: jbwharris)
The Junction - Level With Me (User: jbwharris)
Iron & Wine - Swans and the Swimming (User: jbwharris)
Manic Street Preachers - Motorcycle Emptiness (User: jbwharris)
Chairlift - Sidewalk Safari (Martyn's Crystal World remix) (User: jbwharris)
Strange Relations - Good Time, Baby (User: jbwharris)
Tracy Chapman - Talkin' Bout a Revolution (User: jbwharris)
Interpol - Mammoth (User: jbwharris)
Amos Lee - Shout Out Loud (User: jbwharris)
Two Hours Traffic - Stuck For The Summer (User: jbwharris)
Sufjan Stevens - Vito’s Ordination Song (User: jbwharris)
Matt Maeson - Cringe (User: jbwharris)
Sinéad O'Connor - I Am Stretched On Your Grave (User: jbwharris)
Blur - Villa Rosie (User: jbwharris)
The Subways - Rock & Roll Queen (User: jbwharris)
U2 - Trip Through Your Wires (User: jbwharris)
Royal Wood - I'm So glad (User: jbwharris)
Red Hot Chili Peppers - Dark Necessities (User: jbwharris)
Poor Nameless Boy - The Tourist (User: jbwharris)
Shuggie Otis - Strawberry Letter 23 (User: jbwharris)
Rachel Mazer - Sparrows Wings (User: jbwharris)
Ben Rudnick and Friends - Supercalifragilisticexpialidocious (User: jbwharris)
Glen Hansard - Cry Me a River (User: jbwharris)
Aretha Franklin - Spanish Harlem (User: jbwharris)
Foo Fighters - The Sky Is A Neighborhood (User: jbwharris)
Anderson East - Madelyn (User: jbwharris)
Lou Reed - I Love You, Suzanne (User: jbwharris)
The Cure - Killing an Arab (User: jbwharris)
Slowcoaster - Fuck Last Night (User: jbwharris)
Starflyer 59 - When No One Calls (User: jbwharris)
Mia Sanchez - Can't Have It (User: jbwharris)
Noun - In The Shade (User: jbwharris)
Melanie - Look What They've Done To My Song, Ma (User: jbwharris)
Jim Cuddy - Pull Me Through (User: jbwharris)
The Amboy Dukes - Journey to the Center of the Mind (User: jbwharris)
The Breeders - Safari (User: jbwharris)
The Maccabees - Toothpaste Kisses (User: jbwharris)
Pearl Jam - Dissident (User: jbwharris)
Curtis Harding - Need Your Love (User: jbwharris)
A Certain Ratio - Emperor Machine (ACR vs. The Emperor Machine) (User: jbwharris)
Primal Scream - Swastika Eyes (User: jbwharris)
Eels - On the Ropes (User: jbwharris)
Arctic Monkeys - The View from the Afternoon (User: jbwharris)
nothing,nowhere. - fake friend (User: jbwharris)
Cloves - Everybody's Son (User: jbwharris)
James Brown - I Got The Feelin' (User: jbwharris)
FIDLAR - West Coast (User: jbwharris)
Solange - Stay Flo (User: jbwharris)
Maroon 5 - Moves Like Jagger (feat. Christina Aguilera) (User: jbwharris)
Shopping - Initiative (User: jbwharris)
Madeon - Finale (feat. Nicholas Petricca) (User: jbwharris)
Hey Ocean! - Islands (User: jbwharris)
Reverend and the Makers - Silence Is Talking (User: jbwharris)
The Smashing Pumpkins - 1979 (User: jbwharris)
The Night Game - The Outfield (Roosevelt Remix) (User: jbwharris)
Joy Division - Love Will Tear Us Apart (User: jbwharris)
The Cure - Plainsong (User: jbwharris)
The Lottery Winners - Times Are Changing (User: jbwharris)
The Clash - Rudie Can't Fail (User: jbwharris)
Greta Van Fleet - When The Curtain Falls (User: jbwharris)
Heartless Bastards - Revolution (User: jbwharris)
Greta Van Fleet - Watching Over (User: jbwharris)
Meg Myers - Running Up That Hill (User: jbwharris)
Spoon - Shake It Off (User: jbwharris)
Prince - Purple Rain (Piano & a Microphone 1983 Version) (User: jbwharris)
boy pablo - I <3 U (User: jbwharris)
Sleater-Kinney - Worry With You (User: jbwharris)
Fugazi - Repeater (User: jbwharris)
Pixies - Bone Machine (User: jbwharris)
Eric's Trip - Stove (User: jbwharris)
Starcrawler - Goodtime Girl (User: jbwharris)
Nick Hakim - Qadir (User: jbwharris)
Krister Axel - Weightless Heart (feat. Courtney Hartman, Shane Leonard & J.E. Sunde) (User: jbwharris)
The Paper Kites - Paint (User: jbwharris)
The War on Drugs - Pain (User: jbwharris)
Joel Plaskett - Rollin', Rollin', Rollin' (User: jbwharris)
Dan Deacon - Sat By A Tree (User: jbwharris)
rum.gold - Where There's Smoke (User: jbwharris)
Chuck Prophet - Summertime Thing (User: jbwharris)
The Constantines - Working Full-Time (User: jbwharris)
Whitney - Used to Be Lonely (User: jbwharris)
The Rocket Summer - Tell Me Something Good (User: jbwharris)
nevi - Invoice (User: jbwharris)
M. Ward - Shangri-La (User: jbwharris)
Korn - Take Me (User: jbwharris)
The Streets - Empty Cans (User: jbwharris)
John Lennon & Yoko Ono - Instant Karma! (We All Shine On) [Ultimate Mix] (User: jbwharris)
Grumpster - Teeth (User: jbwharris)
Mazzy Star - Flowers In December (User: jbwharris)
L’Rain - Suck Teeth (User: jbwharris)
The Police - When The World Is Running Down, You Make The Best Of What's Still Around (User: jbwharris)
LCD Soundsystem - North American Scum (User: jbwharris)
Belle and Sebastian - Piazza, New York Catcher (User: jbwharris)
INXS - Don't Change (User: jbwharris)
New Kids on the Block - Step by Step (User: jbwharris)
Incubus - Nimble Bastard (User: jbwharris)
Tyra Jutai - Still Good (User: jbwharris)
Tyra Jutai - Still Good (User: jbwharris)
The Wallflowers - Roots And Wings (User: jbwharris)
Copyright - Rock Machine (User: jbwharris)
LU KALA - DCMO (Don't Count Me Out) (User: jbwharris)
Knxwledge - kometostai.aintreallynootherwaytoputitro (User: jbwharris)
Nikka Costa - Nylons in a Rip (User: jbwharris)
Jungle - Talk About It (User: jbwharris)
Paul McCartney & Wings - Let Me Roll It (User: jbwharris)
Linkin Park - Until It's Gone (User: jbwharris)
Talking Heads - Girlfriend Is Better (User: jbwharris)
Supergrass - Alright (User: jbwharris)
Bob Marley & The Wailers - Could You Be Loved (User: jbwharris)
Syd - Fast Car (User: jbwharris)
Young Mc - Know How (User: jbwharris)
The BPA - He's Frank (Slight Return) (User: jbwharris)
The Marías - Hush (User: jbwharris)
Oasis - Live Forever (User: jbwharris)
Same as me - Stand Up (User: jbwharris)
Coheed and Cambria - The Suffering (User: jbwharris)
Bob Dylan - Not Dark Yet (User: jbwharris)
Cloud Cult - Journey of the Featherless (User: jbwharris)
Bad Bad Hats - Detroit Basketball (User: jbwharris)
Blondie - Long Time (User: jbwharris)
The Who - Pictures of Lily (User: jbwharris)
En Vogue - Free Your Mind (User: jbwharris)
Anjulie - Love Songs (User: jbwharris)
Cat Power - Moonshiner (User: jbwharris)
G.O.D Limited - Original Don (Mixed) (User: jbwharris)
The B-52's - Debbie (User: jbwharris)
Primal Scream - Loaded (User: jbwharris)
Primal Scream - Movin' On Up (User: jbwharris)
Manic Street Preachers - If You Tolerate This Your Children Will Be Next (User: jbwharris)
The B-52's - Debbie (User: jbwharris)
Michie Mee - Bahdgyal Bubble (User: jbwharris)
Lady Gaga - Look What I Found (User: jbwharris)
Faces - Ooh La La (User: jbwharris)
Jurassic 5 - Quality Control (User: jbwharris)
Olivia O'Brien - Josslyn (User: jbwharris)
Des'ree - You Gotta Be (User: jbwharris)
David Usher - If You Tolerate This Your Children Will Be Next (User: jbwharris)
Tubeway Army - Down in the Park (User: jbwharris)
Tom Waits - Temptation (User: jbwharris)
Linda Ronstadt & James Ingram - Somewhere Out There (User: jbwharris)
The Champs - Tequila (User: jbwharris)
The Offspring - Original Prankster (Feat. Redman) (User: jbwharris)
Alejandro Fernández - Mátalas (User: jbwharris)
Songhoy Blues - Worry (User: jbwharris)
Bambara - Serafina (User: jbwharris)
Quicksilver Messenger Service - Fresh Air (2002 Remaster) (User: jbwharris)
Oh Wonder - Without You (User: jbwharris)
BODY CORP - Everything Is Talking (User: jbwharris)
José González - Visions (User: jbwharris)
Shannon and the Clams - Sleep Talk (User: jbwharris)
Sam Smith - I Feel Love (User: jbwharris)
Sleaford Mods - Second (User: jbwharris)
Margaret Glaspy - Before We Were Together (User: jbwharris)
Fiona Apple - Fast as You Can (User: jbwharris)
Death Cab for Cutie - This Charming Man (User: jbwharris)
Wilco - A Shot In The Arm (User: jbwharris)
Pearl Jam - State of Love and Trust (User: jbwharris)
The Rolling Stones - Street Fighting Man (Remastered) (User: jbwharris)
black midi - Slow (User: jbwharris)
Arcade Fire - Une année sans lumière (User: jbwharris)
Jackie - Unspun (User: jbwharris)
Space Afrika - B£E (feat. Blackhaine) (User: jbwharris)
Woods - Waiting Around for a New Me (User: jbwharris)
Nate Young - Worlds Behind (User: jbwharris)
Sloan - If It Feels Good Do It (User: jbwharris)
Leonard Cohen - Chelsea Hotel (Live Nov 17, 2008; Royal Albert Hall, London, England) (User: jbwharris)
Damon Albarn - Polaris (User: jbwharris)
Metric - Gimme Sympathy (User: jbwharris)
Nick Lowe - Ragin' Eyes (User: jbwharris)
Ghostpoet - I Grow Tired But Dare Not Fall Asleep (User: jbwharris)
Gelka - All I Need (Mixed) (User: jbwharris)
Angus & Julia Stone - Mango Tree (User: jbwharris)
David Bowie - Changes (User: jbwharris)
POLICE CAR COLLECTIVE - K (User: jbwharris)
The Chemical Brothers - Let Forever Be (2003 Remaster) (User: jbwharris)
Bob Dylan - Slow Train (User: jbwharris)
Clariloops - Evaporate (User: jbwharris)
The Nixons - Sister (User: jbwharris)
Joy Oladokun & Maren Morris - Bigger Man (User: jbwharris)
Lea Porcelain - I Am Ok (User: jbwharris)
The Temptations - Psychedelic Shack (User: jbwharris)
CHVRCHES - Good Girls (KC Lights 6am Remix) (User: jbwharris)
Foo Fighters - Making a Fire (User: jbwharris)
Nirvana - The Man Who Sold the World (User: jbwharris)
Marshmello - Silence (feat. Khalid) (User: jbwharris)
Bay City Rollers - Saturday Night (User: jbwharris)
Circa Waves - Sad Happy (User: jbwharris)
Bonnie Raitt - Love Me Like A Man (User: jbwharris)
Camera Obscura - Lloyd, I'm Ready To Be Heartbroken (User: jbwharris)
Londa Larmond - You Are God Alone (feat. Peter Moncrieffe) (User: jbwharris)
Iron & Wine and Calexico - History of Lovers (User: jbwharris)
Fiction Plane - Two Sisters (User: jbwharris)
The Baseballs - Umbrella (User: jbwharris)
Book of Love - Boy (User: jbwharris)
Low - Days Like These (User: jbwharris)
Iron & Wine - Flightless Bird, American Mouth (User: jbwharris)
David Bowie - Modern Love (2018 Remaster) (User: jbwharris)
Siouxsie and the Banshees - Spellbound (12" Mix) (User: jbwharris)
Die Realität - Nur die Realität (User: jbwharris)
Röyksopp - So Easy (User: jbwharris)
Phil Collins - A Groovy Kind of Love (2016 Remastered) (User: jbwharris)
Rilo Kiley - Spectacular Views (User: jbwharris)
Elliott Smith - Happiness/The Gondola Man (User: jbwharris)
The Damned - Neat Neat Neat (User: jbwharris)
Jerry Lee Lewis - Whole Lotta Shakin' Goin' On (User: jbwharris)
My Morning Jacket - Thank You Too! (User: jbwharris)
Hot Chip - Hungry Child (User: jbwharris)
Melanie Fiona - Give It To Me Right (User: jbwharris)
AM & Shawn Lee - Persuasion (User: jbwharris)
Grae - Your Hands (User: jbwharris)
H.E.R. - For Anyone (User: jbwharris)
Cigarettes After Sex - K. (User: jbwharris)
Jully Black - Seven Day Fool (User: jbwharris)
Bedouin Soundclash - When the Night Feels My Song (User: jbwharris)
Squirrel Flower - To Be Forgotten (User: jbwharris)
The Wild Feathers - Overnight (User: jbwharris)
Black Label Society - Room of Nightmares (User: jbwharris)
They Might Be Giants - We're The Replacements (User: jbwharris)
Ratatat - Loud Pipes (User: jbwharris)
Mandy Moore - When Will My Life Begin (User: jbwharris)
Sonny Knight & The Lakers - Sugar Man (User: jbwharris)
Leigh Phillips - Lockdown (User: jbwharris)
Aurora - Cure For Me (User: jbwharris)
Lauryn Hill - To Zion (feat. Carlos Santana) (User: jbwharris)
Save Ferris - Goodbye (User: jbwharris)
Beach House - Lazuli (User: jbwharris)
Sylvan Esso - Rooftop Dancing (User: jbwharris)
Mandolin Orange - The Wolves (User: jbwharris)
Thundercat - Them Changes (User: jbwharris)
Chelsea Stewart - Just Wanna Love You (User: jbwharris)
Orchestra of Jesus Christ Superstar Live in Concert & Original Television Cast of Jesus Christ Superstar Live in Concert - Overture (Orchestra) (User: jbwharris)
The Smithereens - Only A Memory (User: jbwharris)
Beth Orton - See through Blue (User: jbwharris)
Big Thief - Shark Smile (User: jbwharris)
Sharon, Lois & Bram - Who put the bomp (User: jbwharris)
Kellylee Evans - My Name Is (User: jbwharris)
Ace Frehley - New York Groove (User: jbwharris)
Tedeschi Trucks Band - Part of Me (User: jbwharris)
Skee-Lo - I Wish (User: jbwharris)
Caamp - Peach Fuzz (User: jbwharris)
The Wombats - Oceans (User: jbwharris)
The B-52's - Roam (User: jbwharris)
CCFX - The One To Wait (User: jbwharris)
Pink Floyd - The Great Gig in the Sky (User: jbwharris)
Nick Drake - Which Will (User: jbwharris)
Van Halen - Dancing in the Street (User: jbwharris)
Savages - Husbands (User: jbwharris)
Phoenix - Rome (User: jbwharris)
Of Monsters and Men - Yellow Light (User: jbwharris)
The Smiths - How Soon Is Now? (User: jbwharris)
Pretenders - Brass in Pocket (User: jbwharris)
Portugal. The Man - Feel It Still (User: jbwharris)
Treble Charger - Red (User: jbwharris)
Iggy Pop - Real Wild Child (User: jbwharris)
Dan Mangan - Robots (User: jbwharris)
Cake - I Will Survive (User: jbwharris)
Madness - Our House (User: jbwharris)
The White Stripes - We're Going to Be Friends (User: jbwharris)
Tegan and Sara - I Was a Fool (User: jbwharris)
R.E.M. - Radio Song (User: jbwharris)
The Grapes Of Wrath - O Lucky Man (User: jbwharris)
Alanis Morissette - Ironic (User: jbwharris)
Grace Jones - Slave to the Rhythm (User: jbwharris)
Modest Mouse - Back To The Middle (User: jbwharris)
Courtney Barnett - History Eraser (User: jbwharris)
The Shins - Turn A Square (User: jbwharris)
The Record Company - How High (User: jbwharris)
The Velvet Underground - Foggy Notion (User: jbwharris)
Gang of Youths - the angel of 8th ave. (User: jbwharris)
Joy Division - Love Will Tear Us Apart (User: jbwharris)
LOW RATS - Cryin' and Moanin' (User: jbwharris)
Lump - Animal (User: jbwharris)
Leon Bridges - Don't Worry (User: jbwharris)
The Black Keys - Fever (User: jbwharris)
Lizzo - Rumors Feat. Cardi B (User: jbwharris)
St. Vincent - Down (User: jbwharris)
X - The New World (User: jbwharris)
Michigander - Better (User: jbwharris)
Caroline Polachek - Bunny Is a Rider (User: jbwharris)
The Monkees - Last Train to Clarksville (User: jbwharris)
Iceage - Gold City (User: jbwharris)
Lake Street Dive - Know That I Know (User: jbwharris)
Bon Iver - Towers (User: jbwharris)
Clairo - Amoeba (User: jbwharris)
The Raconteurs - Now That You're Gone (User: jbwharris)
Gully Boys - Russian Doll (User: jbwharris)
The Marias - Hush (User: jbwharris)
The Sundays - Love (User: jbwharris)
Dinosaur Jr. - I Ran Away (User: jbwharris)
Amyl and the Sniffers - Security (User: jbwharris)
Hot Chip - Ready for the Floor (User: jbwharris)
Fleet Foxes - Sunblind (User: jbwharris)
Yves Tumor - Jackie (User: jbwharris)
Foo Fighters - Making a Fire (User: jbwharris)
Garbage - Special (User: jbwharris)
Björk - It's in Our Hands (User: jbwharris)
Chicano Batman - Dark Star (User: jbwharris)
Bad Bad Hats - Detroit Basketball (User: jbwharris)
Disq - Daily Routine (User: jbwharris)
Imaginary Cities - Hummingbird (User: jbwharris)
Soul Coughing - Circles (User: jbwharris)
Run the Jewels - Ooh LA LA (feat. Greg Nice & DJ Premier) (User: jbwharris)
The Posies - Solar Sister (User: jbwharris)
Yola - Stand for Myself (User: jbwharris)
Pretty Sick - Superstar (User: jbwharris)
The Marvelettes - Please Mr. Postman (User: jbwharris)
HAIM - Don't Wanna (User: jbwharris)
Matthew E. White - Genuine Hesitation (User: jbwharris)
Weezer - Island in the Sun (User: jbwharris)
Sunflower Bean - Moment in the Sun (User: jbwharris)
Strand of Oaks - Galacticana (User: jbwharris)
Lou Reed - Vicious (User: jbwharris)
Japanese Breakfast - Paprika (User: jbwharris)
Iron & Wine - Naked as We Came (User: jbwharris)
Lala Lala - DIVER (User: jbwharris)
Tamar Aphek - Crossbow (User: jbwharris)
Jade Bird - Lottery (User: jbwharris)
R.E.M. - It's the End of the World as We Know It (and I Feel Fine) (User: jbwharris)
Cautious Clay - Strange Love feat. Saba (User: jbwharris)
Jason Isbell - Sad But True (User: jbwharris)
Alice Merton - Vertigo (User: jbwharris)
Kevin Ayers - Town Feeling (User: jbwharris)
Arlo Parks - Hope (User: jbwharris)
Beyonce - Hold Up (User: jbwharris)
Rufus - Tell Me Something Good (User: jbwharris)
Enya - Orinoco Flow (User: jbwharris)
Irma Thomas - Time Is On My Side (User: jbwharris)
Wanda Jackson - Rock Your Baby (User: jbwharris)
Aretha Franklin - Chain of Fools (User: jbwharris)
Missy Elliott - The Rain (Supa Dupa Fly) (User: jbwharris)
Kate Bush - Running Up That Hill (A Deal with God) (User: jbwharris)
Waxahatchee - Can't Do Much (User: jbwharris)
Leon Bridges - Smooth Sailin' (User: jbwharris)
The War on Drugs - Living Proof (User: jbwharris)
Lorde - Solar Power (User: jbwharris)
Phoebe Bridgers - Nothing Else Matters (User: jbwharris)
Lucy Dacus - Brando (User: jbwharris)
Talking Heads - Psycho Killer (User: jbwharris)
Wet Leg - Chaise Longue (User: jbwharris)
Margo Price - Stone Me (User: jbwharris)
Merle Haggard - The Bottle Let Me Down (User: jbwharris)
Aurora - Cure For Me (User: jbwharris)
Margaret Glaspy - Before We Were Together (User: jbwharris)
Low - Days Like These (User: jbwharris)
beabadoobee - He Gets Me So High (User: jbwharris)
Kings of Leon - Sex on Fire (User: jbwharris)
Pearl Jam - Dissident (User: jbwharris)
CHVRCHES - Good Girls (User: jbwharris)
Elvis Costello & The Attractions - Clubland (User: jbwharris)
Jens Lekman - Maple Leaves (7" version) (User: jbwharris)
Lord Huron - Mine Forever (User: jbwharris)
Hozier - Nina Cried Power feat. Mavis Staples (User: jbwharris)
The The - This Is The Day (User: jbwharris)
Rhye - Open (User: jbwharris)
Brandi Carlile - The Things I Regret (User: jbwharris)
The Lemonheads - Into Your Arms (User: jbwharris)
Bedouin Soundclash - When the Night Feels My Song (User: jbwharris)
The Brothers Macklovitch - Give Love To Get Some (User: jbwharris)
Talking Heads - Girlfriend Is Better (User: jbwharris)
The Sadies - Tell Her What I Said (User: jbwharris)
Samm Henshaw - Church (User: jbwharris)
The Cure - The Love Cats (User: jbwharris)
Jamiroquai - Cloud 9 (User: jbwharris)
New Order - True Faith (User: jbwharris)
Lady Gaga - Look What I Found (User: jbwharris)
Supergrass - Alright (User: jbwharris)
Tom Waits - Temptation (User: jbwharris)
Sara Bareilles - Armor (User: jbwharris)
The La's - There She Goes (User: jbwharris)
Jenn Grant - Sorry Doesn't Know (User: jbwharris)
Jurassic 5 - Quality Control (User: jbwharris)
Bobby Bazini - Move Away (User: jbwharris)
Malaika Khadijaa - Tears (User: jbwharris)
Kellylee Evans - My Name Is (User: jbwharris)
Haviah Mighty - Wishy Washy Ft. Omega Mighty (User: jbwharris)
Jully Black - Rally 'N' (feat. Saukrates) (User: jbwharris)
Nelly Furtado - Turn Off the Light (User: jbwharris)
Michie Mee - Jamaican Funk Canadian Style (User: jbwharris)
Chelsea Stewart - Do You Love Me (User: jbwharris)
Jess Leung - Bloom (User: jbwharris)
Elise LeGrow - No Good Woman (User: jbwharris)
Kellylee Evans - KNOW HIS WORTH (User: jbwharris)
Tyra Jutai - Still Good (User: jbwharris)
Haviah Mighty - Thirteen (User: jbwharris)
Tasha Angela - Deja Vu (User: jbwharris)
Anjulie - Love Songs (User: jbwharris)
Melanie Fiona - Gone and Never Coming Back (User: jbwharris)
Amber J - The Process (User: jbwharris)
Michie Mee - Bahdgyal Bubble (User: jbwharris)
Azalyne - E-Girl (User: jbwharris)
LU KALA - Don't Count Me Out (User: jbwharris)
Jennie Laws - Heavenly (User: jbwharris)
