Juan Atkins - Transport (User: melons)
Steve Hauschildt - Ketracel (User: melons)
Belarisk - Belewe Moon (User: melons)
Huerco S. - On the Embankment (User: melons)
Biosphere - Departed Glories (User: melons)
Julianna Barwick - Nebula (User: melons)
Steven Price - Neon (User: melons)
Cassandra Jenkins - Hard Drive (User: melons)
Emma-Jean Thackray - Sun (User: melons)
Fred again.. - Baxter (These Are My Friends) (User: melons)
Bleachers - Don't Go Dark (User: melons)
Snail Mail - Valentine (User: melons)
Momma - Medicine (User: melons)
Jade Bird - Now Is The Time (User: melons)
Audiobooks - LaLaLa It's The Good Life (User: melons)
Charlotte Adigéry - Thank You (User: melons)
박혜진 Park Hye Jin - Let’s Sing Let’s Dance (User: melons)
Nilüfer Yanya - stabilise (User: melons)
Turnstile - UNDERWATER BOI (User: melons)
Jockstrap - 50/50 (User: melons)
Marina Allen - Oh, Louise (User: melons)
Subsonic Eye - Fruitcake (User: melons)
Tajai - Let It Ride (User: melons)
Pep Love and Jay Biz - Every Day of the Week (User: melons)
Casual - It Gets No Better (User: melons)
Souls of Mischief - Souls of Mischief (User: melons)
Pauline Oliveros - Sound Patterns (User: melons)
Klein - no more shubz (User: melons)
alpha maid - MILD WEATHER (User: melons)
Jana Rush - Moanin' (User: melons)
Aaron Dilloway - Labyrinths & Jokes (User: melons)
The Same - Hot & Cold (User: melons)
Phew - Hearts And Flowers (User: melons)
Uman - UMAN Spirit (User: melons)
Olivia Block - Axiolite (User: melons)
Beatriz Ferreyra - Echos (User: melons)
Marina Rosenfeld - Teenage Lontano I (User: melons)
Pamela Z - Echolocation (User: melons)
James Blake - Say What You Will (User: melons)
Bitchin Bajas & Bonnie "Prince" Billy - Your Whole Family are Well (User: melons)
Dally Proton - Pretender (User: melons)
Bill Callahan - Miracles (feat Ty Segall) (User: melons)
Dean Blunt - SEMTEX (User: melons)
The Red Krayola - It Will Be (Delivered) (User: melons)
Dead Rider - The Ideal (User: melons)
Squid - Peel St. (User: melons)
U.S. Maple - Apollo, Don't You Crust? (User: melons)
Joel Vandroogenbroeck - Oil Tankers - Analog Remaster (User: melons)
Bitchin Bajas - Moon Dance (User: melons)
Big Black - The Model (User: melons)
Broadcast - Winter Now (User: melons)
Purelink - Maintain The Bliss (User: melons)
Zomby - Salamander (User: melons)
Little People - Intermezzo (User: melons)
Paul Kalkbrenner - Fochleise-Kassette (User: melons)
C2D - With My Hoe! (User: melons)
YBN Nahmir - Opp Stoppa (User: melons)
Olivia Herdt - strawberry kisses (User: melons)
Lil Yachty - COFFIN (User: melons)
FAMILY EVENT - Relax And Take Notes (User: melons)
Lil Kapow - BLACKOUT (User: melons)
BKTHERULA - LEFT RIGHT (User: melons)
Lofi.Samurai - Love (User: melons)
SwuM - Milly Rock (User: melons)
September Savior - Just Think (User: melons)
Freddie Dredd - SNAKE (User: melons)
King Staccz - Pretty Face (User: melons)
Ben Clark - Be Mine (User: melons)
Joey Trap - Alexis (User: melons)
Just Viz - 15 (User: melons)
8percent - Dream Girl (User: melons)
Savage Ga$p - an ocean of stars couldn't keep us apart (User: melons)
ilyTOMMY - Shes My Lover Girl (User: melons)
LIL Chawley - Catfish (User: melons)
Boxout - I Just Want to Be the One You Love (User: melons)
Lonely God - Marlboro Nights (User: melons)
Cordae - Sweet Lawd - Skit (User: melons)
Dean Blunt - I Run New York (User: melons)
Babyfather - breddas (User: melons)
Bar Italia - rage quit (User: melons)
J Saunders - Tinkle (User: melons)
23 - Pink Soldiers (User: melons)
Hella - The D.Elkan (User: melons)
Clown Core - Surreal Cereal (User: melons)
The Frogs - I'm Hungry for Whores (User: melons)
Ana Roxanne - Untitled (User: melons)
00110100 01010100 - 0000 871 0009 (User: melons)
Masonna - Part IV (User: melons)
Lil Ugly Mane - Country Crott Commercial (User: melons)
Clarence Clarity - Become Death (User: melons)
XavlegbmaofffassssitimiwoamndutroabcwapwaeiippohfffX - XavlegbmaofffassssitimiwoamndutroabcwapwaeiippohfffX (User: melons)
Andrew Huang - Transmission (User: melons)
Joe Pera Talks With You - Nana's Theme - Summer Version (User: melons)
⣎⡇ꉺლ༽இ•̛)ྀ◞ ༎ຶ ༽ৣৢ؞ৢ؞ؖ ꉺლ - °。 * ̧.·*  ́ ̈・*・ . °。· ́ ̈ ́ ゚ * ́ ̈・ 。・ ゚.  ́ ̈ ゚. .· ・*.。 * ̈°. ・*。 ̧.·*  ́.·* ̈.· ・ ゚. 。 * ́ ̈* ́ ̈ .·.·* ́ ̈.·*:・✧(๑ඕัළඕั๑)✧*:・s░ƪ. (User: melons)
Connie Converse - Unknown (A Little Louder, Love) (User: melons)
Arthur - Twist (User: melons)
Otto - Jumping Jane (User: melons)
Dance Gavin Dance - Untitled (User: melons)
Kero Kero Bonito - Gateway (User: melons)
Micachu & The Shapes - Sweetheart (User: melons)
Steven Universe - Giant Woman (feat. Zach Callison) (User: melons)
Jack Stauber's Micropop - Coffee (User: melons)
Sleep Fruits Music - Rain Fruits Sounds, Pt. 109 (User: melons)
Cortex - Sabbat, Pt. 3 (User: melons)
Mr Dooves - Bill Nye the Science Guy (User: melons)
The Home Depot - The Home Depot Beat (User: melons)
The Home Depot - The Home Depot Beat (User: melons)
Leadbelly - Julie Ann Johnson (240-A-4) (User: melons)
Modest Mussorgsky - Pictures at an Exhibition: Promenade (User: melons)
Mndsgn - inhale (User: melons)
Parry Gripp - Do You Like Waffles? (User: melons)
Frankie Cosmos - Sand (User: melons)
Lil Yachty - Otha Shit (User: melons)
Frankie Cosmos - Sand (User: melons)
Sam Brown - Tea (User: melons)
Lootpack - Stylewild (User: melons)
A Balladeer - As Far As the Compliments Went (User: melons)
All - She Broke My Dick (User: melons)
Kid Jr. - Octonauts Theme Song (User: melons)
Sleep - Some Grass (User: melons)
Avril Lavigne - SpongeBob SquarePants Theme (User: melons)
Misfits - Kong Unleashed (User: melons)
AFI - AB- (User: melons)
PAW Patrol - PAW Patrol Opening Theme (User: melons)
Kevin Macleod - Avant Jazz (User: melons)
Remembering Never - Spray Paint The Walls (User: melons)
Minus the Bear - Hey, Wanna Throw Up? (User: melons)
The Minions - Universal Fanfare (User: melons)
Spongebob Squarepants - Electric Zoo (User: melons)
Doopees - CHOPIN OPUS 28 NO.4 LA JIMI STYLE (User: melons)
Field Medic - song i made up to stop myself from having a panic attack just now (User: melons)
Joe Pera Talks With You - Snowmobiles (User: melons)
daigoro789 - 9:00 P.M. Rainy/Snowy (From "Animal Crossing: New Leaf") (User: melons)
The Pissed Alpacas - December 4, 2020: National Sock Day (Instrumental) (User: melons)
Daorongguang - Shange diao (Mountain song) (User: melons)
Yoga Goa - Blank Mind (User: melons)
Zimoun - Mikroskopie 3.19 (User: melons)
Dorothee Munyaneza - Icyibo (User: melons)
Megatones - The Benny Hill Show (User: melons)
Gutalax - Anus Ice Cream (User: melons)
England Supporters Club - I'm England 'Till I Die (User: melons)
Petr Narozny - Mach a Šebestová / My jsme žáci 3. B (User: melons)
Geek Music - Peppa Pig - Theme Song (User: melons)
Caillou - Caillou Theme (User: melons)
Yung Scrambled Eggs - Tidbits (User: melons)
Caroline Konstnar - Ants in My Pussy (User: melons)
Schwey - Falling Action (User: melons)
Bobby Krlic - Prophesy (User: melons)
Tobias Lilja - Parasites (User: melons)
Schwey - Interlude (User: melons)
London Philharmonic Orchestra - Creation of Tron (User: melons)
Colin Stetson - Chasing Peter (User: melons)
knife girl - ''happy New Year!'', I Shout Through a Crowd of People as Fireworks Go off in the Sky. Can You Hear Me? (User: melons)
Ben Levin - Pro Audio (User: melons)
John Debney - Working With Dad (User: melons)
Daughters - Fur Beach (User: melons)
Clown Core - Van (User: melons)
Choker - Jet Stereo (User: melons)
Jim Henson - Bufferin: Memories (User: melons)
Tiny Tim - A Smile Will Go a Long, Long Way (User: melons)
Mrs. Miller - Happy Birthday Gary Owens (User: melons)
Fenn Rosenthal - Tigers In The Forest (User: melons)
Tuplets for Toddlers - Twinkle, Twinkle, Little Star (User: melons)
Scuba Z - Electrons Are Waves (User: melons)
Ashley Eriksson - Show Up (User: melons)
Burial - Untitled (User: melons)
Alex Somers - We Agreed (User: melons)
100 gecs - came to my show - intro (User: melons)
Benji Hughes - Lyegue (User: melons)
Pomplamoose - Door (User: melons)
Jacob Collier - CLARITY (User: melons)
Lianne La Havas - Green & Gold - Interlude; Solo (User: melons)
Men I Trust - Fiero GT (User: melons)
Miguel - Overload (Enter.Lewd) (User: melons)
Tenacious D - Karate Schnitzel (User: melons)
In Love With a Ghost - help (User: melons)
Alexandre Desplat - Overture: M. Gustave H (User: melons)
knife girl - i wish you'd realize that i'm actually crying when i tell you i'm fine (User: melons)
Backxwash - HETERONOMY (User: melons)
The Beatles - Dig It - Remastered 2009 (User: melons)
Jan Two-Sleeves - Kissing Toads Again (User: melons)
kai bravewood - good morning (User: melons)
Nxworries - Intro (User: melons)
recovery girl - lets go bitch (User: melons)
Sondre Lerche - Dan and Marie Melody (User: melons)
Flume - ╜φ°⌂▌╫§╜φ°⌂▌╫§╜φ°⌂▌╫§╜φ°⌂▌╫§╜φ°⌂▌╫§╜φ°⌂▌╫§╜φ°⌂▌╫§╜φ°⌂▌╫§╜φ°⌂▌╫§╜φ°⌂▌╫§╜φ°⌂▌╫§╜φ°⌂▌╫§╜φ°⌂▌╫§╜φ°⌂▌╫§╜φ°⌂▌╫§╜φ°⌂▌╫§╜φ°⌂▌╫§╜φ°⌂▌ (User: melons)
Dadweed - Fuck it, Forget it (User: melons)
Free Cake For Every Creature - I'll Blade with You Baby (User: melons)
Andrew Huang - Strummy (User: melons)
Doug Walker - Spongebob Theme (User: melons)
Persian Empire - grillyourfeet (User: melons)
bowl frizell - A Cockwind (Interlude) (User: melons)
aivi & surasshu - 38 (User: melons)
Boston - A New World (User: melons)
Steven Universe - Giant Woman (feat. Zach Callison) (User: melons)
Oscar Brand - California, Here We Come (Ronald Reagan) (User: melons)
Claude-Michel Schönberg - Turning (User: melons)
Chameleon Circuit - Knock Four Times (User: melons)
Stephen Sondheim - The Ballad of Sweeney Todd: "Sweeney Pondered and Sweeney Planned" (User: melons)
J.Period - Stay Alive - Interlude (User: melons)
Asheru - The Boondocks Main Title (User: melons)
Simon & Garfunkel - Bookends Theme (User: melons)
Reki - Flayn (User: melons)
Somi - The Story of Monkey (User: melons)
Samiyam - Ronald (User: melons)
Soulchef - Seashore (User: melons)
Karen O - NYC Baby (User: melons)
The Tokens - Perhaps, The Joy Of Giving (User: melons)
Comets On Fire - Rimbaud Blues (User: melons)
Lila Sakura - beepock (User: melons)
The Beets - Eat No Dick (User: melons)
Little Tybee - Humorous To Bees (User: melons)
BRANX - Deluxe (User: melons)
Wax Tailor - That Case (User: melons)
Trip Lee - Apathy (Interlude) (User: melons)
Those Lavender Whales - Sleep In (User: melons)
Bob & Gene - I Can Be Cool (User: melons)
The Budos Band - Untitled (User: melons)
bluntone - Nature Session (User: melons)
Turnstile - HUMANOID / SHAKE IT UP (User: melons)
Pansy Division - The Cocksucker Club (User: melons)
The Monkees - Can You Dig It (User: melons)
Todd Rundgren - It Wouldn't Have Made Any Difference - 2015 Remaster (User: melons)
NEEDTOBREATHE - Spare The Time (User: melons)
The Garden - The Tractor (User: melons)
Shu-De - Baian-Dudai (User: melons)
William Walton - Ass-Face (User: melons)
Chill Bump - The Smell Of Beer (Interlude) (User: melons)
Mat Lee - 7th Day (User: melons)
Gaudi - Roots (User: melons)
Slum Village - Intro (User: melons)
DJ Sorama - Treblalude (User: melons)
Atmosphere - Anterlude (User: melons)
Gods'Illa - Seeds (Interlude) (User: melons)
BTU - Ugly Sneakers - Original Mix (User: melons)
Lettuce - 'lude 2 (User: melons)
Brenk Sinatra - FTP Intro (User: melons)
Self Jupiter - To Love Me Is Know Is To Love Me (Skit) (User: melons)
Ventla - Vertebra (User: melons)
Glass Ghost - LYFE Intro (User: melons)
In Tall Buildings - Cedarspeak (User: melons)
Brous One - Chopped (User: melons)
bluntone - Nature Session (User: melons)
Girl Talk - Pump It Up (User: melons)
Lamitina - finish feature incentive (User: melons)
Chevy Woods - Intro (User: melons)
Fort Minor - The Battle (feat. Celph Titled) (User: melons)
Knxwledge - time&tide (User: melons)
Charizma - Apple Juice Break (User: melons)
Mndsgn - inhale (User: melons)
Bahwee - Silverskies (User: melons)
Juj - SoulBounceRemix (interlude) (User: melons)
Pajjama - Keiba (User: melons)
Beat Connection - The Foreign Embassy (User: melons)
Articolo 31 - Non Ce La Fai (User: melons)
Gucci Mane - Perfect (Intro) (User: melons)
CHON - Drift (User: melons)
Lone - Buried Coral Banks (User: melons)
toe - 反逆する風景 (User: melons)
Burn So Bright - (Presence) (User: melons)
Harry Gregson-Williams - El paso (User: melons)
Michael Giacchino - Free Skating (User: melons)
Alan Silvestri - Some Men Are Born Great (User: melons)
Alan Menken - Fireworks - From "The Little Mermaid"/Score (User: melons)
Kaitlyn Aurelia Smith - Labyrinth IX (User: melons)
Rhian Sheehan - An Afternoon on the Moon - The Phoenix Foundation Re-Mangle, Pt. 2 (User: melons)
Common - WMOE (User: melons)
Siriusmo - Call Me (User: melons)
ESPRIT 空想 - gameover.wav (User: melons)
Biff Chitlins - Liars (User: melons)
non prophets - A Mill (User: melons)
Masters of Reality - Madonna (User: melons)
Charlie's Angels - Seinfeld (User: melons)
The Beatles - Wild Honey Pie - Remastered 2009 (User: melons)
G-Eazy - Interlude (User: melons)
Bumblebeez - Intro (User: melons)
Kai Miles - Passion Flour (User: melons)
Television's Greatest Hits Band - I Dream of Jeannie (User: melons)
Alice Cooper - Street Fight (User: melons)
The Incredible String Band - Schaeffer's Jig - 2010 Remaster (User: melons)
White Fang - Coffee Table (User: melons)
Western Motel - Chicken Bacon Guacamole (User: melons)
Kai Miles - Aïsea (User: melons)
múm - Sleep/Swim (User: melons)
Sir - John Redcorn (User: melons)
Souls of Mischief - Step to My Girl (User: melons)
Xixa - Eclipse (User: melons)
Altin Gün - Kara Toprak (User: melons)
Dos Santos - A Shot in the Dark (User: melons)
The Cambodian Space Project - Dance Twist (User: melons)
Mdou Moctar - Ya Habibti (User: melons)
Dengue Fever - Tiger Phone Card (User: melons)
The National Parks - I Can Feel It (User: melons)
Evie Irie - BLEED (User: melons)
Orla - Lazy (User: melons)
Charlotte Adigéry - Blenda (User: melons)
Hiatus Kaiyote - Red Room (User: melons)
Matt Corby - All Fired Up (User: melons)
She Past Away - Durdu Dunya (User: melons)
THE ROOP - Discoteque (User: melons)
The Murlocs - Rolling On (User: melons)
Gojira - Sphinx (User: melons)
Leprous - Alleviate (User: melons)
Rob Thomas - Streetcorner Symphony (User: melons)
säje - Desert Song (User: melons)
3JS - één met de bomen (User: melons)
Noto - Catatonic (User: melons)
Mob Rich - Loser (User: melons)
Sara Watkins - Night Singing (User: melons)
Chase Atlantic - Moonlight (User: melons)
Madison Olds - Moments in the Mountains (User: melons)
St. Panther - Highway (User: melons)
Still Woozy - Window (User: melons)
Ber - Meant To Be (User: melons)
LP - One Last Time (User: melons)
AJR - Way Less Sad (User: melons)
In Flames - Cloud Connected (User: melons)
Sarah and the Sundays - I'm So Bored (User: melons)
Gunship - When You Grow Up, Your Heart Dies (User: melons)
Timecop1983 - On the Run (User: melons)
Renata Rosa - Na janela do dia (User: melons)
Agnes Obel - Familiar (User: melons)
Ela Minus - megapunk - TSHA Remix (User: melons)
Sorry - Cigarette Packet (User: melons)
Middle Kids - Today We're The Greatest (User: melons)
Sorry - Don't Be Scared (User: melons)
Sam Mehran - LOUNGY (User: melons)
Yelle - Je Veux Te Voir (User: melons)
Shirley Collins - My Sailor Boy (User: melons)
Middle Kids - Driver's License (Triple J Like a Version) (User: melons)
Thao & The Get Down Stay Down - Marrow - Strings Version (User: melons)
George Fitzgerald - Ultraviolet - Edit (User: melons)
Porches - Back3School (User: melons)
Hayden Thorpe - Golden Ratio (User: melons)
SASAMI - The Greatest (User: melons)
Franz Ferdinand - Billy Goodbye (User: melons)
Hard Feelings - Love Scenes (User: melons)
Night Moves - Fallacy Actually (User: melons)
Georgia - The Thrill - After Hours Edit (User: melons)
Circle - Saxo (User: melons)
DC Gore - California - Edit (User: melons)
All We Are - Colour Me Amazed (User: melons)
Jaakko Eino Kalevi - Left Outside Alone (User: melons)
Pansy Division - luv luv luv (User: melons)
Mudhoney - Into The Drink (User: melons)
Primus - Grandad's Little Ditty (User: melons)
Wire - Three Girl Rhumba - 2006 Remastered Version (User: melons)
The Beatles - Misery - Remastered 2009 (User: melons)
They Might Be Giants - Particle Man (User: melons)
Buddy Holly - Rock Around With Ollie Vee - Alternate Version (User: melons)
Tom Waits - Such a Scream (User: melons)
The Smiths - Death at One's Elbow - 2011 Remaster (User: melons)
Turnstile - DON'T PLAY (User: melons)
Harry Connick, Jr. - Heavenly (User: melons)
S.O.D. Stormtroopers Of Death - What's That Noise? (User: melons)
Minor Threat - I Don't Wanna Hear It (User: melons)
The French Impressionists - Pick Up the Rhythm (User: melons)
The Peth - Let's Go Fucking Mental (User: melons)
John Wesley Harding - Movie Theme (User: melons)
BaRRy - Barry Loves You Santa (User: melons)
Harry Nilsson - Listen, The Snow Is Falling (User: melons)
Fuzz - Sleigh Ride (User: melons)
Buscabulla - Cantares (User: melons)
LA Wise Man - All I Want For Xmas Is Rock & Roll (User: melons)
SASAMI - Little Drummer Boy (User: melons)
Charlotte Cardin - Fous N'importe Où (User: melons)
Mirror Machines - Pray For Rain (User: melons)
Ducks Ltd. - Patience Wearing Thin (User: melons)
Seb - seaside_demo (User: melons)
Blair Lee - California (feat. Sylo Nozra) (User: melons)
Sarcastic Sounds - Closure (feat. BIRDY and Mishaal) (User: melons)
MAY-A - Apricots (User: melons)
Goldroom - Till Sunrise (Remix) (User: melons)
TWO LANES - Rolling Back (User: melons)
Orange Juice - Holiday Hymn (User: melons)
Josh Jacobson - Ocean (User: melons)
Amitė - Save Me (User: melons)
Kevin Brennan - The Clown and the Cigarette Girl (User: melons)
Gus Dapperton - Medicine (User: melons)
Vandelux - Know Some (User: melons)
Catie Turner - Hide and Seek - Le Youth Remix (User: melons)
SG Lewis - Feed The Fire (feat. Lucky Daye) (User: melons)
Stonebank - Strength Unknown (User: melons)
Adventure Club - High Like This (User: melons)
Half Moon Run - Monster (User: melons)
Whitney - Valleys (My Love) (User: melons)
Palace - Have Faith (User: melons)
Ruby Waters - Blow (User: melons)
Leisure - Lonely Nights (User: melons)
Cannons - Bad Dream (User: melons)
John Mayer - Slow Dancing in a Burning Room (User: melons)
Waterstrider - End of Sequence (User: melons)
1990nowhere - Picasso (User: melons)
Adam Melchor - Light Year (feat. Lennon Stella) (User: melons)
Half Moon Run - On & On (User: melons)
LÉON - You And I - SAINT WKND Remix (User: melons)
Golden Ears - Fix Yourself (User: melons)
Kaleo - Hey Gringo (User: melons)
Clinic - Christmas (User: melons)
Rostam - 4Runner (User: melons)
The Griswolds - ALIENS (User: melons)
Von Sell - Want (User: melons)
Forester - Undercover (User: melons)
Reuben And The Dark - YES (User: melons)
Half Moon Run - Seasons of Change (User: melons)
Yves Jarvis - In Every Mountain (User: melons)
LA Priest - Beginning - Edit (User: melons)
besphrenz - DISTORTO (User: melons)
The Paper Kites - Bloom - Bonus Track (User: melons)
Francko - I Found Peace In Your Violence (User: melons)
Cosmo's Midnight - Down for You (User: melons)
Tora - Can't Buy The Mood - Two Another Remix (User: melons)
Porter Robinson - Polygon Dust (User: melons)
Bayonne - Fallss (User: melons)
Nasaya - PATTERNS (User: melons)
Chiiild - Pirouette (User: melons)
Axwell /\ Ingrosso - Renegade (User: melons)
Stillwater Sound - Karma (User: melons)
Novo Amor - Terraform (User: melons)
Cautious Clay - Joshua Tree (User: melons)
A R I Z O N A - What She Wants (User: melons)
Wilderado - Favors (User: melons)
Twin Shadow - Saturdays (feat. HAIM) (User: melons)
RUUTH - All About (User: melons)
The Midnight - Lost & Found (User: melons)
Jane's Party - Right Down the Line (User: melons)
Hovvdy - Pretend (User: melons)
3LAU - Touch (User: melons)
Sam Setton - Santiago (User: melons)
Shor - Sirens (User: melons)
Zanski - Oceans (User: melons)
Jeff Beadle - Gone Before Sunrise (User: melons)
Elliot Root - Wicked Lies (User: melons)
Cobi - Don't You Cry For Me (User: melons)
Electric Guest - Oh Devil (User: melons)
Allan Rayman - Much Too Much (User: melons)
347aidan - IDWK (User: melons)
Jon Seger - Gold Pub (User: melons)
Lionel Richie - Don't Stop The Music (User: melons)
jobii - Sisu (User: melons)
Slumberville - Lonely in London (User: melons)
Liam Huston - Melloton (User: melons)
Braj Mahal - Crush (User: melons)
Lofi Fruits Music - I'm Yours (User: melons)
owlh - sunflower (User: melons)
Recueil - daybreak (User: melons)
Hydrologic - River Bend (User: melons)
Teebs - While You Doooo (User: melons)
W00DS - Hope (User: melons)
KAN SANO - On My Way Home (User: melons)
Ganzo - Happy Feet (User: melons)
Lofi Fruits Music - Dancing in the Moonlight (User: melons)
Kid Kio - Somewhere New (User: melons)
Elior - Pharaoh (User: melons)
Cheap Monk - Tao (User: melons)
Rosehip - Awake (User: melons)
David Cutter Music - Seeing (User: melons)
Moseqar - Anybody Else (User: melons)
Hermes Music - 2 Minutes of Silence (Reflexion Spiritual Break Pause Minutos Silencio Hermetismo Silenzio Stille 沉默 沈黙 молчание) (User: melons)
Simon Whitfield - Two Minute Silence (User: melons)
Hen Ogledd - Monty Don’s Handset (User: melons)
Night Heron - Dreamz (User: melons)
boreen - mood ring (User: melons)
M A N E - Mood~Ring (User: melons)
Laith - Pine Drive (User: melons)
Palm Sunday - Swimming In Indigo (User: melons)
Oh, Rose - 25, Alive (User: melons)
Sawtooth - Wildwood (User: melons)
Senses Fail - Buried A Lie (User: melons)
Senses Fail - Calling All Cars (User: melons)
Senses Fail - Can't Be Saved (User: melons)
Nothings - Reality (User: melons)
Ancient Pools - Forget (User: melons)
Tim Cappello - I Still Believe (User: melons)
Pretty Boy Aaron - Comb My Hair (User: melons)
Harriette - at least i'm pretty (User: melons)
Caroline Rose - Do You Think We’ll Last Forever? (User: melons)
Ritt Momney - Escalator (User: melons)
Aminé - NEO (User: melons)
Alina Baraz - If You Let Me (User: melons)
Wallice - Wisdom tooth (User: melons)
Remi Wolf - Front Tooth (User: melons)
spencer. - Automatic - Orion Sun Remix (User: melons)
Molokai - Ooh Baby (User: melons)
Gracie Abrams - Feels Like (User: melons)
¿Téo? - Buzzed (User: melons)
Kacey Musgraves - what doesn’t kill me (User: melons)
Dominic Fike - Phone Numbers (User: melons)
KAYTRANADA - Go DJ (User: melons)
The Beatles - Till There Was You - Remastered 2009 (User: melons)
Masked Wolf - Astronaut in the Ocean (User: melons)
Basil Gabbidon - This Generation (User: melons)
spencer. - MyLuv (User: melons)
Isaiah Rashad - Darkseid (User: melons)
Zaia - BLUE (User: melons)
Willow - G R O W (WILLOW & Avril Lavigne feat. Travis Barker) (User: melons)
Tyler, the Creator - LUMBERJACK (User: melons)
Tyler, the Creator - LEMONHEAD (feat. 42 Dugg) (User: melons)
The Marías - Spin Me Around (User: melons)
Vince Staples - ARE YOU WITH THAT? (User: melons)
Samia - As You Are (User: melons)
GoldLink - Evian (feat. PinkPantheress, Rizloski & Rax) (User: melons)
Saba - Areyoudown? Pt. 2 (User: melons)
Rico Nasty - Own It (User: melons)
Lilyisthatyou - FMRN (User: melons)
Dominic Fike - Wurli (User: melons)
spill tab - Calvaire (User: melons)
LoveLeo - HEAD OVER HEELS (User: melons)
Evann McIntosh - WIYULD (User: melons)
Billy Lemos - Wonder (feat. Still Woozy and MTMBO) (User: melons)
Miloe - Winona (User: melons)
llusion - Sad4good (feat. Cautious Clay & HXNS) (User: melons)
carolesdaughter - violent (User: melons)
Apricot Ink - Carmelyzed Crusade (User: melons)
Paul McCartney - The Kiss Of Venus (Dominic Fike) (User: melons)
Still Woozy - Lucy (User: melons)
Still Woozy - Goodie Bag (User: melons)
spill tab - PISTOLWHIP (User: melons)
Dominic Fike - Superstar Sh*t (User: melons)
Lil Nas X - MONTERO (Call Me by Your Name) (User: melons)
Dominic Fike - Double Negative (Skeleton Milkshake) (User: melons)
Steve Lacy - Some (User: melons)
Carnage - Learn How to Watch (feat. MAC MILLER & MadeinTYO) (User: melons)
Aminé - Talk (feat. Saba) (User: melons)
Billy Lemos - 12:34 AM (User: melons)
Selena Gomez - Adiós (User: melons)
Still Woozy - Window (User: melons)
Clairo - Feel Something (User: melons)
the booyah! kids - Don't Trust Me (User: melons)
Jawny - Anything You Want (User: melons)
Dominic Fike - Rollerblades (User: melons)
DUCKWRTH - Crush (User: melons)
Tyler, the Creator - BEST INTEREST (User: melons)
Frank Ocean - In My Room (User: melons)
Binki - Sea Sick (User: melons)
Dominic Fike - Why (User: melons)
Steve Lacy - C U Girl (User: melons)
Still Woozy - BS (User: melons)
beabadoobee - Coffee (User: melons)
Zaia - VERY ALONE (User: melons)
Emotional Oranges - Body & Soul (feat. Biig Piig) (User: melons)
Kali Uchis - no eres tu(soy yo) (User: melons)
Joji - Tick Tock (User: melons)
Cautious Clay - Cheesin' (User: melons)
Dayglow - Something (User: melons)
BROCKHAMPTON - 1997 DIANA (User: melons)
Omar Apollo - ugotme (User: melons)
Ray Charles - Hit the Road Jack (User: melons)
Kate Bush - Night Scented Stock - 2018 Remaster (User: melons)
David Sylvian - September (User: melons)
Kevin Morby - Wander (User: melons)
Andrew Bird - Logan's Loop (User: melons)
Max Richter - Horizon Variations (User: melons)
Ron Sexsmith - Maybe This Christmas (User: melons)
John Dowland - Lady Rich, Her Galliard (User: melons)
Josquin des Prez - El grillo (User: melons)
Felix Mendelssohn - Lieder ohne Worte, Op. 62: No. 6 Allegretto grazioso "Frühlingslied" (Arr. Ottensamer for Clarinet and Strings) (User: melons)
John Dowland - The Frog Galliard (P 23a) (User: melons)
L'Arpeggiata - Ciaccona, Pt. 2 (User: melons)
Hans Neusidler - Welscher Tantz Wascha mesa - Hupfauff (User: melons)
Arthur Rubinstein - Waltzes, Op. 64: No. 1, Minute, in D-flat (User: melons)
Thomas Greaves - Come Away, Sweet Love (User: melons)
Benjamin Britten - Songs from "Friday Afternoons", Op.7: Songs From Friday Afternoons, Op. 7: "Cuckoo!" (User: melons)
Richard Strauss - Also sprach Zarathustra, Op. 30, TrV 176: 1. Prelude (Sonnenaufgang) (User: melons)
George Frideric Handel - Handel: Acis and Galatea, HWV 49a, Act 1: No. 9b, Chorus, "Happy we!" (User: melons)
John Tavener - Out of the Night (Alleluia) - Reprise I - Voice (User: melons)
Arthur Lyman - Hii Lawe (User: melons)
Thomas Bergersen - Heart of Courage (User: melons)
The Pretty Things - The Good Mr. Square (User: melons)
The 6ths - As You Turn To Go (User: melons)
Billy Cobb - Lullaby (User: melons)
Okay Kaya - Mother Nature's Bitch (User: melons)
Jessica Pratt - On Your Own Love Again (User: melons)
The Bomboras - Last Call (User: melons)
Dick Dale and His Del-Tones - Night Rider (User: melons)
Wipers - Mystery (User: melons)
deadman 死人 - Omae Wa Mou (User: melons)
Piero Umiliani - Crepuscolo sul mare (User: melons)
Piero Umiliani - Mah nà mah nà (User: melons)
Soul II Soul - Get a Life (User: melons)
Henrik Schwarz - Take Words in Return (User: melons)
DNA - Blonde Redhead (User: melons)
John Mellencamp - Grandma's Theme (User: melons)
Peter Murphy - Untitled (User: melons)
Cactus - Part of the Game (User: melons)
Spirit - Why Can't I Be Free (User: melons)
Basia Bulat - Before I Knew (User: melons)
Almeda Riddle - My Little Rooster (User: melons)
Louis Hardin - Lament I, "Bird's Lament" - Instrumental (User: melons)
Arvo Pärt - Lamentate: Fragile - (User: melons)
Coro della Radio Svizzera, I Barocchisti, Diego Fasolis - Accompagnato - Ozias - Ita Decreto Aeterno (User: melons)
François Couperin - Les Baricades Mistérieuses (6e ordre) (User: melons)
Angelika Köhlermann - Need to Find (User: melons)
Ichiko Aoba - Pochette No Outa (User: melons)
Kalaido - Houses on Hills (User: melons)
Jeroen Van Veen - Le vieux en veut encore (User: melons)
Kelly Clarkson - Santa, Can’t You Hear Me (User: melons)
Kelly Clarkson - Under The Mistletoe - Bonus Track (User: melons)
Kelly Clarkson - Stronger (What Doesn't Kill You) (User: melons)
Kalaido - Houses on Hills (User: melons)
The Andrews Sisters - Rum And Coca-Cola - Single Version (User: melons)
The Marvelettes - Please Mr. Postman - Single Version / Mono (User: melons)
Mary Jane Girls - All Night Long (User: melons)
Jodeci - U And I (User: melons)
Tony! Toni! Toné! - Whatever You Want (User: melons)
Soul for Real - Candy Rain - Heavy D & TrakMasterz Mix (User: melons)
Allure - Enjoy Yourself / Love Me Interlude - For Advance & Frontline (User: melons)
Shai - If I Ever Fall In Love (User: melons)
Dru Hill - Beauty (User: melons)
Glass Animals - Take A Slice (User: melons)
Jagged Edge - Put A Little Umph In It - Single Version (User: melons)
Mint Condition - Breakin' My Heart (Pretty Brown Eyes) (User: melons)
702 - Where My Girls At (User: melons)
Hiss Golden Messenger - Joy to the World (User: melons)
Ron Sexsmith - Maybe This Christmas (User: melons)
Natalie McCool - Have Yourself A Merry Little Christmas (User: melons)
Fenne Lily - In the Bleak Midwinter (User: melons)
Fruit Bats - It’s Beginning To Look Like Christmas (User: melons)
Phoebe Bridgers - Christmas Song (User: melons)
The Cribs - Christmas (All Year Long) (User: melons)
Yo La Tengo - Winter A-Go-Go (User: melons)
Neil Halstead - The Man in The Santa Suit (User: melons)
John Prine - Christmas In Prison (User: melons)
The Band - Christmas Must Be Tonight - Remastered 2001 (User: melons)
Frightened Rabbit - It's Christmas So We'll Stop (User: melons)
Bright Eyes - Blue Christmas (User: melons)
Marika Hackman - Driving Under Stars (User: melons)
Sweet Baboo - Don't be Alone (This Christmas) (User: melons)
Pedro the Lion - Yellow Bike (User: melons)
Low - Some Hearts (at Christmas Time) (User: melons)
Fleet Foxes - White Winter Hymnal (User: melons)
Low - Just Like Christmas (User: melons)
Sufjan Stevens - Lonely Man of Winter (User: melons)
Bert Jansch - In The Bleak Mid Winter (User: melons)
Mi Mye - I'm Dreaming Of A (User: melons)
Paul Thomas Saunders - Christmas, The Sequel (User: melons)
Shakin' Stevens - Merry Christmas Everyone (User: melons)
Kelly Clarkson - Underneath the Tree (User: melons)
Jennifer Castle - Walkin' Down The LIne (User: melons)
William Tyler - She's As Beautiful As A Foot (User: melons)
Kevin Morby - Caught In My Eye (User: melons)
Tashaki Miyaki - I Only Have Eyes For You (User: melons)
Ryley Walker - Everybody is Crazy (User: melons)
Sonny & The Sunsets - Tracy Had a Hard Day Sunday (User: melons)
of Montreal - All My Sorrows (User: melons)
Caetano Veloso - The Empty Boat - Remastered 2006 (User: melons)
Alex Cameron - The Comeback (User: melons)
Robert Lester Folsom - April Suzanne (User: melons)
Opus Kink - This Train (User: melons)
David Johansen - Funky But Chic (User: melons)
Parquet Courts - Stoned and Starving (User: melons)
Spencer Cullum - Imminent Shadow (User: melons)
Brazilian Girls - St. Petersburg (User: melons)
Kathy Heideman - The Earth Won't Hold Me (User: melons)
Cristina - What's a Girl to Do (User: melons)
Acetone - All the time (User: melons)
Lives Of Angels - Ascension (User: melons)
Wand - M.E. (User: melons)
Beat Happening - Godsend (User: melons)
The Courtneys - Lost Boys (User: melons)
Karen Dalton - In a Station (User: melons)
A.C. Marias - Just Talk (User: melons)
Dungen - Festival (User: melons)
Cardiacs - Is This the Life? (User: melons)
Amadou & Mariam - Masiteladi (feat. M) (User: melons)
The Tragically Hip - Bobcaygeon (User: melons)
The Tragically Hip - Escape Is At Hand For The Travellin' Man (User: melons)
Marvin Pontiac - Runnin' Round (User: melons)
The Umlauts - Boiler Suits & Combat Boots (Edit) (User: melons)
White Fence - Allison Road (User: melons)
Bryan Ferry - The 'In' Crowd (User: melons)
The Sea and Cake - Jacking the Ball (User: melons)
Karen Young - Dee Tour (User: melons)
Bruce Cockburn - Night Train (User: melons)
John Glacier - If Anything (User: melons)
Simon Raymonde - Here I Am (User: melons)
Elias Rahbani - Dance of Maria (User: melons)
Sunbear - I Heard the Voice of Music Say (User: melons)
coco maria - Me Veo Volar (User: melons)
Krust - Negative Returns - Four Tet Remix (User: melons)
Mr. Mitch - In the Hills (User: melons)
Ersen ve Dadaşlar - Yedin Beni (User: melons)
Emma-Jean Thackray - Movementt (User: melons)
Fatback Band - Wicky Wacky (User: melons)
Greentea Peng - Jimtastic Blues (User: melons)
Brazilian Octopus - Summer Hill (User: melons)
Sons of Kemet - My Queen Is Albertina Sisulu (User: melons)
Arthur Verocai - Na Boca do Sol (User: melons)
Derrick Harriott - The Loser (User: melons)
Derrick Harriott - The Loser (User: melons)
Marion Brown - Sweet Earth Flying - Pt. 1 (User: melons)
Little Dragon - Constant Surprises (User: melons)
Aphex Twin - Bbydhyonchord (User: melons)
Kokoroko - Baba Ayoola (User: melons)
Theon Cross - We Go Again (User: melons)
John Glacier - If Anything (User: melons)
Rosinha de Valença - Asa Branca (User: melons)
Prince - Colors - 2020 Remaster (User: melons)
Human Race - human race (User: melons)
Burning Spear - Marcus Garvey (User: melons)
Sault - Wildfires (User: melons)
Altin Gün - Kısasa Kısas (User: melons)
Moses Boyd - 2 Far Gone (User: melons)
Horace Family - God Will Dry My Weeping Eyes (User: melons)
Miles Davis - Générique - Bande originale du film "Ascenseur pour l'échafaud" (User: melons)
LA timpa - Deaf in Three Corners (User: melons)
Tommy James & The Shondells - Crystal Blue Persuasion (User: melons)
Yves Tumor - Jackie (User: melons)
Joy Orbison - better (User: melons)
Fela Kuti - Water No Get Enemy (User: melons)
The Equatics - Merry Go Round (User: melons)
Little Simz - Point and Kill (User: melons)
The Budos Band - Gun Metal Grey (User: melons)
Ranil - Las oladas (User: melons)
Gilberto Gil - Tartaruguê (User: melons)
Yves Tumor - Gospel for a New Century (User: melons)
Santo & Johnny - Show And Tell (User: melons)
Sofia Kourtesis - La Perla (User: melons)
Machinedrum - Stone Age (User: melons)
Dr. Buzzard's Original Savannah Band - Sunshower (User: melons)
Mano Le Tough - Moment To Change (User: melons)
Lorez Alexandria - Send In the Clowns (User: melons)
Roy Ayers Ubiquity - Everybody Loves The Sunshine (User: melons)
Tony Allen - Cosmosis (User: melons)
Little Beaver - I'm Losin' The Feelin (User: melons)
King Tubby - Take Five (User: melons)
Lijadu Sisters - COME ON HOME (User: melons)
Sonzeira - O Baixo do Kassin (feat. Kassin) (User: melons)
Sister Nancy - Bam Bam (User: melons)
Sault - Let Me Go (User: melons)
Nightmares on Wax - Imagineering (User: melons)
The Brothers Johnson - Strawberry Letter 23 (User: melons)
Bee Gees - More Than A Woman - From "Saturday Night Fever" Soundtrack (User: melons)
Radiohead - Everything in Its Right Place (User: melons)
Marvin Gaye - Where Are We Going? (User: melons)
Sopwith Camel - Fazon (User: melons)
Kiki Gyan - Disco Dancer (User: melons)
Gotts Street Park - Diego (User: melons)
Kool & The Gang - Summer Madness (User: melons)
Labi Siffre - I Got The... - 2006 Remaster (User: melons)
Barry Can't Swim - Jazz Club After Hours (User: melons)
Dr. John - Mama Roux (User: melons)
Hiatus Kaiyote - Red Room (User: melons)
Manfred Mann Chapter Three - One Way Glass (User: melons)
The Clash - Straight to Hell - Remastered (User: melons)
Bill Callahan - Blackness of the Night (feat. AZITA) (User: melons)
Get Well Soon - Mantra (User: melons)
Erasure - Time (Hearts Full of Love) (Single Mix) - Bonus Track (User: melons)
The Bay Man - Magnificent (User: melons)
Jeremy Arndt - Song of the Morning (User: melons)
Kate Stone - Whispering Creek (User: melons)
Tibetan Meditation - Deep Mind Reset (User: melons)
Hang Drum Pro - Under the Blue Sky (User: melons)
Hang Drum Massive - Thingless Things (User: melons)
Tempus Fugit Percussion Ensemble - A B S E N T I A - Udu & Hang Solo (User: melons)
Alex Couture - Stillness is Waiting (User: melons)
Tech art - Winds Of Hope (User: melons)
Azure Lilly - Hang Dream (User: melons)
Hang Drum music - Spa Relaxation (User: melons)
Nicole Rosario - Waves are coming (User: melons)
Benjamin Frith - Nocturne No. 10 in E minor (User: melons)
Richard Wagner - Das Rheingold: Prelude (User: melons)
Georg Philipp Telemann - Orchestral Suite in C Major, TWV 55:C3 "Hamburger Ebb und Fluth": VII. Der sturmende Aeolus (User: melons)
Anton Webern - Elf kurze Stücke: No. 4 in A Minor (User: melons)
Alexander Scriabin - Etude in C-sharp minor, Op. 2, No. 1 (1887-9) (User: melons)
Franz Liszt - Mendelssohns Lieder, S. 547: Auf Flugeln des Gesanges (from Op. 34, No. 2) (User: melons)
Mario Castelnuovo-Tedesco - Sonatina Canonica, Op. 196: II. Tempo Di Siciliane (User: melons)
Frank Bridge - Berceuse (arr. for viola and piano) (User: melons)
武満徹 - Piano Pieces for Children: No. 2. Clouds (User: melons)
Fanny Mendelssohn - 6 Melodies, Op. 4 - 6 Melodies, Op. 5: Allegretto (User: melons)
György Kurtág - Gottes Zeit ist die allerbeste Zeit, BWV 106 (Arr. G. Kurtag for Piano Duo) (User: melons)
Alessandro Marcello - Oboe Concerto in D Minor, S. Z799: I. Andante e spiccato (User: melons)
Karol Szymanowski - Violin Concerto No.1, Op.35: Vivace scherzando (User: melons)
Jean Sibelius - 13 Pieces, Op. 76: No. 3 Carillon (User: melons)
Leonard Bernstein - 5 Anniversaries: No. 5. For Susanna Kyle (User: melons)
Anton Webern - Symphony, Op. 21: II. Variationen (User: melons)
Percy Grainger - La Scandinavie: III. Polska norvégien (User: melons)
Richard Wagner - Das Rheingold: Prelude (User: melons)
Krzysztof Penderecki - 3 Pieces in Old Style: No. 1. Aria (User: melons)
Anton Bruckner - Locus iste (User: melons)
Heitor Villa-Lobos - Bachianas Brasileiras No. 5 (for soprano and 8 cellos) (1998 Digital Remaster): I. Aria (Cantilena) (1938) Adagio (User: melons)
Leoš Janáček - On an Overgrown Path (Po zarostlém chodnicku), JW 8/17 / Book 1: 1. Nase vecery (Our Evenings) (User: melons)
Charles-Valentin Alkan - 25 Preludes dans tous les tons majeurs et mineurs, Op. 31: No. 8 La chanson de la folle au bord de la mer: Lentement (User: melons)
Edward MacDowell - Woodland Sketches, Op. 51: No. 1: To a Wild Rose (User: melons)
Johann Baptist Cramer - Studio per il pianoforte, Book 1, Op. 30: No. 26 in G-Sharp Minor (User: melons)
Robert Schumann - Kinderszenen (Scenes from Childhood) Op. 15: No. 12 Kind im Einschlummern (Child Falling Asleep) (User: melons)
Claudio Monteverdi - Cantate Domino (User: melons)
Sergei Rachmaninoff - Rachmaninov: 6 Moments Musicaux, Op. 16: No. 4 in E Minor (User: melons)
Angélica Negrón - Sueno Recurrente (User: melons)
David Lang - Light Moving (User: melons)
Henri Dutilleux - Dutilleux: Blackbird (User: melons)
Igor Stravinsky - Stravinsky: Double Canon for String Quartet "Raoul Dufy in memoriam" (User: melons)
Edvard Grieg - Grieg: Lyric Pieces, Book 5, Op. 54: III. Troldtog (User: melons)
Hildegard von Bingen - Antiphon Caritas habundant in omnia (User: melons)
Cécile Chaminade - 6 Romances sans paroles, Op. 76: No. 1. Souvenance (User: melons)
Charles Griffes - 3 Tone-Pictures, Op. 5 (version for orchestra): No. 2. The Vale of Dreams (User: melons)
Nikolai Medtner - 2 Tales, Op. 20: 2 Fairy Tales, Op. 20: No. 1. Allegro con espressione (User: melons)
Alexander Scriabin - Two Pieces, Op.59: No.1 - Poème (User: melons)
Edward Elgar - Salut d'amour, Op. 12 (User: melons)
Heitor Villa-Lobos - Saudades das Selvas Brasilieras No. 2 (User: melons)
Joaquín Rodrigo - Cançoneta for Violin and Orchestra (User: melons)
György Kurtág - Játékok / 4.: 6. Hommage à Halmágyi Mihály (User: melons)
Astor Piazzolla - Oblivion (Arr. for Violin, Cello & Accordion) (User: melons)
Philip Glass - Études: No. 9 (User: melons)
Francisco Tárrega - Lagrima (User: melons)
Francis Poulenc - Nocturnes n°4 en ut mineur (User: melons)
Ensemble Recherche - In Nomine (Instrumentation colorée I) (User: melons)
François Couperin - Le Tic-Toc-Choc, ou Les Maillotins: 18ème ordre, 3ème livre (User: melons)
Anton Webern - Three Little Pieces for Cello and Piano, op.11 (1914) (User: melons)
Franz Liszt - At the Grave of Richard Wagner (User: melons)
Felix Mendelssohn - Lieder ohne Worte, Op. 62: No. 6 Allegretto grazioso - "Spring Song" (User: melons)
Arvo Pärt - Arbos (User: melons)
Henry Purcell - Fantasy upon one note (User: melons)
John Field - Nocturne No. 5 In B-Flat Major (User: melons)
Reinhold Glière - 8 Pieces, Op. 39: No. 3. Berceuse (User: melons)
Ludwig van Beethoven - 6 Bagatelles, Op.126: 2. Allegro (User: melons)
Sally Norris - 40 24 20 10 (User: melons)
Domenico Scarlatti - Keyboard Sonata in D Minor, Kk. 1 (User: melons)
Alonso Mudarra - Fantasia que contrahaze la harpa de Ludovico (User: melons)
Charles-Valentin Alkan - 25 Preludes dans tous les tons majeurs et mineurs, Op. 31: No. 13. J'etais endormie, mais mon coeur veillait (User: melons)
Frederick Delius - 2 Aquarelles: No. 1. Lento, ma non troppo (User: melons)
Maurice Ravel - Menuet sur le nom d'Haydn (User: melons)
Antonín Dvořák - Gypsy Songs, Op. 55, B. 104: No. 4, Songs My Mother Taught Me (Arr. F. Kreisler for Cello & Piano) (User: melons)
John Dowland - Lady Rich, Her Galliard (User: melons)
Giya Kancheli - Miniature No. 7 (User: melons)
Bedřich Smetana - Album Leaf for Kateřina Kolářová in B Major, JB 1:20 (User: melons)
Percy Grainger - La Scandinavie: III. Polska norvégien (User: melons)
Federico Mompou - Scènes d'enfants: Jeunes filles au jardin (User: melons)
Sulkhan Tsintsadze - Chonguri (User: melons)
Fritz Kreisler - Kreisler: Schön Rosmarin (User: melons)
Carl Philipp Emanuel Bach - Solfeggio No. 1 in C Minor, Wq. 117/2, H. 220 (User: melons)
Caterina Valente - Bongo Cha Cha Cha (User: melons)
Keeley Forsyth - Debris (User: melons)
Kate NV - Plans (User: melons)
Luther Vandross - The Christmas Song (User: melons)
Spoon - Christmas Time (Is Here Again) (User: melons)
The Magnetic Fields - Everything Is One Big Christmas Tree (User: melons)
Puddles Pity Party - Oh Holy Night (User: melons)
Wizzard - Rock 'N' Roll Winter (Loony's Tune) (User: melons)
Iggy Pop - White Christmas (User: melons)
Run the Jewels - A Christmas Fucking Miracle (User: melons)
Gruff Rhys - Post Apocalypse Christmas (User: melons)
Pharoah Sanders - Prince of Peace (User: melons)
Cocteau Twins - Frosty the Snowman (User: melons)
Galaxie 500 - Listen, the Snow is Falling (User: melons)
Seasick Steve & The Level Devils - Xmas Prison Blues (User: melons)
The Polyphonic Spree - It's Christmas (User: melons)
Patti Smith - We Three Kings (User: melons)
The Flaming Lips - Christmas at the Zoo (User: melons)
Get Well Soon - Christmas In Adventure Parks (User: melons)
Damon Locks - Keep your mind free (User: melons)
The Walkmen - The Christmas Party (feat. Nicole Sheahan) (User: melons)
Sly & Robbie - Boops (Here To Go) (User: melons)
Nevermen - Treat Em Right - Boards of Canada Remix (User: melons)
North Americans - Rivers That You Cannot See (User: melons)
Tirzah - Send Me (User: melons)
The Notwist - Al Sur (User: melons)
Wombo - Dreamsickle (User: melons)
Rostam - From The Back Of A Cab (User: melons)
Hologram Teen - Okandjambameya (User: melons)
Liars - Sekwar (User: melons)
L'Rain - Two Face (User: melons)
Moin - Right is Alright, Wrong is to Belong (User: melons)
Dehd - Loner - Protomartyr Remix (User: melons)
Marker Starling - Starved for Glamour (User: melons)
Midnight Sister - Doctor Says (User: melons)
Roy Montgomery - Apparition (User: melons)
Damon Locks - Keep your mind free (User: melons)
Immersion - Riding the Wave (User: melons)
Mega Bog - Station to Station (User: melons)
Vanishing Twin - Phase One Million (User: melons)
Cavern of Anti-Matter - melody in high feedback tones (User: melons)
Tune-Yards - hypnotized (User: melons)
Boards of Canada - Telephasic Workshop (User: melons)
Roy Montgomery - Used To (User: melons)
Laetitia Sadier - New Moon (User: melons)
Stereolab - Dimension M2 (User: melons)
Virginia Wing - I'm Holding Out For Something (User: melons)
Julia Holter - Gold Dust Woman (User: melons)
Big Red Machine - Phoenix (feat. Fleet Foxes & Anaïs Mitchell) (User: melons)
Lost Horizons - Every Beat That Passed (User: melons)
Lou Hayter - Telephone (User: melons)
Deep Sea Diver - Impossible Weight - feat. Sharon Van Etten (User: melons)
Unknown Mortal Orchestra - That Life (User: melons)
Audiobooks - LaLaLa It's The Good Life (User: melons)
Francis Lung - Bad Hair Day (User: melons)
Bess Atwell - Co-Op (User: melons)
Liz Lawrence - Drive (User: melons)
Bess Atwell - Co-Op (User: melons)
Ethan P. Flynn - The Universal Deluge (User: melons)
Gotts Street Park - Diego (User: melons)
Orlando Weeks - Bigger (User: melons)
Talk Talk - Desire - 1997 Remaster (User: melons)
Circuit des Yeux - Dogma (User: melons)
The Weather Station - Robber (User: melons)
Mogwai - Dry Fantasy (User: melons)
Liars - Big Appetite (User: melons)
Mogwai - Dry Fantasy (User: melons)
Black Country, New Road - Track X (User: melons)
Jane Weaver - Solarised - Edit (User: melons)
Black Country, New Road - Track X (User: melons)
Deradoorian - Saturnine Night (User: melons)
Moon Duo - Lost Heads (User: melons)
The Cool Greenhouse - Alexa! (User: melons)
Psychic TV - White Nights (User: melons)
Geese - Low Era (User: melons)
Amen Dunes - Feel Nothing (User: melons)
Aldous Harding - Old Peel (User: melons)
Spectral Display - It Takes a Muscle To Fall In love (User: melons)
LoneLady - Hinterland (User: melons)
Jane Weaver - The Revolution of Super Visions (User: melons)
Echo & the Bunnymen - Ocean Rain (User: melons)
Dry Cleaning - Scratchcard Lanyard (User: melons)
Diles que no me maten - La vida de alguien más (User: melons)
Vanishing Twin - The Lift (User: melons)
QUINQUIS - Adkrog (User: melons)
Beach House - Once Twice Melody (User: melons)
Cate Le Bon - Moderation (User: melons)
The Voluntary Butler Scheme - Trading Things In (User: melons)
PVA - Talks - Mura Masa Remix (User: melons)
Dur-Dur Band - Yabaal (User: melons)
Siouxsie and the Banshees - Happy House (User: melons)
Jimena Amarillo - Tremenda suerte (User: melons)
Chocolate Remix - ¿Quién Sos? (User: melons)
Karsu - Hijo De La Luna (User: melons)
Selin - Gidip Gel (User: melons)
Kay Tse - 未見過世面的招積 (User: melons)
Ajda Pekkan - Bi' Tık - Sunrise Version (User: melons)
Nicole - Valientes (User: melons)
Corina Smith - Obviamente (User: melons)
Miiesha - Price I Paid (User: melons)
Chaii - Pineapple Pizza (User: melons)
Edith Márquez - Qué Ironía (User: melons)
Bivolt - Raspa Placa (User: melons)
Eve Ai - 貪 (User: melons)
Sara Hebe - Mexico (User: melons)
Leepa - how to live (User: melons)
Joya Mooi - You Know Me Well By Now (User: melons)
Pyra - hole heart (User: melons)
Sole Gimenez - La Noche (User: melons)
Dulce Pontes - Amapola (User: melons)
Aisyah Aziz - Utopia Reimagined: Euphoria (User: melons)
Angèle - Bruxelles je t’aime (User: melons)
Zaz - Les jours heureux (User: melons)
Simi - Woman (User: melons)
Javiera Mena - Culpa (User: melons)
Serrini - I’m Fine, Thx. (User: melons)
Qrion - Your Love (User: melons)
Kuoko - Hiding In The Dark (User: melons)
9m88 - Tell Me (User: melons)
Tommy Genesis - a woman is a god (User: melons)
Maika Loubté - System (User: melons)
Amelie Siba - Ljubljana (User: melons)
Nídia - Celebration (User: melons)
Crystal Murray - Too Much to Taste (User: melons)
Joy Crookes - Trouble (User: melons)
Nova Twins - Antagonist (User: melons)
Tanya Tagaq - Tongues (User: melons)
UNiiQU3 - Microdosing (User: melons)
STAYC - STEREOTYPE (User: melons)
Andy Williams - It's the Most Wonderful Time of the Year (User: melons)
Freddie McGregor - Africa Here I Come (User: melons)
Atlas Sound - Walkabout (w/ Noah Lennox) (User: melons)
Clean Pete - Slaap Diep, Slaap Zacht (Coventry Carol) (User: melons)
K-Lone - Cape Cira (User: melons)
Kokoroko - Baba Ayoola (User: melons)
Yosui Inoue - Pi Po Pa - Remastered 2018 (User: melons)
Stan Getz - Aguas De Março (User: melons)
Susumu Yokota - Purple Rose Minuet (User: melons)
K-Lone - Yelli (User: melons)
Anchorsong - Tunis Dream (User: melons)
Jay Som - Devotion (User: melons)
Beatrice Dillon - Workaround One (User: melons)
Yasuaki Shimizu - Yume dewa (User: melons)
Falle Nioke - Loneliness (User: melons)
OB - Cob (User: melons)
Dazion - Dancing In The Future - Instrumental (User: melons)
Sfire - Sfire 1 (User: melons)
HAIM - 3 AM - Toro y Moi Remix (User: melons)
Soft Focus - Elsewhere (User: melons)
Joseph Shabason - The Fellowship (User: melons)
Arcade Fire - Morning Talk / Supersymmetry (User: melons)
Domenique Dumont - Sans cesse, mon chéri (User: melons)
Inwards - Welcome to the Gang (User: melons)
Grauzone - Eisbär (User: melons)
Murlo - Primal (User: melons)
Ryuichi Sakamoto - Tearjerker (User: melons)
Spirituals - A New Kind Of Quiet (User: melons)
Bullion - O Vermona (User: melons)
The Sea and Cake - Bird and Flag (User: melons)
Mark Sparling - See You At The Top (Short Hike) (User: melons)
Yu Su - Xiu (User: melons)
Catrin Finch - Future Strings (User: melons)
Inwards - Tottertot (User: melons)
⣎⡇ꉺლ༽இ•̛)ྀ◞ ༎ຶ ༽ৣৢ؞ৢ؞ؖ ꉺლ - ࿃ूੂ࿃ूੂੂ࿃ूੂOOOOOOOOOOOO ̟̞̝̜̙̘̗̖҉̵̴̨̧̢̡̼̻̺̹̳̲̱̰̯̮̭̬̫̪̩̦̥̤̣̠҈͈͇͉͍͎͓͔͕͖͙͚͜͢͢͢͢͢͢͢͢͢͢͢͢͢͢ͅ ooooooooo (User: melons)
Four Tet - Parallel 4 (User: melons)
Shida Shahabi - Pretty In Plums (User: melons)
Clark - Lambent Rag (User: melons)
Inwards - 19Tet (User: melons)
Built to Spill - Goin' Against Your Mind (User: melons)
