Dzeltenie Pastnieki - Sliekutēva Vaļasprieks (User: melons)
Drinking Electricity - Discord Dance (User: melons)
Playboi Carti - FlatBed Freestyle (User: melons)
Die Doraus & Die Marinas - Fred vom jupiter (User: melons)
The Door and the Window - Dads (User: melons)
Dislocation Dance - San Michelle (User: melons)
Diseño Corbusier - golpe de amistad (User: melons)
Diagram Brothers - Bricks (User: melons)
Danny & The Parkins Sisters - War (Is On Your Doorstep) (User: melons)
Danny Alias - Civil Defense - Danny (User: melons)
Blah Blah Blah - In The Army - Bonus Track (User: melons)
Confusional Quartet - Bologna rock (User: melons)
Cold Dogs in the Courtyard & Michael Sevy - Video Is Not Art (User: melons)
Ckc - 20h25 (User: melons)
Christiane F. - Heimweh (User: melons)
Chandra - Get It Out Of Your System (User: melons)
Krisma - Black Silk Stocking (User: melons)
Crash Course in Science - Cardboard Lamb (User: melons)
Cha Cha Guitri - Non non non (User: melons)
Carambolage - Lampenfieber (User: melons)
Camilla Motor - Gefahr im Tivoli - Kapote Rework (User: melons)
Brian Brain - Another Million Miles (User: melons)
Bona Dish - Actress (Rupert Version) (User: melons)
Blurt - The Fish Needs a Bike (User: melons)
Black Randy & the Metrosquad - Down At The Laundrymat (User: melons)
Biting Tongues - Heart Disease (User: melons)
The Beakers - Red Towel (User: melons)
Alain Bashung - What's In A Bird (User: melons)
Bal Paré - Venuszepter (User: melons)
Bene Gesserit - Parlez-Vous Francais? (User: melons)
The Anemic Boyfriends - Guys Are Not Proud (User: melons)
Baby Buddha - Little Things (User: melons)
Eminem - Kill You (User: melons)
Baard - Life In A Goldfish Bowl (User: melons)
JAY-Z - Kill Jay Z (User: melons)
Kendrick Lamar - King Kunta (User: melons)
Childish Gambino - Me and Your Mama (User: melons)
Death Grips - Get Got (User: melons)
OFWGKTA - Forest Green (feat. Mike G) (User: melons)
The Dancing Cigarettes - Broken Windows (User: melons)
Action Bronson - Dmtri (User: melons)
Ruth - Polaroid / Roman / Photo (User: melons)
Madvillain - Accordion (User: melons)
Ash Wednesday - Love by Numbers (User: melons)
The Astronauts - Sod Us (User: melons)
Frank Ocean - Novacane (User: melons)
Art Bears - Civilization (User: melons)
Freddie Gibbs - Scottie Beam (User: melons)
Roberto Cacciapaglia - My Time (User: melons)
Earl Sweatshirt - Shattered Dreams (User: melons)
Essendon Airport - Lost in Madagascar (User: melons)
Tyler, the Creator - LUMBERJACK (User: melons)
...and the Native Hipsters - There Goes Concorde Again (User: melons)
Amoebas In Chaos - Designer Genes (User: melons)
Alesia Cosmos - pat'lin d'merde (User: melons)
Veronique Vincent - Chez les Aborigènes (User: melons)
Des Airs - Lovely Lady Of The Roses - CGS (User: melons)
After Dinner - The Room Of Hair Mobiles (User: melons)
3 Teens Kill 4 - 5/4 (User: melons)
Asphixiation - l'acrostique d'amour (User: melons)
The 49 Americans - Heritage (User: melons)
48 chairs - Snap It Around (User: melons)
Icehouse - Great Southern Land (User: melons)
Hoodoo Gurus - What's My Scene - 2005 Remaster (User: melons)
Dead Katz - Casual Buddy (User: melons)
virginia aveline - Nothing Loves a Dog in the Wild (User: melons)
Blair - bug or flea (User: melons)
Earth Moon Transit - Trondheim (User: melons)
weltraumrauschen - No Human (User: melons)
Flowertown - The Lake (User: melons)
Flowertown - The Lake (User: melons)
simian cyborg - Chalk Knob Hollow (User: melons)
SwallowTail - Pocketstones (User: melons)
CLOTHESLINE FROM HELL - Love & Basketball (User: melons)
Aldo Fisk - New Girl (User: melons)
Occult Modem Settings - Bugman (User: melons)
Grog Organ - Toerag (User: melons)
Gretchen Grimm - Bad Day (User: melons)
laceleaf - come down (User: melons)
argo nuff - Paul's Chains. (User: melons)
Salt Meadow - our presence is eternal on mountains unknown (User: melons)
Jack Brady - Air (User: melons)
being awone - fond (User: melons)
Skippie - James Dean (User: melons)
Scoutmaster - November (User: melons)
Saltlick - steel phantom (User: melons)
Vivi Milne - Double Headed Deer (User: melons)
lemon meringue die - BOYSUGAR (User: melons)
Greg Horbal - shrug (User: melons)
BabyHead - LingerLonger (User: melons)
soft idiot - beforing (User: melons)
sharkkymarky - Being Dead Is Still Better than Being Me (User: melons)
The Goalie’s Anxiety at the Penalty Kick - We Love You So Much (User: melons)
sharkkymarky - Being Dead Is Still Better than Being Me (User: melons)
Daniel Johann - City Smells (User: melons)
Androgynous Mind - juanita (User: melons)
Dan Darrah - Look Away (User: melons)
Poorly Drawn House - Paulina's Spine (User: melons)
100% - The Second Book (User: melons)
apistat commander - this is not what is meant to be (User: melons)
Crashblossoms - i missed you so much that i bought vegan groceries & watered my plants (User: melons)
Freya Juliane - this time is the real time that i mean it (User: melons)
Soupy - Sunlight (User: melons)
hysterla - the pictures on my phone are all of you (User: melons)
YOWLER - Go (User: melons)
Yours Are The Only Ears - Low (User: melons)
Yesol - Sea She'll (User: melons)
wished bone - hubbub (User: melons)
Whitney Ballen - Rainier (User: melons)
Thanks For Coming - me, missing you (User: melons)
tall friend - guts (User: melons)
Soupy - Sunlight (User: melons)
The Helicopter of the Holy Ghost - Slow Down (Edit) (User: melons)
Sonoda - Goodbye (User: melons)
Secret Pool - Hall of Shame (User: melons)
Sadurn - clementine (User: melons)
R.L. Kelly - the voices (User: melons)
really big pinecone - Big Plans (User: melons)
puppy problems - Tecate / Tylenol (User: melons)
Ollie Quinn - Astronaut Song (User: melons)
Morgan Powers - Take the Train Alone (User: melons)
Moon Racer - Princess Jasmine In The Hourglass (User: melons)
Misty Moon - Nu-Moon (User: melons)
Merce Lemon - Corners of Bedrooms (User: melons)
Lizard Kisses - old friend (User: melons)
Knifeplay - Tears (User: melons)
Julie Doiron - Dance Me (User: melons)
Jessica Risker - I See You Among The Stars (User: melons)
i tried to run away when i was 6 (but got too scared to cross the street) - Don't Look at Me I Don't Like It (User: melons)
Isabella Fortuna - a fool for my demon (User: melons)
Ian Sweet - Pink Marker 2 (User: melons)
Hungry Cloud Darkening - I Am Seen (User: melons)
Harmony Tividad - where you sink (User: melons)
hann cassady - The Floor of My Messy Bedroom Reminds Me Me of How I Felt Before We Met (User: melons)
girl valley - body, etc (User: melons)
Gabby's World - Folly (User: melons)
Free Cake For Every Creature - Took A Walk (User: melons)
Freak Slug - Bend (User: melons)
Flowergirl - a short poem for a long year (User: melons)
Emily Yacina - Bleachers (User: melons)
Eliza Moon - Tell Me / Why'd You (User: melons)
Eerie Summer - Breakdown (User: melons)
clara joy - Time Is Running Out (User: melons)
Chloe Frances - Otto (I Miss You) (User: melons)
Chloe Frances - Otto (I Miss You) (User: melons)
CBMC - Pile Cans Up (User: melons)
BOOSEGUMPS - MARCH SADNESS (User: melons)
beverly tender - Saltine Complex (User: melons)
beetle bee - Kool Boy (User: melons)
Baby Mollusk - salty slush (User: melons)
Ada Lea - the party (User: melons)
Yeah Wings - The Promise Bison (User: melons)
Yard Dog - Quit It (User: melons)
Wine Tears - letters (User: melons)
Winded - Teething (User: melons)
Will Henriksen - Guitar (User: melons)
weyndt - Bleed (User: melons)
weird fingers - tardes em que eu passei observando as moscas que se chocavam contra as lâmpadas (User: melons)
Try the pie - please!please!please! (User: melons)
Tough Boy - timing (User: melons)
Toddler - Restless (User: melons)
Tobias - Head (User: melons)
Thread Mountain - Sunset Manor (User: melons)
The Lake at Night - Emptiness (User: melons)
sun is poison - yorick (User: melons)
sundots - be (User: melons)
sulkr - U Ruined My Life (User: melons)
Steven Leftovers - Exercise in Confidence (User: melons)
Spring Onion - i did my taxes for free online (User: melons)
Spartan jet-plex - Liable (User: melons)
Regret Will Come - Mayoi (User: melons)
postcard nowhere - i drove to your house with broken headlights (just to hear your voice) (User: melons)
Poor You - A Product of Efficiency (User: melons)
Occult Modem Settings - Like Like Like (User: melons)
Poor You - A Product of Efficiency (User: melons)
pitychild - i shouldn't be this sad (User: melons)
Ok Pilocase - Fly (User: melons)
Nurse Manhattan - Why Aren't U Online? (User: melons)
Nick Brobak - Silver Wine (User: melons)
Naomi Alligator - Dreamer (User: melons)
the most beautiful images (created only to be destroyed) - my heart hurt (User: melons)
MOLLY DRAG - Out Like a Light (User: melons)
MJ Lenderman - Basketball #2 (User: melons)
Mean Spirit'd Robots - dreaming of el toro (User: melons)
margot whipps - Freezer (User: melons)
Marbling - entitlement (User: melons)
lots of hands - choco sponge pud (User: melons)
Look Mom, I'm on TV! - I DON'T BELONG (User: melons)
Lion Detective Club - Slide (User: melons)
leor miller - born on tuesday (User: melons)
Laptop Funeral - Don't Lie to Me (User: melons)
Julia Brown - 'im falling in love' (User: melons)
Joyer - Here (User: melons)
i love to surf - choke in my sleep (User: melons)
Hood - The Day to Stand Alone (User: melons)
Hollow Comet - The Way I Wanted To (User: melons)
Hold Music - six four (User: melons)
Henderson Century - Oh (User: melons)
Halloween Costume Contest - A Panic Attack at a Halloween Party (User: melons)
flunkie - Good Again (User: melons)
father truck - Lost (User: melons)
Empress - Don't Give Up On Me (User: melons)
Eating Cake With Friends - Break Broke Broken (User: melons)
Depressica - Fondly (User: melons)
delay in orbit - Emacs Bismuth (User: melons)
deathcrash - Slowed (User: melons)
david attias - this will hurt someone (User: melons)
Cult Film - Mona (User: melons)
Computer Dating - A Hollow Needle (User: melons)
community college - People Pleaser (User: melons)
Colin Miller - Vice (User: melons)
the carpet store - dinner in the car (User: melons)
Canary Room - Don't Die (User: melons)
Camp Counselor - Museum of Broken Relationships (User: melons)
Bunny Love - Odessa (User: melons)
BeerbellyJake - Adolescent (User: melons)
bark dog - Caused U Pain (User: melons)
Amelia Cry Til I Die - (It's So Good to Be Alone) (User: melons)
A Country Western - On Edge (User: melons)
55 Deltic - You Could Own an American Home (User: melons)
ylayali - little caterpillar graveyard (User: melons)
Wishing - eight months (User: melons)
Unrecovery - Movies (User: melons)
Told Slant - Low Hymnal (User: melons)
The Loners With Parentheses - I See Are Seeing Me (User: melons)
Thanksgiving - Home Alone (User: melons)
Talons' - my life as a broke-ass conor oberst (User: melons)
Spook Houses - Old Folks (User: melons)
Sowet - Secret Boy (User: melons)
Sadurn - Advil (User: melons)
Redding Hunter - Strange Eyes (User: melons)
Punty - Tummy (User: melons)
puking in yr ex-girlfriends bed - I Loved You (User: melons)
Fraternal Twin - Skin Gets Hot (User: melons)
Ness Lake - When You Feel Nothing (User: melons)
Mother Evergreen - House Fire (User: melons)
Mineral Girls - The Most Recent Addition To (User: melons)
mathew lee cothran - cherry high (User: melons)
Kitchen - town (User: melons)
Jesus the Dinosaur - Cigarettes (User: melons)
Jordaan Mason - another war (User: melons)
i know who you are and you are nothing - i didn't give a fuck (User: melons)
Haunted Houses - Night Of Pan (User: melons)
German Error Message - Everything is scary (User: melons)
Friendship - Clairvoyant (User: melons)
Fraternal Twin - Skin Gets Hot (User: melons)
Foozle - Sofa Couch (User: melons)
Fog Lake - farther reaches (User: melons)
F.F. Ivanovski - Home (User: melons)
Family Restaurant - Warmer Than the Lake (User: melons)
Drowse - Klonopin (User: melons)
Drive Me Home Please - haha shit (User: melons)
Dead Sullivan - wishuwerehere (User: melons)
Cooking - bummer (User: melons)
Computer Science - Blackceiling (User: melons)
Chatterton - Who Were You (User: melons)
Cal Fish - Big Problem! (User: melons)
breaking - Callow (User: melons)
Tina Turner - I Can't Stand the Rain - 2015 Remaster (User: melons)
Broken Beak - Mire (User: melons)
Bellows - Am I? Or Was I? Because I (User: melons)
Hello Shark - Seven Hundred (User: melons)
Attic Abasement - Sorry About Your Dick (User: melons)
A Wonderful - under cover(s) (User: melons)
Occult Modem Settings - Doubled-Edged Convenience (User: melons)
Carla Bruni - Quelqu'un m'a dit (User: melons)
Lord of the Lost - Drag Me To Hell (User: melons)
Alien Ant Farm - Smooth Criminal (User: melons)
Juice WRLD - Conversations (User: melons)
BTS - Butter (User: melons)
Carfax Abbey - Cry Little Sister (User: melons)
E'LAST - Dangerous (User: melons)
Patrice Rushen - Haven't You Heard (User: melons)
Aaliyah - Are You That Somebody (User: melons)
Herbert - So Now… (User: melons)
Kano - I'm Ready (User: melons)
Sheila E. - The Glamorous Life (User: melons)
Slick Rick - Children's Story (User: melons)
Giuseppe Verdi - La Traviata / Act 1: Libiamo ne'lieti calici (User: melons)
The Kid LAROI - STAY (with Justin Bieber) (User: melons)
Lil Nas X - INDUSTRY BABY (feat. Jack Harlow) (User: melons)
You'll Never Get to Heaven - Vapor Frames (User: melons)
Glass Animals - Heat Waves (User: melons)
Joel Corry - OUT OUT (feat. Charli XCX & Saweetie) (User: melons)
You'll Never Get to Heaven - Beyond the Clouds (User: melons)
Drake - Fair Trade (with Travis Scott) (User: melons)
Central Cee - Obsessed with You (User: melons)
Faul & Wad Ad - Changes - Timmy Trumpet Remix (User: melons)
Drake - Girls Want Girls (with Lil Baby) (User: melons)
Ed Sheeran - Shivers (User: melons)
The Tymes - Ms. Grace - Rerecorded (User: melons)
Bauer - Connected (User: melons)
Inner Wave - Bower (User: melons)
Bowery Electric - Empty Words (User: melons)
Mere of Light - Bower of Bliss (User: melons)
Taylor Swift - Shake It Off (User: melons)
Duke & Jones - Trenches (User: melons)
Megan Thee Stallion - Body (User: melons)
Camo & Krooked - Turn Up (The Music) (User: melons)
Miley Cyrus - The Climb (User: melons)
Funkdoobiest - Lost In Thought (User: melons)
Ramson Badbonez - February - Whateva Da Weatha (User: melons)
Thrice - Under A Killing Moon (User: melons)
Times of Grace - Rescue (User: melons)
Rammstein - Mein Herz brennt (User: melons)
Ghost - Faith (User: melons)
Jonathan Young - In the Dark of the Night (User: melons)
Vended - Asylum (User: melons)
Knuckle Puck - Untitled (User: melons)
McBusted - What Happened to Your Band (User: melons)
Blossoms - Like Gravity (User: melons)
Times of Grace - To Carry The Weight (User: melons)
Versus Me - Obsolete (User: melons)
Ghost - Infestissumam (User: melons)
The Waltones - downhill (User: melons)
Rodney Allen - Glastonbury (User: melons)
The Church Grims - Plaster Saint (User: melons)
Fizzbombs - Surfaround (User: melons)
The Revolving Paint Dream - Sun, Sea, Sand (User: melons)
Nick Heyward - Kite (User: melons)
Metro Trinity - Michael Furey (User: melons)
Bubblegum Splash - 18:10 to Yeovil Junction (User: melons)
Emily - Mad Dogs (User: melons)
Rote Kapelle - Fire Escape (User: melons)
Clouds - Village Green (User: melons)
Baby Lemonade - Real World (User: melons)
The Wilderness Children - Mrs Susan Spence (User: melons)
The Waltones - Spell It Out (User: melons)
The Flatmates - Heaven Knows (User: melons)
Murrumbidgee Whalers - Giving Way To Trains (User: melons)
Hangman's Beautiful Daughters - They Fell for Words like Love (User: melons)
The Bachelor Pad - Do It For Fun (User: melons)
The Darling Buds - Shame On You (User: melons)
Cud - Slack Time - Single Mix (User: melons)
Bob - Kirsty (User: melons)
Apple Boutique - The Ballad Of Jet Harris (User: melons)
Pale Saints - Colours And Shapes - Demo (User: melons)
The Mock Turtles - Mary's Garden (User: melons)
Blow-Up - Forever Holiday - Ediesta Version (User: melons)
Pacific - Barnoon Hill (User: melons)
The Train Set - She's Gone (User: melons)
Another Sunny Day - Anorak City (User: melons)
Prayers - Sister Goodbye (User: melons)
Thrilled Skinny - So Happy to Be Alive (User: melons)
Bradford - Tattered, Tangled And Torn (User: melons)
Choo Choo Train - High (User: melons)
The Driscolls - Julie Christie (User: melons)
The Groovy Little Numbers - Happy Like Yesterday (User: melons)
Bridewell Taxis - Lies (User: melons)
The Moss Poles - One Summer (User: melons)
The Snapdragons - The Things You Want (User: melons)
The Charlottes - Are You Happy Now? - Molesworth Version (User: melons)
The Man From Delmonte - (Will Nobody Save) Louise (User: melons)
The Popguns - Where Do You Go - Flexi Version (User: melons)
The Nivens - Yesterday (User: melons)
Unbelievable Truth - Solved (User: melons)
Cheo - Wake Up Call (User: melons)
Kinder - Feeling Gets Too Heavy (User: melons)
Nana Lourdes - Made Your Mama Cry (User: melons)
Yola - Dancing Away in Tears (User: melons)
Water From Your Eyes - "Quotations" - Single Version (User: melons)
Emily King - Distance (User: melons)
Andrew Pekler - Description of Rain (Over Frisland) (User: melons)
Tom T. Hall - That's How I Got To Memphis (User: melons)
A.r.t. Wilson - Overworld (User: melons)
The Heptones - Crystal Blue Persuasion (User: melons)
Ross From Friends - The Daisy (User: melons)
Atlas Sound - Walkabout (w/ Noah Lennox) (User: melons)
K-Lone - In The Pines (User: melons)
DellaXOZ - Where Do I Belong? (User: melons)
Ada Lea - damn (User: melons)
The Delgados - Pull The Wires From The Wall (User: melons)
Robert Plant - Little Maggie (User: melons)
Aurora Nealand & the Royal Roses - Ferry Man (User: melons)
Snooks Eaglin - Alberta (User: melons)
Donald Harrison - Hu-Ta-Nay (User: melons)
Nick Mulvey - Fever To The Form (User: melons)
Outfit - Thank God I Was Dreaming (User: melons)
Res - They-Say Vision (User: melons)
Zambri - To Keep Back (User: melons)
Jeffrey Taylor - Amateur Opening (User: melons)
Conduits - Top Of The Hill (User: melons)
Heather Woods Broderick - For Misty (User: melons)
The Naked and Famous - Young Blood (User: melons)
Atticus Ross - Immigrant Song: Karen o With Trent Reznor (User: melons)
Natalie Merchant - Carnival (User: melons)
Appaloosa - The Day (We Fell In Love) (User: melons)
Katy Perry - Firework (User: melons)
The Runaways - Cherry Bomb (User: melons)
Mylo - In My Arms (User: melons)
Ou Est Le Swimming Pool - Dance The Way I Feel (User: melons)
Clare Maguire - Ain't Nobody - Breakage's Suck It Up Mix (User: melons)
Ellie Goulding - Starry Eyed (User: melons)
Alexandra Burke - All Night Long (feat. Pitbull) - Single Version (User: melons)
Texas - Inner Smile (User: melons)
Metro Station - Shake It (User: melons)
Movie Sounds Unlimited - Theme From The X-files: I Want To Believe (User: melons)
Then Jerico - What Does It Take? (User: melons)
Bobby Hebb - Sunny (User: melons)
The Blue Nile - Soon (User: melons)
Mychael Danna - Train (User: melons)
Broken Social Scene - Love Will Tear Us Apart (User: melons)
Coldplay - Life in Technicolor (User: melons)
Susanna Hoffs - Unconditional Love (User: melons)
Rod Stewart - Young Turks - 2008 Remaster (User: melons)
Joan Armatrading - The Weakness In Me (User: melons)
Gold Sounds - Prints (User: melons)
Bloodhound Gang - Your Only Friends Are Make Believe (User: melons)
Crowded House - Fall at Your Feet (User: melons)
Empire of the Sun - Walking on a Dream (User: melons)
Shakira - Don't Bother (User: melons)
Kate Nash - Mariella (User: melons)
Passion Pit - Sleepyhead (User: melons)
Sonver - Plus 30 Minus 2 (User: melons)
Cesare Andrea Bixio - Finale - Instrumental (User: melons)
Clint Mansell - The Wrestler - Original Score (User: melons)
Enya - Caribbean Blue (User: melons)
...And You Will Know Us by the Trail of Dead - Blight Takes All (User: melons)
Fields - Charming The Flames - Single Version (User: melons)
Seachange - In (User: melons)
Johnny Flynn - Tickle Me Pink (User: melons)
Julian Cope - Bill Drummond Said (User: melons)
Leo Abrahams - 2000 Years From Now (User: melons)
Calvin Harris - I'm Not Alone (User: melons)
Mika - Rain (User: melons)
Glass Candy - Digital Versicolor (User: melons)
Freur - Doot Doot (User: melons)
The Invisible - London Girl (User: melons)
Cold War Kids - Hang Me Up to Dry (User: melons)
Sol Seppy - Slo Fuzz (User: melons)
Au Revoir Simone - Shadows (User: melons)
Sandi Sheldon - You're Gonna Make Me Love You (User: melons)
The Cure - Lovesong (User: melons)
Day for Night - Badlands (User: melons)
Slingbacks - No Way Down (User: melons)
Joyner - White Lights (User: melons)
The Homesick - Male Bonding (User: melons)
Niagara - Pendant que les champs brûlent (User: melons)
The McCluskey Brothers - Freedom Come All Ye (User: melons)
The Parrots - Maldito (User: melons)
Gravity Wheel - This Is (User: melons)
The Goldenhour - These Things (User: melons)
The Dharmas - Little Sunshine (User: melons)
Stephen Marley - Hey Baby (User: melons)
Uchu Nekoko - Hibi No Awa (User: melons)
Melt-Banana - We Will Rock You (User: melons)
Car Seat Headrest - It's Only Sex (User: melons)
William Doyle - Millersdale (User: melons)
Link Wray - Fallin' Rain (User: melons)
The Neville Brothers - Fallin' Rain (User: melons)
Father John Misty - Fallin' Rain (User: melons)
The Gun Club - Mother of Earth - Remastered 2020 (User: melons)
Niagara - L'amour à la plage (User: melons)
Ren Harvieu - Through The Night (User: melons)
Sour Widows - Tommy (User: melons)
Leroy Sibbles - Express Yourself (User: melons)
Conrad Schnitzler - 3 (User: melons)
Chris & Cosey - Walking Through Heaven (User: melons)
Cluster - Hollywood (User: melons)
Meat Whiplash - Don't Slip Up (User: melons)
Nyah Fearties - Lugton Calling / Rantin' Robbie (User: melons)
Altres - Panic (User: melons)
The Red Krayola - Victory Garden (User: melons)
The Prats - Inverness (User: melons)
Angelique Kidjo - Once in a Lifetime (User: melons)
Trost - Cowboy (User: melons)
Kaada - Mainframe (User: melons)
Abner Jay - Cocaine Blues (User: melons)
Rob Jo Star Band - Loving Machine (User: melons)
Eyeless in Gaza - Seven Years (User: melons)
Tinkerbells Fairydust - In My Magic Garden (User: melons)
Blue Cheer - Summertime Blues (User: melons)
The Savage Resurrection - Fox Is Sick (User: melons)
John Fahey - Days Have Gone By (User: melons)
Bartholme - War Sucks (2011 Sonic Boom Stereo Remaster) (User: melons)
Roger Daltrey - Is There Anybody Out There? (User: melons)
D.R. Hooker - Fall In Love (User: melons)
Fraction - Come Out Of Her (User: melons)
Blind Willie Johnson - God Moves On the Water (User: melons)
Lonnie Johnson - Flood Water Blues (User: melons)
Charley Patton - High Water Everywhere, Part. 1 (User: melons)
The Scrotum Poles - Pick The Cat's Eyes Out (User: melons)
Johnny Thunders - You Can't Put Your Arms Round a Memory (User: melons)
The Chocolate Watchband - Baby Blue (User: melons)
The Gun Club - Sex Beat (User: melons)
Laurel & Hardy - The Trail of the Lonesome Pine (User: melons)
p - I Save Cigarette Butts (User: melons)
PinkPantheress - Pain (User: melons)
Farruko - Pepas (User: melons)
Niagara - Pendant que les champs brûlent (User: melons)
Guts - Penda (User: melons)
Pendant - Blood Rite (User: melons)
Diners - fifteen on a skateboard (User: melons)
Alpha Blondy - Seba Allah Y'e (User: melons)
St. Beethoven - Superfuzz - Original Mix (User: melons)
Superfuzz - Sobredosis (User: melons)
Autonomics - Superfuzz (User: melons)
Aoife Nessa Frances - Blow Up (User: melons)
Andrekza - TÉ (feat. Carlos Sadness) (User: melons)
The Woodentops - Good Thing (User: melons)
Terry - Take Me To The City (User: melons)
Boris - Kagero (User: melons)
Blind Melon - No Rain (User: melons)
Mariah Carey - Emotions (User: melons)
A Certain Ratio - Flight - The Graveyard (User: melons)
Bone Thugs-N-Harmony - Tha Crossroads (User: melons)
This Heat - Sleep (User: melons)
Cass McCombs - That's That (User: melons)
Adrianne Lenker - anything (User: melons)
The Orion Experience - Adrianne (User: melons)
Robin Williams - Adrian Cronauer - Pt. 1 (User: melons)
The Midnight Hour - Questions (User: melons)
Herman Düne - I wish that I could see you soon (User: melons)
The Sound - Sense of Purpose (User: melons)
Butcher Boy - I Could Be In Love With Anyone (User: melons)
The Wonder Stuff - There, There My Dear (User: melons)
Kodaline - Perfect World (User: melons)
Butcher Boy - Helping Hands (User: melons)
Godspeed You! Black Emperor - Bosses Hang, Pt. I (User: melons)
Dr. Alimantado - Just the Other Day (User: melons)
Stephen Fretwell - Run (User: melons)
The Lathums - How Beautiful Life Can Be - Single Version (User: melons)
Robbie Williams - It's Only Us (User: melons)
The Lilac Time - Return To Yesterday (User: melons)
The Duckworth Lewis Method - Meeting Mr Miandad (User: melons)
Hamish Hawk - The Mauritian Badminton Doubles Champion, 1973 (User: melons)
Robbie Williams - The Road to Mandalay (User: melons)
Guy Chambers - The Road to Mandalay (User: melons)
Brian Tyree Henry - Love's Gonna Pick You Up (User: melons)
Abra - PULL UP (User: melons)
Frank Virgilio - 1 Dime of Love (User: melons)
Bodie Lee - Freedom Flash (User: melons)
Kornum - Summer Gruuv (User: melons)
Cowboy Junkies - Sweet Jane (User: melons)
Hank Mizell - Jungle Rock (User: melons)
Susan Cadogan - Hurt So Good (User: melons)
Sister Nancy - Bam Bam (User: melons)
Central Line - Walking Into Sunshine - Edit (User: melons)
Hamilton Leithauser - Here They Come (User: melons)
Dirty Old Ann - TURN ME ON - Full Vocal Club Mix (User: melons)
The Big Dish - Prospect Street (User: melons)
Candidate - The Eye Of The Cyclone (User: melons)
Juca Chaves - Take me back to Piauí (User: melons)
Pluto Shervington - Dat (User: melons)
Mates of State - I Want To Run (User: melons)
Timi Yuro - Insult to Injury (User: melons)
Tocotronic - Hi Freaks (User: melons)
Tonbandgerät - Irgendwie anders (User: melons)
Shortstraw - Couch Potato (User: melons)
Central Line - Walking Into Sunshine - Original Larry Levan 12" Mix (User: melons)
Satellite Stories - Campfire (User: melons)
Druques - Não Assim (User: melons)
toddle - Sack Dress (User: melons)
NUMBER GIRL - 透明少女 (User: melons)
bloodthirsty butchers - Escape (User: melons)
The Blasters - Dark Night (User: melons)
Montrose - Rock Candy (User: melons)
Little Feat - Willin' (User: melons)
Lobo - I'd Love You to Want Me (User: melons)
Donny Hathaway - Jealous Guy (Studio Version) (User: melons)
The Spinners - The Rubberband Man (User: melons)
England Dan & John Ford Coley - Love Is The Answer (Single Version) (User: melons)
Al Stewart - Year of the Cat (User: melons)
Foghat - Slow Ride (User: melons)
Andrew Gold - Lonely Boy (User: melons)
Orleans - Dance with Me (User: melons)
Seals And Crofts - Summer Breeze (User: melons)
The Count Bishops - Teenage Letter (User: melons)
Eggs Over Easy - Face Down In the Meadow (User: melons)
Ducks Deluxe - Something's Going On (User: melons)
Brinsley Schwarz - Surrender To The Rhythm (User: melons)
Die Toten Hosen - Tage wie diese (User: melons)
Les Rallizes Dénudés - White Awakenning - Version 2 (User: melons)
Teenage Fanclub - The Sun Won't Shine on Me (User: melons)
Teenage Fanclub - Fallin' (User: melons)
Big Star - In The Street (User: melons)
Evan Dando - The Ballad Of El Goodo (User: melons)
Guided by Voices - Motor Away (User: melons)
Dion - Little Diane (User: melons)
The Elegants - Little Star (User: melons)
Frankie Avalon - Why (User: melons)
Halloween Sound Effects - Sad Monster Piano (User: melons)
The Chantels - Maybe (User: melons)
Nolan Strong and The Diabl... - The Wind (User: melons)
Vince Taylor - Jet Black Machine (User: melons)
Chas McDevitt Skiffle Group - Freight Train (feat. Nancy Whiskey) (User: melons)
The Silhouettes - Get a Job (User: melons)
Cranes Skiffle Group - The Banana Boat Song (User: melons)
Jack Scott - The Way I Walk (User: melons)
DeFord Bailey - John Henry (User: melons)
Françoise Hardy - Viens (User: melons)
Harpers Bizarre - Witchi Tai To - Remastered Version (User: melons)
Let's Active - Every Word Means No (User: melons)
Mink DeVille - Venus Of Avenue D (User: melons)
Faust - The Sad Skinhead (User: melons)
Pale Saints - Sight of You (User: melons)
Dave Edmunds - Girls Talk (User: melons)
Peter Ivers - Love Is A Jungle (User: melons)
Times of Grace - Worlds Apart (User: melons)
Harmonia - Deluxe (Immer weiter) (User: melons)
The Soft Boys - Insanely Jealous (User: melons)
Sallie Ford & The Sound Outside - I Swear (User: melons)
The Music Tapes Present: Songs of the Orbiting Human Circus - The Sea of Tranquility (User: melons)
Ooberman - Shorley Wall (User: melons)
The Soft Boys - I Wanna Destroy You (User: melons)
The Fiery Furnaces - Tropical Ice-Land (User: melons)
The Wrens - Happy (User: melons)
Beulah - Emma Blowgun's Last Stand (User: melons)
Eric B. & Rakim - Don't Sweat the Technique (User: melons)
Prince - Girls & Boys (User: melons)
Massive Attack - Teardrop (User: melons)
Morrissey - Suedehead (User: melons)
Cream - Sunshine of Your Love (User: melons)
T99 - Anasthasia (User: melons)
Public Image Ltd. - Public Image - Remastered (User: melons)
Barry Ryan - Magical Spiel (User: melons)
Manic Street Preachers - Love's Sweet Exile - Remastered (User: melons)
Wham! - Wake Me Up Before You Go-Go (User: melons)
Elvis Presley - That's All Right (User: melons)
The Upsetters - Return of Django (User: melons)
Johnny & The Hurricanes - Beatnik Fly (User: melons)
Aphex Twin - On (User: melons)
Salt-N-Pepa - Push It (User: melons)
Steve "Silk" Hurley - Jack Your Body - 1986 Club Mix (User: melons)
Bruce Springsteen - Racing in the Street (User: melons)
Evelyn "Champagne" King - Love Come Down - Single Version (User: melons)
Guy Mitchell - Rock-a-Billy (with Jimmy Carroll) (User: melons)
The Impressions - I'm So Proud - Single Version (User: melons)
The Impressions - It's All Right - Single Version (User: melons)
Aphex Twin - Come to Daddy (Pappy mix) (User: melons)
Odyssey - Use It Up and Wear It Out - Radio Version (User: melons)
UB40 - Food For Thought (User: melons)
Alpinestars - Burning Up (User: melons)
Senseless Things - Too Much Kissing (User: melons)
Chris Andrews - Girl Don't Come (User: melons)
Lorraine Silver - Lost Summer Love (User: melons)
Paul Revere & The Raiders - Just Like Me (User: melons)
The Standells - Dirty Water (stereo) (User: melons)
Barbara Lewis - Hello Stranger (User: melons)
The Mojos - Everything's Alright (User: melons)
The Fleetwoods - Tragedy (User: melons)
Billy Fury - Collette (User: melons)
Jade Bird - Candidate (User: melons)
Chloe Moriondo - I Eat Boys (User: melons)
Loretta Lynn - One's on the Way (feat. Margo Price) (User: melons)
Valerie June - Fallin' (User: melons)
Adrian Younge - Light on the Horizon (User: melons)
Ashnikko - Daisy (User: melons)
Kiwi Jr. - Maid Marian's Toast (User: melons)
Raymond Antrobus - Happy Birthday Moon (User: melons)
Johnny Burnette & The Rock 'n' Roll Trio - The Train Kept A Rollin' (User: melons)
Pizzagirl - Sugar Ray (User: melons)
Lazarus Kane - Milk at My Door (User: melons)
Wych Elm - scolds bridle (User: melons)
King Adora - Big Isn't Beautiful (User: melons)
Fluffy - Crossdresser (User: melons)
The Morning Benders - Excuses (User: melons)
Pussy Galore - Nothing Can Bring Me Down (User: melons)
The Amps - She's a Girl (User: melons)
The Amps - Pacer (User: melons)
Lick - Stand Up! (User: melons)
Boss Hog - Jus So Ya No (User: melons)
Electrafixion - Lowdown (User: melons)
Thousand Yard Stare - O-O Aet (User: melons)
Midway Still - Better Than Before (User: melons)
Kitchens of Distinction - Drive That Fast (User: melons)
Th' Faith Healers - Reptile Smile (User: melons)
Dr. Phibes & House Of Wax Equations - Sugarblast (User: melons)
Sonic Youth - Teen Age Riot (album version) (User: melons)
The Polyphonic Spree - Soldier Girl (User: melons)
Goatsnake - Innocent (User: melons)
Amen - Coma America - Single Version (User: melons)
Max Tundra - Lights (User: melons)
Lupine Howl - Vaporizer (User: melons)
Pharoahe Monch - Simon Says (User: melons)
Del The Funky Homosapien - Missing Link (feat. Dinosaur Jr.) - Remastered LP Version (User: melons)
Primal Scream - I'm Losing More Than I'll Ever Have (User: melons)
The Third Eye Foundation - For All the Brothers and Sisters (User: melons)
The Third Eye Foundation - Lions Writing the Bible (User: melons)
The Third Eye Foundation - A Galaxy of Scars (User: melons)
The Enormous Room - I Don't Need You (User: melons)
The Claim - gullible's travels (User: melons)
Janitors - Good To Be The King (User: melons)
Pop Will Eat Itself - Mesmerized (User: melons)
Biff Bang Pow! - Love's Going Out of Fashion (User: melons)
The Jasmine Minks - World's No Place (User: melons)
14 Iced Bears - Inside (User: melons)
The Brillant Corners - Meet Me on Tuesdays (User: melons)
Mercury Rev - The Dark Is Rising (User: melons)
Belle & Sebastian - If You Find Yourself Caught In Love (User: melons)
Belle & Sebastian - I'm A Cuckoo (User: melons)
Belle & Sebastian - Step Into My Office, Baby (User: melons)
Belle & Sebastian - FUNNY LITTLE FROG (User: melons)
Belle and Sebastian - The Party Line (User: melons)
Belle & Sebastian - Lazy Line Painter Jane (User: melons)
Leila - Won't You Be My Baby, Baby (feat. Luca Santucci) (User: melons)
Mac DeMarco - My Kind of Woman (User: melons)
Leila - Feeling (feat. Donna Paul) (User: melons)
Leila - Little Acorns (feat. Khemahl and Thaon Richardson) (User: melons)
Roar - Poor Grammar (User: melons)
Roar - Christmas Kids (User: melons)
Roar - I Can't Handle Change (User: melons)
John Grant - Rhetorical Figure (User: melons)
Current Joys - Kids (User: melons)
Current Joys - Blondie (User: melons)
Jack Stauber - Buttercup (User: melons)
Jack Stauber - Oh Klahoma (User: melons)
Grouplove - Back In the 90's (User: melons)
Harmless - Swing Lynn (User: melons)
Salvia Palth - I Was All Over Her (User: melons)
Cults - Always Forever (User: melons)
Gigi - Sometimes (backwood) (User: melons)
Steve Lacy - Dark Red (User: melons)
Muroki - Wavy (User: melons)
Rex Orange County - Loving Is Easy (User: melons)
The Weather Prophets - Almost Prayed (User: melons)
Timmy Thomas - Why Can't We Live Together (User: melons)
The Weather Prophets - Worm In My Brain (User: melons)
The Band of Holy Joy - Rosemary Smith (User: melons)
Yeah Yeah Noh - Another Side To Mrs Quill (User: melons)
The Raincoats - Fairytale in the Supermarket (User: melons)
Tad - Leafy Incline (User: melons)
The Cateran - Traffic Drone (User: melons)
Chris Cohen - In a Fable (User: melons)
Devendra Banhart - Fancy Man (User: melons)
Foxygen - Follow The Leader (User: melons)
Los Mambo Jambo - Fuego Cruzado (User: melons)
Melvins - Lizzy (User: melons)
DBFC - Get It All (User: melons)
The Coathangers - Watch Your Back (User: melons)
Wipers - Over The Edge (User: melons)
The Primitives - Lazy (User: melons)
Another Sunny Day - Anorak City (User: melons)
The Sea Urchins - Pristine Christine (User: melons)
Hurrah! - Around And Around (When In Rome) (User: melons)
Manic Street Preachers - Rewind the Film (feat. Richard Hawley) (User: melons)
The June Brides - Just The Same (User: melons)
McCarthy - Celestial City (User: melons)
Stump - Buffalo (User: melons)
Mighty Mighty - Law (User: melons)
The Mighty Lemon Drops - Happy Head (User: melons)
Swans - Time Is Money (Bastard) (User: melons)
Johnny Nash - Stir It Up (User: melons)
Jerry Lee Lewis - Great Balls of Fire (User: melons)
AC/DC - Back in Black (User: melons)
Bow Wow Wow - C30 C60 C90 Go (User: melons)
The Who - Pictures Of Lily - Single Mix / Mono Version (User: melons)
Dexys Midnight Runners - There There My Dear (User: melons)
Hot Chocolate - Put Your Love in Me (User: melons)
The Upsetters - Return of Django (User: melons)
David Cassidy - Daydreamer (User: melons)
Bo Diddley - Bo Diddley Is a Lover (User: melons)
ABC - Poison Arrow (User: melons)
Johnnie Ray - Walkin' My Baby Back Home (User: melons)
The Shangri-Las - Leader of the Pack (User: melons)
Vera Lynn - Auf Wiederseh'n, Sweetheart (User: melons)
Small Faces - All Or Nothing (User: melons)
Doris Day and Frankie Laine - Sugarbush (User: melons)
Frankie Laine - High Noon (User: melons)
Rosemary Clooney - Half As Much (with Percy Faith & His Orchestra) (User: melons)
Guy Mitchell - Feet up (Pat Him on the Po Po) (User: melons)
Bing Crosby - The Isle Of Innisfree - Single Version (User: melons)
The Monkees - For Pete's Sake (Closing Theme) - 2007 Remaster (User: melons)
The Beatles - Savoy Truffle - Remastered 2009 (User: melons)
Manic Street Preachers - She Is Suffering - Remastered (User: melons)
Manic Street Preachers - You Love Us (User: melons)
Dinosaur Jr. - Start Choppin' (User: melons)
Arrested Development - People Everyday (User: melons)
Jimmy Murphy - Granpaw's Cat (User: melons)
The Rolling Stones - Miss You - Remastered (User: melons)
Thunderclap Newman - Something In The Air (User: melons)
Millie Small - My Boy Lollipop (User: melons)
Max Bygraves - Cowpuncher's Cantata (User: melons)
The Lovin' Spoonful - She Is Still A Mystery - 2003 Remaster (User: melons)
Blur - She's so High - 2012 Remaster (User: melons)
Manic Street Preachers - She Is Suffering - Remastered (User: melons)
Manic Street Preachers - She Is Suffering - Remastered (User: melons)
Bob Dylan - Hurricane (User: melons)
Soulwax - Much Against Everyone's Advice (User: melons)
Andrew Roachford - The way I feel (User: melons)
Siouxsie and the Banshees - Hong Kong Garden (User: melons)
Cabaret Voltaire - Landslide (User: melons)
Glen Campbell - Wichita Lineman - Remastered 2001 (User: melons)
Ice Cube - Once Upon a Time in the Projects (User: melons)
Biff Rose - Fill Your Heart (User: melons)
Wee Papa Girl Rappers - Wee Rule (User: melons)
Public Enemy - Can't Do Nuttin' for Ya, Man! (User: melons)
Amadou & Mariam - Filaou Bessame (User: melons)
Dinosaur Jr. - Puke + Cry (User: melons)
Manic Street Preachers - She Is Suffering - Remastered (User: melons)
White Denim - Just Dropped In (To See What Condition My Condition Is In) (User: melons)
Yak - Heavens Above (User: melons)
The B-52's - Give Me Back My Man (User: melons)
Jonathan Richman - Velvet Underground (User: melons)
Nick Cave & the Bad Seeds - God Is In The House - 2011 Remastered Version (User: melons)
Carly Simon - Why - 12" Version (User: melons)
The Dylans - Grudge (User: melons)
Public Enemy - Shut Em Down (User: melons)
MILCK - Quiet (User: melons)
The Halluci Nation - R.E.D. (User: melons)
Public Enemy - Rebel Without a Pause (User: melons)
Public Enemy - Fight the Power (User: melons)
The Isley Brothers - Fight the Power (User: melons)
Honeybus - I Can't Let Maggie Go (User: melons)
The Shamen - Ebeneezer Goode - beat edit (User: melons)
The Cure - Close to Me (User: melons)
Gat Decor - Passion - Naked Edit (User: melons)
Davy Graham - Angi (User: melons)
Sabrina Johnston - Peace (User: melons)
Ricky Nelson - Hello Mary Lou (Goodbye Heart) (User: melons)
Iron Butterfly - In-a-gadda-da-vida - Single Version (User: melons)
Chicks On Speed - We Don't Play Guitars (User: melons)
Nick Lowe - Heart Of The City (User: melons)
The Pointer Sisters - Dirty Work (User: melons)
The Orielles - Space Samba (Disco Volador Theme) (User: melons)
The Jaynetts - Sally Go Round The Roses (User: melons)
Yo La Tengo - Here Comes My Baby (User: melons)
King Curtis - A Whiter Shade Of Pale - Live at Fillmore West, 3/7/1971 (User: melons)
Rocket from the Crypt - On a Rope (User: melons)
Smoking Popes - Need You Around (User: melons)
Tame Impala - Remember Me (User: melons)
Curtis Mayfield - We Got To Have Peace (User: melons)
Judy Henske - High Flying Bird (User: melons)
Gang of Four - I Found That Essence Rare (User: melons)
Mac DeMarco - I've Been Waiting For Her Demo (User: melons)
The Jellies - jive baby on a saturday night (User: melons)
Norma Tanega - Walkin' My Cat Named Dog (User: melons)
Look Blue Go Purple - Cactus Cat (User: melons)
The Donays - Devil In His Heart (User: melons)
Nick Cave - Disco 2000 - Pub Rock Version - previously unreleased (User: melons)
Stephen Malkmus - Jo Jo's Jacket (User: melons)
Richard Dawson - Lily (User: melons)
Milo - Don't Hate Me (User: melons)
Hüsker Dü - Pink Turns to Blue (User: melons)
Young Disciples - Apparently Nothin' - Edit (User: melons)
The Woodentops - Well Well Well (User: melons)
Small Faces - All Or Nothing (User: melons)
The Woodentops - Get It On (User: melons)
R.E.M. - Talk About the Passion (User: melons)
Del Shannon - Runaway (User: melons)
Ed Harcourt - Sister Renee (User: melons)
Villagers - Becoming a Jackal (User: melons)
The Beatles - Rain - Remastered 2009 (User: melons)
R.E.M. - So. Central Rain (User: melons)
Scarce - All Sideways (User: melons)
John Foxx - Burning Car (User: melons)
The Feelies - Crazy Rhythms (User: melons)
Altered Images - I Could Be Happy - 12" Version (User: melons)
Voice of the Beehive - I Say Nothing (User: melons)
Cate Le Bon - I Can't Help You (User: melons)
Juniore - Un jour ou l'autre (User: melons)
Malcolm McLaren - Double Dutch (User: melons)
Manic Street Preachers - Faster - Remastered (User: melons)
Manic Street Preachers - Imperial Bodybags (User: melons)
Lambchop - Each Time I Bring It Up It Seems to Bring You Down (User: melons)
Lambchop - Nothing but a Blur From a Bullet Train (User: melons)
Lambchop - Grumpus (User: melons)
Guillemots - Sao Paulo (User: melons)
Carwyn Ellis & Rio 18 - Duwies y Dre (User: melons)
Cotton Wolf - Ofni (User: melons)
Cotton Wolf - Ofni (User: melons)
Yr Ods - Tu Hwnt i'r Muriau (User: melons)
Whyte Horses - Tocyn (User: melons)
Ani Glass - Mirores (User: melons)
Datblygu - Y Teimlad (User: melons)
Misty's Big Adventure - The Story of Love (User: melons)
Aidan Smith - I met myself in a Bar (User: melons)
Aidan Smith - Be My How (User: melons)
Aidan Smith - You've Really Got A Hold On Me (User: melons)
Guillemots - The Basket (User: melons)
Fyfe Dangerfield - Woah! Life (User: melons)
Guillemots - Little Bear (User: melons)
The Walker Brothers - The Sun Ain't Gonna Shine Anymore (User: melons)
Fionn Regan - 1st Day Of May (User: melons)
Midlake - We Gathered In Spring (User: melons)
Rufus Wainwright - Go Or Go Ahead (User: melons)
The Walker Brothers - Make It Easy On Yourself (User: melons)
Folding Legs - Spring On 93rd Street (User: melons)
Isobel Campbell - Saturday's Gone (User: melons)
Isobel Campbell - (Do You Wanna) Come Walk With Me? (User: melons)
Isobel Campbell - Revolver (User: melons)
The Afghan Whigs - Demon in Profile (User: melons)
The Afghan Whigs - Debonair (User: melons)
The Twilight Singers - The Twilite Kid (User: melons)
The Twilight Singers - Teenage Wristband (User: melons)
The Twilight Singers - Live With Me (User: melons)
Beth Gibbons - Mysteries (User: melons)
Beth Gibbons - Tom The Model (User: melons)
Isobel Campbell - Come Undone (User: melons)
Calexico - Crystal Frontier (User: melons)
Bill Baird - I'm Not a Perfect Person (User: melons)
Bill Baird - We'll Meet Again Someday, Or We Won't (User: melons)
Bill Baird - Boomerang Grenade (User: melons)
Bill Baird - Spring Break of the Soul (User: melons)
Sea Power - Spring Has Sprung (User: melons)
Richard Swift - The Atlantic Ocean (User: melons)
Richard Swift - Lady Luck (User: melons)
Cloudy Busey - a spring fuck you (User: melons)
Department of Eagles - Noam Chomsky Spring Break 2002 (User: melons)
Painted Shield - Knife Fight (User: melons)
Kate Bush - James and the Cold Gun (User: melons)
Glen Campbell - Southern Nights (User: melons)
Nick Cave & the Bad Seeds - Something's Gotten Hold of My Heart - 2009 Remastered Version (User: melons)
Bobby Womack - Across 110th Street (User: melons)
Get Well Soon - Help To Prevent Forest Fires (User: melons)
Yuck - Get Away (User: melons)
Richard Swift - Most Of What I Know (User: melons)
King Creosote - Leslie (User: melons)
Nicolai Dunger - I'd Rather Die (User: melons)
Lou Barlow - Home (User: melons)
Fenster - Spring Break (User: melons)
Houses - Endless Spring (User: melons)
Bill Callahan - Spring (User: melons)
La Luz - Sure as Spring (User: melons)
The Grouch - Artsy (User: melons)
The Zillions - Don't Waste Your Tears On Me (User: melons)
Mary Margaret O'Hara - Body's In Trouble (User: melons)
Fanny - Ain't That Peculiar (User: melons)
Tom Tom Club - Kissin' Antonio (User: melons)
Deee-Lite - Try Me On... I'm Very You (User: melons)
Alan Vega - Wipeout Beat (User: melons)
Fat White Family - Whitest Boy On The Beach (User: melons)
Field Music - The Noisy Days Are Over (User: melons)
Clinic - Fine Dining (User: melons)
Clinic - Fantasy Island (User: melons)
Clinic - I Can't Stand The Rain (User: melons)
Clinic - I Can't Stand The Rain (User: melons)
The The - This Is The Day (User: melons)
Water Liars - Swannanoa (User: melons)
Phil Ranelin - Vibes from the Tribe (User: melons)
Teenage Fanclub - Sparky's Dream (User: melons)
The Hollies - The Air That I Breathe - 2008 Remaster (User: melons)
HAMAD KALKABA AND THE GOLDEN SOUNDS - Astadjam Dada Sare (User: melons)
The Passions - I'm in Love With a German Film Star (User: melons)
Yo La Tengo - Let's Save Tony Orlando's House (User: melons)
Danny Brown - Ain't it Funny (User: melons)
Pere Ubu - Modern Dance (User: melons)
Adrian Crowley - Long Distance Swimmer (User: melons)
Dan Deacon - True Thrush (User: melons)
Sonic Youth - Purr (User: melons)
Digable Planets - Rebirth of Slick (Cool Like Dat) (User: melons)
Magazine - Shot By Both Sides - Remastered (User: melons)
The Capitols - Cool Jerk (User: melons)
Gregory Abbott - Shake You Down (User: melons)
Animal Collective - Bluish (User: melons)
Nicolai Dunger - I'd Rather Die (User: melons)
Magazine - Sou Boy (User: melons)
W. H. Lung - Gd Tym (User: melons)
Depeche Mode - Never Let Me Down Again - Split Mix (User: melons)
The Beatles - I Want You (She's So Heavy) - Remastered 2009 (User: melons)
Pere Ubu - Modern Dance (User: melons)
The Rolling Stones - Wild Horses (User: melons)
Tanya Donelly - The Storm (User: melons)
Mick Jagger - Memo From Turner (User: melons)
Tanya Donelly - Long Long Long (User: melons)
Aztec Camera - The Boy Wonders (User: melons)
The Beatles - Long, Long, Long - Remastered 2009 (User: melons)
The Beatles - Glass Onion - Remastered 2009 (User: melons)
Prince - I Would Die 4 U (User: melons)
Adam and the Ants - Physical (You're So) - Single Version (User: melons)
The Auteurs - Show Girl (User: melons)
Tom Tom Club - Genius of Love (User: melons)
Manic Street Preachers - Motorcycle Emptiness - Remastered (User: melons)
Ben Folds Five - Underground (User: melons)
The Charlatans - Crashin' In (User: melons)
The Charlatans - Then (User: melons)
The Belle Stars - Sign Of The Times (User: melons)
Manic Street Preachers - Roses in the Hospital (User: melons)
Manic Street Preachers - Life Becoming a Landslide (User: melons)
Manic Street Preachers - Yourself (User: melons)
Manic Street Preachers - La Tristesse Durera (Scream to a Sigh) (User: melons)
Manic Street Preachers - From Despair to Where (User: melons)
Manic Street Preachers - She Is Suffering - Remastered (User: melons)
Whipping Boy - Tripped (User: melons)
Prince - When You Were Mine (User: melons)
Grandaddy - A.M. 180 (User: melons)
Public Image Ltd. - This Is Not A Love Song - 2011 - Remaster (User: melons)
Jonathan Richman - Velvet Underground (User: melons)
The Wedding Present - Everyone Thinks He Looks Daft (User: melons)
808 State - Olympic (User: melons)
Sparks - Beat the Clock (User: melons)
The Martha's Vineyard Ferries - MC Modern (User: melons)
Alfie - Montevideo (User: melons)
Jane's Addiction - Jane Says (User: melons)
The Smiths - This Charming Man - 2011 Remaster (User: melons)
The Smiths - There Is a Light That Never Goes Out - 2011 Remaster (User: melons)
The Smiths - Bigmouth Strikes Again - 2011 Remaster (User: melons)
Antony and the Johnsons - I fell in love with a dead boy - live (User: melons)
Swell Maps - Read About Seymour (User: melons)
Antony and the Johnsons - I fell in love with a dead boy - live (User: melons)
Swell Maps - Read About Seymour (User: melons)
File Under Pop - Heathrow (User: melons)
Kenny Rogers & The First Edition - Just Dropped In (To See What Condition My Condition Is In) (User: melons)
Hookworms - Negative Space (User: melons)
Tricky - Black Steel (User: melons)
Jason Isbell - Elephant (User: melons)
Phosphorescent - Song For Zula (BBC Radio Performance 2013) (User: melons)
Captain Beefheart & His Magic Band - Too Much Time (User: melons)
Astrid - Distance (User: melons)
Frankie Goes to Hollywood - The Power of Love (User: melons)
