Ann Sorel - La poupée des Favellas (User: melons)
Frank Gérard - Comme une samba (User: melons)
Sylvia Fels - Corto Maltese (User: melons)
Isabelle De Funès - Jusqu'à la tombée du jour (User: melons)
Jean-Pierre Sabar - vai vai (User: melons)
Marpessa Dawn - Le Petit Quica (User: melons)
Billy Nencioli - Si Rien Ne Va (User: melons)
Jean Constantin - Pas Tant De D'chichi Ponpon (User: melons)
Sophia Loren - De Jour En Jour (User: melons)
Christiane Legrand - HLM et ciné roman (User: melons)
Isabelle Aubret - Casa Forte (User: melons)
Les Masques - Il Faut Tenir (User: melons)
The Books - Fralite (User: melons)
Sparrow and the Workshop - Over the Water (User: melons)
Conquering Animal Sound - The Future Does Not Require (User: melons)
Bee, Brien & Louie - Two By Two (User: melons)
Sylvie Testud - L'Italie (User: melons)
Robbie Curtice - Gospel Lane (User: melons)
John Pantry - Red Chalk Hill (User: melons)
La France - L'Italie (User: melons)
Peter and the Wolves - Little Girl Lost & Found (User: melons)
La France - L'Angleterre (User: melons)
The Kinsmen - Glasshouse Green, Splinter Red (User: melons)
Fugu - L'Allemagne (User: melons)
Fm Laeti - Gimme love and truth (User: melons)
Mariama - Easy way out (User: melons)
Lise - Where is my mind (User: melons)
Pauline Croze - Dans la ville (User: melons)
Maissiat - Tropiques (User: melons)
PEAKS - Thank You (User: melons)
Elista - La Part De Toi (User: melons)
Tété - Nus Là-Bas (User: melons)
Alan Corbel - Children Of The Sun (User: melons)
Applause - All about you (User: melons)
Séverin - The Edge of a Sunday (Breakbot Remix) (User: melons)
Naive New Beaters - La Onda (User: melons)
Brigitte - I Want Your Sex (User: melons)
Naive New Beaters - La Onda (User: melons)
Mai Lan - Schumacher (User: melons)
FAUVE - 4.000 îles (User: melons)
Le Prince Miiaou - Be silent (User: melons)
Team Ghost - Curtains (User: melons)
Pony Pony Run Run - Everywhere I go (User: melons)
Coming Soon - Woman in Love (User: melons)
Lilly Wood & The Prick - Where I Want to Be (California) (User: melons)
Lisa Portelli - Les Chiens Dorment (User: melons)
Bertrand Belin - Hypernuit (User: melons)
Mon Eléphant - J'voudrais qu'on m'annule (User: melons)
Pixies - Wave of Mutilation (User: melons)
Nicola Són - Je voudrais me divertir (User: melons)
Rover - Father I can't explain (User: melons)
Dominique A - Contre un arbre (User: melons)
Corazon Rebelde - De quoi j'me mèle (User: melons)
Caroline Loeb - Narcissique (User: melons)
Cristina - La poupée qui fait non (User: melons)
Casino Music - Burger City - French Version (User: melons)
Guillaume Serp - Danser à Berlin (User: melons)
Todd Rundgren - Couldn't I Just Tell You (User: melons)
Octobre - Nos Amis d'Europe (User: melons)
Suicide Romeo - Suicide Romeo (User: melons)
Marie et les garçons - Attitudes - Remastered (User: melons)
Lizzy Mercier Descloux - Mission impossible (User: melons)
Modern Guy - Electrique Sylvie (User: melons)
Helena Noguerra - Lunettes noires (User: melons)
Lio - Seules Les Filles Pleurent (User: melons)
Suicide Romeo - Moderne Romance (User: melons)
Guillaume Serp - Toi et moi à Rome (User: melons)
Casino Music - Amour Sauvage (User: melons)
Guillaume Serp - Toi et moi à Rome (User: melons)
Casino Music - Amour Sauvage (User: melons)
Bella Vista - Mister Wong (User: melons)
Jacno - Rectangle (User: melons)
Lio - Veste du Soir (User: melons)
Caroline Loeb - A Malibu (User: melons)
Mathématiques Modernes - Disco Rough (User: melons)
Elli & Jacno - Je T'aime Tant (User: melons)
Artefact - Be Bop Logic (User: melons)
Marie Et Les GarÇons - Re Bop (User: melons)
Quail Club & The West Saugerties Ale - Love Lost (User: melons)
LP.ORG - The Ballad Of The Opening Band (User: melons)
Frankie Lee - Times Like This (User: melons)
Chan Poling - Chrome Lipstick (User: melons)
Chris Mars - When I Fall Down (User: melons)
A Winged Victory for the Sullen - We Played Some Open Chords and Rejoiced, for the Earth Had Circled the Sun Yet Another Year (User: melons)
The Young Fresh Fellows - Slim's Place (User: melons)
John Eller - Girlfriend (User: melons)
Peter Holsapple - Laugh It Up (It's All A Big Joke Anyway) (User: melons)
Lucero - From The Git Go (User: melons)
Jeff Tweedy - The Ballad Of The Opening Band (User: melons)
The Young Fresh Fellows - Loud Loud Loud Loud Guitars (User: melons)
Patterson Hood And The Downtown Rumblers - Hate This Town (User: melons)
You Am I - Ain't Exactly Good (User: melons)
Frank Black & The Suicide Commandos - The King & Queen (User: melons)
Deer Tick / Scott Lucas / Vanessa Carlton - From The Git Go (User: melons)
John Doe - Just For The Hell Of It (User: melons)
Joe Henry - Taken On The Chin (User: melons)
Jakob Dylan - Ain't No Fair (In A Rock 'N' Roll Love Affair) (User: melons)
Tim O'Reagan - Cozy (User: melons)
The Minus 5 - Rockin' Here Tonight (User: melons)
Tommy Keene - Nowheres Near (User: melons)
Lucinda Williams - Partners In Crime (User: melons)
Craig Finn - Isn't It? (User: melons)
Steve Earle - Times Like This (User: melons)
Chris Mars - Radio Hook Word Hit (User: melons)
The Replacements - Busted Up (User: melons)
BossaCucaNova - You Know My Name (Look Up The Number) (User: melons)
Vitor Araújo - Paul's Piano Intro (User: melons)
Filhos da Judith - Suzy Parker (User: melons)
Manfred - Hear Me Lord (User: melons)
Maria Gadú - Let It Down (User: melons)
Tortú - Wah Wah (User: melons)
Mú Carvalho - All Things Must Pass (User: melons)
Paula Marchesini - TeddY Boy (User: melons)
Nenê Benvenuti - For You Blue (User: melons)
Fagner - The Long and Winding Road (User: melons)
Ultraje A Rigor - One After 909 (User: melons)
Danni Carlos - I've Got a Feeling (User: melons)
Operação Tequila - Maggie Mae (User: melons)
Ivan Lins - Let It Be (User: melons)
Astronauta Pinguim - Dig It (User: melons)
Wanderléa - I Me Mine (User: melons)
Rodrigo Santos - Across The Universe (User: melons)
Biquini Cavadão - Dig a Pony (User: melons)
Leoni - Two of Us (User: melons)
Capital Inicial - Don't Let Me Down (User: melons)
Jota Quest - Get Back (User: melons)
Brocklesby Crooke - It Should Be Easy (User: melons)
Bamyasi - Do You Feel Ready (User: melons)
Jon Dix - A.I Sequel (User: melons)
Emerson Ware - Don’t Think (User: melons)
Wolfgang Black - All We Need Is Love (User: melons)
Badfinger - Love Is Easy (User: melons)
Liverpool Express - Smile (User: melons)
Badfinger - Love Is Easy (User: melons)
Alvin Stardust - Red Dress (User: melons)
Mud - Crazy (User: melons)
Kenny - The Bump (User: melons)
C.C.S. - The Band Played The Boogie (User: melons)
Roy Wood - Dear Elaine (User: melons)
Pilot - Call Me Round (User: melons)
Electric Light Orchestra - Showdown (User: melons)
The Crystals - Then He Kissed Me (User: melons)
Jobriath - Rock of Ages (User: melons)
De Lux - Center of L.U.B. (User: melons)
The Revolving Paint Dream - Flowers in the Sky (User: melons)
The Delgados - Under Canvas Under Wraps (User: melons)
Mild High Club - Rollercoaster Baby (User: melons)
The Isley Brothers - It's Your Thing (User: melons)
The Bobby Fuller Four - I Fought The Law - Single Version (User: melons)
The Soft Boys - Queen of Eyes (User: melons)
Tom Rush - No Regrets - 2008 Remaster (User: melons)
Donny Hathaway - Jealous Guy (User: melons)
The Bonzo Dog Band - Death Cab for Cutie - 2007 Remaster (User: melons)
Tigerbalm - Tokyo Business (User: melons)
Khidja - The Exchange (User: melons)
hollis - Bloom Indigo (User: melons)
Elles - Anthem (User: melons)
Jenny Hval - American Coffee (User: melons)
Jane Inc. - 2120 (User: melons)
Grace Ives - Shelly (User: melons)
Bones UK - Milk (User: melons)
Santi & Tuğçe - Zaman Zaman (User: melons)
Pritam - Tere Hawaale (From "Laal Singh Chaddha") (User: melons)
Nosaj Thing - Blue Hour (User: melons)
ITZY - Cheshire (User: melons)
Momma - Speeding 72 (User: melons)
Louise Verneuil - Nicotine (User: melons)
Jane Weaver - Oblique Fantasy (User: melons)
Carly Rae Jepsen - Talking to Yourself (User: melons)
Aldous Harding - Tick Tock (User: melons)
Megan Thee Stallion - Her (User: melons)
Gorgon City - Sidewindah (feat. Flirta D) (User: melons)
clipping. - nothing is safe (remx) (User: melons)
Steve Lacy - Bad Habit (User: melons)
Tigerbalm - Tokyo Business (User: melons)
Bones UK - Milk (User: melons)
Angel Olsen - All The Good Times (User: melons)
KARKARA - Proxima Centaury (User: melons)
The Detroit Cobras - Midnite Blues (User: melons)
Ice Cube - Once Upon a Time in the Projects (User: melons)
Wreckless Eric - Whole Wide World (User: melons)
The Ides Of March - Time For Thinking (User: melons)
FLO - Cardboard Box (User: melons)
Hey Colossus - The Mirror (User: melons)
50 Foot Wave - Hot Pink, Distorted (User: melons)
BC Camplight - Cemetery Lifestyle (User: melons)
The Cleaners From Venus - Incident In A Greatcoat (User: melons)
The Surfing Magazines - Voices Carry Through the Mist (User: melons)
Clinic - Walking With Thee (User: melons)
The Rolling Stones - She's A Rainbow (User: melons)
The Surfing Magazines - Voices Carry Through the Mist (User: melons)
Chloé Ferguson - City of Pages (User: melons)
Eädyth - Baby Girl (User: melons)
Mr Bewlay - Dan 'The Don' Wilson (User: melons)
Ela - Our Summer (User: melons)
Phoebe Ann - I’ll Wait For You (User: melons)
Malan - Busy Bee (User: melons)
MARED - Over Again (User: melons)
Owain Felstead - Anybody (User: melons)
Owain Felstead - Anybody (User: melons)
Bright Light Bright Light - Sensation (User: melons)
Rachel K Collier - Dinosaur (User: melons)
Euros Childs - Horse Riding (User: melons)
Meilyr Jones - How To Recognise A Work Of Art (User: melons)
Euros Childs - Horse Riding (User: melons)
Gruff Rhys - Shark Ridden Waters (User: melons)
Georgia Ruth - Close for Comfort (User: melons)
Carwyn Ellis & Rio 18 - Duwies y Dre (User: melons)
Cate Le Bon - Are You With Me Now? (User: melons)
Cian Ciarán - Martina Franca (User: melons)
Violet Skies - Half My Life (User: melons)
Eleri Angharad - Blank Walls (User: melons)
Marged - My Space (User: melons)
Audiobooks - Dance Your Life Away (User: melons)
Nia Wyn - 10 Seconds (User: melons)
Lily Donnelly - Days & Weeks (User: melons)
Megan Branwen - Whatever I Do (User: melons)
Diffiniad - Yes! (User: melons)
Safari Gold - Valley Beyond (User: melons)
Marina - About Love - From The Netflix Film “To All The Boys: P.S. I Still Love You” (User: melons)
Darkhouse Family - Journey to Love (feat. Vanity Jay) (User: melons)
Novo Amor - Anchor (User: melons)
Gulp - Game Love (User: melons)
Greta Isaac - Undone (User: melons)
Lee Dorsey - Love Lots of Lovin' (feat. Betty Harris) (User: melons)
Cadno - Ludagretz (User: melons)
Baby Queens - Red Light (User: melons)
Serol Serol - Cadwyni (User: melons)
Gwenno - Eus Keus? (User: melons)
BITW - Love is Happening! (User: melons)
Lvr - Giving Up (User: melons)
Sweet Baboo - Pink Rainbow (User: melons)
Sonny Winnebago - Take Me For A Ride (User: melons)
Otto - Boxer (User: melons)
LA Priest - What Moves (User: melons)
The School - All I Want From You Is Everything (User: melons)
Sŵnami - Trwmgwsg (User: melons)
Rosehip Teahouse - Same Sky (User: melons)
Sŵnami - Trwmgwsg (User: melons)
Omaloma - Aros o Gwmpas (User: melons)
Casi & The Blind Harpist - Lion (User: melons)
Dusky Grey - Get Easy (User: melons)
Owain Felstead - Summer Vibes (User: melons)
Noah Bouchard - Bedbound (User: melons)
Dualities - Sad Song (feat. Cally Rhodes) (User: melons)
Rebecca Hurn - Waves (User: melons)
Band Pres Llareggub - GWELD Y BYD MEWN LLIW (User: melons)
HVNTER - Just Like a Pill (User: melons)
Ifan Dafydd - Llonydd (feat. Alys Wiliams) (User: melons)
Eädyth - Disgwyl (User: melons)
FoxXglove - City (User: melons)
Macy - Cinema (User: melons)
Dusky Grey - Call Me Over (User: melons)
Lunar Bird - Siren Scales (User: melons)
Lewys - Gwres (User: melons)
Endaf - Dan Dy Draed (User: melons)
Cerys Eless - Overdose (User: melons)
Violet Skies - I'll Buy a House (User: melons)
twst - Are You Listening? (User: melons)
Jade Bird - I Get No Joy (User: melons)
Elio - Body Language (User: melons)
High Contrast - Remind Me (User: melons)
Cally Rhodes - Downfalls (User: melons)
Mantaraybryn - Tropics (User: melons)
Dead Method - Uncool (User: melons)
Marina - Orange Trees (User: melons)
jessy allen - Rushbrook (User: melons)
HANA2K - Jealousy (User: melons)
Ani Glass - Mirores (User: melons)
Hannah Grace - How True Is Your Love (User: melons)
aderyn - Silver Screen (User: melons)
Billy Lockett - Talk (User: melons)
Elio - CHARGER (ft. Charli XCX) (User: melons)
Four Hours Sleep - I Know I Shouldn't (But I Can't Help Myself) (User: melons)
Los Bitchos - The Link is About to Die (User: melons)
Lizzie No - Sweeter Than Strychnine (User: melons)
Jairus Sharif - Water & Tools (User: melons)
Emerald Hill - Todo Dia é Dezembro (User: melons)
Say Sue Me - Around You (User: melons)
Guerilla Toss - Famously Alive (User: melons)
Bodega - Thrown (User: melons)
Orbital - Dirty Rat (User: melons)
Momma - Rockstar (User: melons)
Metric - Doomscroller (User: melons)
Frankie Valli - Can't Take My Eyes Off You (User: melons)
Andy Votel - on Dogs! (User: melons)
Alfie - You Make No Bones (User: melons)
Supreme Vagabond Craftsman - All My Teeth/ North and South (User: melons)
Cherrystones - In This Maze (Take Heed) (User: melons)
Mum & Dad - Dawn Rider (User: melons)
D.O.T - Say Your Prayers (User: melons)
Misty Dixon - Headlights (And When We Drive) (User: melons)
Andy Votel - Diode (User: melons)
Alfie - Montevideo (User: melons)
Dakota Oak - I Love Buses And Girls (User: melons)
Sirconical - Moondance (User: melons)
Jackie Wilson - Lonely Teardrops (User: melons)
Matt Elliott - The Sinking Ship Song (User: melons)
Charlie Rich - Feel Like Going Home (User: melons)
Jason Bingham Noble - Last Things Last (User: melons)
Tim Hardin - How Can We Hang On To A Dream (User: melons)
Beth Nielsen Chapman - I Find Your Love (User: melons)
Conor Oberst - Mamah Borthwick (A Sketch) (User: melons)
Haris Alexiou - To Tragoudi Tou Chelidoniou (User: melons)
Camille Saint-Saëns - The Swan (Arr. Leonard Rose) (User: melons)
Coumba Gawlo - Miniyamba (User: melons)
Kath Bloom - It's So Hard To Come Home (User: melons)
Townes Van Zandt - Waitin' 'Round To Die (User: melons)
Grandaddy - Underneath The Weeping Willow (User: melons)
Bill Fay - I Hear You Calling (User: melons)
Richard Strauss - Vier letzte Lieder, TrV 296: 4. Im Abendrot (User: melons)
Lal Waterson - Columbine (User: melons)
Franz Schubert - Winterreise, Op. 89, D. 911: No. 24, Der Leiermann (Live) (User: melons)
Bonnie Raitt - All at Once (User: melons)
Paper Lace - Billy Don’t Be A Hero (User: melons)
Bill Callahan - One Fine Morning (User: melons)
Graham Nash - Simple Man (User: melons)
The Flying Burrito Brothers - Hot Burrito #1 (User: melons)
The Field Mice - Anyone Else Isn't You (User: melons)
Prefab Sprout - Bonny (User: melons)
Michael Nyman - The Departure (User: melons)
The Innocence Mission - The Brothers Williams Said (User: melons)
The Strokes - Why Are Sundays So Depressing (User: melons)
Pyotr Ilyich Tchaikovsky - 12 Morceaux, Op. 40, TH 138: 2. Chanson triste (User: melons)
The Blue Nile - Stay (User: melons)
Ooberman - Shorley Wall (User: melons)
Joe Henry - Ohio Air Show Plane Crash (User: melons)
Billie Eilish - listen before i go (User: melons)
Big Star - Thirteen (User: melons)
This Mortal Coil - You And Your Sister - Remastered (User: melons)
The Velvet Underground - Pale Blue Eyes (User: melons)
Chris Bell - You And Your Sister (Original Version) (User: melons)
The Velvet Underground - Pale Blue Eyes (User: melons)
Gustav Mahler - Rückert-Lieder: Ich bin der Welt abhanden gekommen (User: melons)
Gustav Mahler - Rückert-Lieder: Ich bin der Welt abhanden gekommen (User: melons)
The Chicks - Travelin' Soldier (User: melons)
The Waifs - London Still (User: melons)
Julie Doiron - Me and My Friend (User: melons)
The Fraser Shaw Trust - Air Chall (User: melons)
Terry Jacks - Seasons in the Sun (User: melons)
Walter Martin - The World at Night (for Stew) (User: melons)
Madam- Sukie Smith - Rope Trick (User: melons)
Leonard Cohen - You Got Me Singing (User: melons)
The Black Heart Procession - Blue Tears (User: melons)
Alan Morrissey - Groundswell (User: melons)
Bill Callahan - Eid Ma Clack Shaw (User: melons)
The Chocolate Watchband - Baby Blue (User: melons)
Max Richter - On the Nature of Daylight (User: melons)
Bob Dylan - Simple Twist of Fate (User: melons)
Ane Brun - Laid In Earth - live (User: melons)
Henry Purcell - Dido and Aeneas, Z. 626 / Act III: "When I Am Laid in Earth" Dido's Lamento (Arr. by Mathieu Herzog for Cello and Strings) (User: melons)
Jessye Norman - Dido and Aeneas: Dido's Lament (User: melons)
Johann Sebastian Bach - Partita No. 2 for solo violin in D minor, BWV 1004: Chaconne (User: melons)
Sir Edward Elgar - Salut d'amour, Op. 12 (version for orchestra) (User: melons)
The Associates - Party Fears Two (User: melons)
Madonna - White Heat (User: melons)
Bob Marley & The Wailers - Chances Are (User: melons)
Clamavi De Profundis - Where There's a Whip (There's a Way) (User: melons)
James Blake - Where's the Catch? (feat. André 3000) (User: melons)
Patrice Rushen - Where There Is Love - Remastered (User: melons)
Faster Pussycat - Where There's a Whip There's a Way (User: melons)
Madonna - Where's the Party (User: melons)
Depeche Mode - Where's the Revolution (User: melons)
Josephine Foster - Where There Are Trees (User: melons)
Willie Griffin - Where There's Smoke There's Fire (User: melons)
Smog - Left Only With Love (User: melons)
Mariza - Ó Gente Da Minha Terra (User: melons)
Muzsikás - Pásztortánc (User: melons)
John Dowland - Lachrimae Pavan, P. 15 (User: melons)
Claudio Monteverdi - Lamento della ninfa (User: melons)
Ane Brun - Another World (User: melons)
Antony and the Johnsons - Another World (User: melons)
Henryk Górecki - Symphony No. 3, Op. 36 "Symphony of Sorrowful Songs": 2. Lento e largo (User: melons)
The Weekenders - Inelegantly Wasted in Papa's Penthouse Pad in Belgravia (User: melons)
Adorable - Sunshine Smile (User: melons)
The Impossibles - The Drum - 12" Mix (User: melons)
The High - Up & Down (User: melons)
The Montgomery Clifts - Lovesville USA (User: melons)
Soul Family Sensation - I Don't Even Know If I Should Call You Baby (User: melons)
Gretel Hänlyn - Motorbike (User: melons)
Andy Bell - Love Comes In Waves (User: melons)
Paint - Flying Fox (User: melons)
Buddy Miles - I Still Love You, Anyway (User: melons)
Rahsaan Roland Kirk - Serenade To A Cuckoo (User: melons)
The Sha La Das - Sha La Da La La (Christmas Time) (User: melons)
Boxed In - All Your Love Is Gone (User: melons)
Wednesday - Perfect (Smashing Pumpkins) (User: melons)
Wunderhorse - Teal (User: melons)
Katherine Priddy - Eurydice (User: melons)
Jeffrey Lewis - Exactly What Nobody Wanted (User: melons)
Joe Strummer & The Latino Rockabilly War - Trash City (User: melons)
X-Ray Spex - Art-I-Ficial (User: melons)
Anna Calvi - Indies or Paradise (User: melons)
Kenny Knight - Whiskey (User: melons)
The Blue Aeroplanes - And Stones - 2006 Remaster (User: melons)
The Chambers Brothers - Love, Peace And Happiness (User: melons)
MJ Lenderman - Hangover Game (User: melons)
Flasher - Love Is Yours (User: melons)
Tim Burgess - Typical Music (User: melons)
Morrissey - Rebels Without Applause (User: melons)
Tim Burgess - Typical Music (User: melons)
Aldous Harding - Old Peel - Alternate Version (User: melons)
Working Men's Club - Widow (User: melons)
Oswald D'ANDREA - Habatoli Souna (User: melons)
Suicide - Cheree - 2019 - Remaster (User: melons)
The Sugarcubes - Blue Eyed Pop (User: melons)
Orange Juice - Flesh of My Flesh (User: melons)
The Pointer Sisters - Dirty Work (User: melons)
Blondie - Ring Of Fire - Live (User: melons)
Spanish Love Songs - Funeral (User: melons)
Camera Obscura - Super Trouper (User: melons)
Nico - Heroes - Alternate Mix (User: melons)
Madi Diaz - Resentment (New Feelings Version) (User: melons)
Fiona Apple - Everyday (User: melons)
Aly & AJ - I Need My Girl (User: melons)
Kacey Musgraves - Fix You (User: melons)
Relient K - Manic Monday (User: melons)
Mayday Parade - Somebody That I Used To Know (User: melons)
Aretha Franklin - Rolling in the Deep (The Aretha version) (User: melons)
The Runaways - Eight Days a Week (User: melons)
Kylie Minogue - Marry the Night (User: melons)
Red Hot Chili Peppers - I Get Around - Live (User: melons)
The Supremes - A Hard Days Night (User: melons)
Harry Styles - Cherry (User: melons)
blink-182 - Dancing With Myself (User: melons)
David Byrne - I Wanna Dance With Somebody - Live (User: melons)
Stevie Nicks - Crash into Me - Live; 2019 Remaster (User: melons)
Cyndi Lauper - Back in Your Head (User: melons)
Angie McMahon - Silver Springs (User: melons)
Patti Smith - Smells Like Teen Spirit - Radio Edit (User: melons)
David Bowie - Across the Universe - 2016 Remaster (User: melons)
Blur - Maggie May - 2012 Remaster (User: melons)
Karen O - Bullet With Butterfly Wings (From "Hanna") (User: melons)
Fountains of Wayne - ...Baby One More Time (User: melons)
Queens of the Stone Age - Goodbye Yellow Brick Road (User: melons)
The Flaming Lips - Can't Get You out of My Head - Live at KEXP (User: melons)
Doja Cat - Celebrity Skin (User: melons)
Doja Cat - Celebrity Skin (User: melons)
R.E.M. - Talk About the Passion (User: melons)
R.E.M. - Gardening at Night (User: melons)
R.E.M. - Carnival Of Sorts (Boxcars) (User: melons)
R.E.M. - Driver 8 - Remastered (User: melons)
R.E.M. - Orange Crush - Remastered 2013 (User: melons)
R.E.M. - Finest Worksong - Remastered (User: melons)
R.E.M. - Monty Got a Raw Deal (User: melons)
R.E.M. - Strange Currencies - Remastered (User: melons)
R.E.M. - Can't Get There From Here - Remastered (User: melons)
R.E.M. - Half a World Away (User: melons)
Sam Smith - Unholy (feat. Kim Petras) (User: melons)
R.E.M. - Laughing (User: melons)
R.E.M. - So. Central Rain (User: melons)
R.E.M. - Pretty Persuasion (User: melons)
R.E.M. - Green Grow The Rushes - Remastered (User: melons)
R.E.M. - She Just Wants to Be (User: melons)
Gorky's Zygotic Mynci - Let's Get Together (In Our Minds) (User: melons)
Harry Styles - As It Was (User: melons)
The Orion Experience - Adrianne (User: melons)
The Phil Jones Experience - Intercontinental (User: melons)
Moin - Yep Yep (User: melons)
Pig - Hopelessly Devoted to You (User: melons)
The Isley Brothers - This Old Heart Of Mine (Is Weak For You) (User: melons)
Maximum Balloon - Tiger (User: melons)
The Osmonds - Crazy Horses (User: melons)
The Goldberg Sisters - Shush (User: melons)
Prince - I Would Die 4 U (User: melons)
Greg Dulli - I Would Die 4 U/Baby I'm a Star (User: melons)
Blur - Tender (User: melons)
Panda Bear - Everyday (User: melons)
Viagra Boys - Troglodyte (User: melons)
Just Mustard - Still (User: melons)
Denzel Curry - Walkin (User: melons)
Moundabout - Bog Bodies (User: melons)
Elaine Howley - Archeological Longing (User: melons)
Daniel Rossen - Unpeopled Space (User: melons)
Makaya McCraven - Seventh String (User: melons)
Danger Mouse - The Darkest Part (feat. Raekwon and Kid Sister) (User: melons)
Moin - Yep Yep (User: melons)
Thank - Dread (User: melons)
New Age Doom - Holy Dub (User: melons)
Cate Le Bon - Harbour (User: melons)
Warrington Runcorn New Town Development Plan - The Key to a New Home of Your own (User: melons)
Beach House - ESP (User: melons)
Keeley Forsyth - I Stand Alone (User: melons)
The Smile - Free in the Knowledge (User: melons)
Chat Pile - Pamela (User: melons)
Snapped Ankles - Jonny Guitar Calling Gosta Berlin (User: melons)
Shabason & Krgovich - I Am So Happy With My Little Dog (User: melons)
Robocobra Quartet - Wellness (User: melons)
Felt - Down but Not Yet Out (User: melons)
The Upsetters - Popcorn (User: melons)
EERA - Ladder (User: melons)
Universal Togetherness Band - More Than Enough (User: melons)
my bloody valentine - Soon (User: melons)
Idrissa Soumaoro - Nissodia (User: melons)
Adonis - Lack of Love (Radio Mix) (User: melons)
Liam Kazar - So Long Tomorrow (User: melons)
Kate Bush - The Big Sky - Special Single Mix (User: melons)
Hot Chip - Eleanor (User: melons)
The Dismemberment Plan - Back and Forth (User: melons)
The Fantasy - Summer Night in Harlem (User: melons)
Been Stellar - Manhattan Youth (User: melons)
Quasi - Drunken Tears (User: melons)
Hotel Lux - National Team (User: melons)
Adam and the Ants - Physical (You're So) - Single Version (User: melons)
Royal Trux - Stevie (For Steven S.) (User: melons)
Screamin' Jay Hawkins - I Put a Spell on You (User: melons)
The Beach Boys - God Only Knows - Mono / 1997 Remastered (User: melons)
Can - Vitamin C (User: melons)
R.E.M. - Gardening at Night (User: melons)
The Snails - Tea Leaves (User: melons)
Du Blonde - Young Entertainment (User: melons)
Al Green - How Can You Mend a Broken Heart (User: melons)
Future Islands - Close to None (User: melons)
Future Islands - Close to None (User: melons)
Marvin Hamlisch - Nobody Does It Better (User: melons)
Spoon - You Got Yr. Cherry Bomb (User: melons)
Marvin Hamlisch - Nobody Does It Better (User: melons)
Depeche Mode - Never Let Me Down Again (User: melons)
McAlmont & Butler - Yes - Full Version (User: melons)
Pixies - Hey (User: melons)
Tom Petty and The Heartbreakers - Christmas All Over Again (User: melons)
Black Flag - My War (User: melons)
His Name Is Alive - Last Night (User: melons)
Frazier Chorus - Sloppy Heart - Edit (User: melons)
Wolf & Cub - Rozalia Bizarre (User: melons)
Jóhann Jóhannsson - Odi et Amo - Remastered (User: melons)
Tanya Donelly - Wrap-around Skirt (User: melons)
A.R. Kane - Lollita (User: melons)
Purity Ring - peacefall (User: melons)
Adrianne Lenker - anything (User: melons)
Blonde Redhead - My Plants Are Dead (User: melons)
Nation of Language - In Manhattan (User: melons)
Mdou Moctar - Nakanegh Dich (User: melons)
Branko Mataja - Tesko Mi Je Zaboravit Tebe (User: melons)
Melt Yourself Down - Balance (User: melons)
Unloved - Turn of the screw (User: melons)
The Diasonics - Gurami (User: melons)
The Mooney Suzuki - Alive & Amplified (User: melons)
Braxe + Falcon - Step By Step - 12" Version (User: melons)
Tamar Aphek - Show Me Your Pretty Side (User: melons)
Jens Lekman - A Postcard to Nina (User: melons)
Ghost Woman - Do You (User: melons)
Ghost Woman - Do You (User: melons)
LCD Soundsystem - new body rhumba (from the film White Noise) (User: melons)
Mattiel - Jeff Goldblum (User: melons)
Valla - Nuxe (User: melons)
Throwing Muses - Bright Yellow Gun (User: melons)
Kalen Elmsley - Spheroidal (User: melons)
Valla - Nuxe (User: melons)
Kalen Elmsley - Spheroidal (User: melons)
Tamara Blake - A subtle joy (User: melons)
Tamara Blake - A subtle joy (User: melons)
Maria Buehler - Between Us (User: melons)
Peter J. Malmsjö - Soft Sunrays (User: melons)
Tanisha Hickman - Feathers (User: melons)
Pelagia Calisto - Una Flor (User: melons)
Ama Hemmah - Vardo (User: melons)
Benjamin Dobbs - Wishes (User: melons)
Ever So Blue - Symbios (User: melons)
Barabás Lőrinc - 22 (User: melons)
Henri de Quengo - Correspondance Insulaire, Op. 11 (User: melons)
Projet Calmant - Je t'ai vu (User: melons)
Aija Alsina - Collecting Memories (User: melons)
Martin Rapide - Retrospect (User: melons)
Marlon Guild - Hinode (User: melons)
Aiden Kelly - For the Fallen (User: melons)
Allysium - Open Sail (User: melons)
Mathilda Skonare Karlsson - New Endings (User: melons)
Jens Wechsler - In Deinen Augen (User: melons)
Jesse Brown - Here And There (User: melons)
Miriam Raye - In your arms (User: melons)
Thibaud Fleming - My Affliction (User: melons)
Carl Fredman - Iris (User: melons)
El Pianista Manco - November Birdie (User: melons)
Klaüs - Green Leaves (User: melons)
Donnie Harman - Unchanged (User: melons)
Richard Sauzal - Coming Closer (User: melons)
Alida Sørby - Det skal nok gå (User: melons)
Emilia Branco - La douche sonore (User: melons)
Josephe Burke - Con Cariño (User: melons)
Hugo Vanbrooke - am ersten Tag (User: melons)
Franz Ewer - Hiemalis (User: melons)
Kepus - Amber (User: melons)
Adelaide Fleur - Eventus Memoria (User: melons)
Kepus - Amber (User: melons)
Asahi Haru - Yasashii (User: melons)
Kellen Chase - Meditabundus (User: melons)
Half Man Half Biscuit - It's Clichéd To Be Cynical At Christmas (User: melons)
Fruit Bats - It’s Beginning To Look Like Christmas (User: melons)
Bing Crosby - Mele Kalikimaka - Single Version (User: melons)
Dean Martin - Baby, It's Cold Outside (User: melons)
The Polyphonic Spree - It's Christmas (User: melons)
The Monkees - Unwrap You At Christmas (User: melons)
Jim Reeves - Silver Bells (User: melons)
The Sonics - Don't Believe in Christmas (User: melons)
Jona Lewie - Stop the Cavalry (User: melons)
Sweet Baboo - Don't be Alone (This Christmas) (User: melons)
Herb Alpert and the Tijuana Brass - Jesu, Joy Of Man's Desiring (User: melons)
Bob Dylan - Must Be Santa (User: melons)
Lee "Scratch" Perry - Merry Christmas Happy New Year (User: melons)
Dean Martin - Let It Snow! Let It Snow! Let It Snow! (User: melons)
Eagles - Please Come Home for Christmas - 2013 Remaster (User: melons)
Perry Como - It's Beginning to Look a Lot Like Christmas (with Mitchell Ayres & His Orchestra) (User: melons)
Calexico - Green Grows The Holly (User: melons)
Kurtis Blow - Christmas Rappin' (User: melons)
Tom Petty and The Heartbreakers - Christmas All Over Again (User: melons)
The Wombles - Wombling Merry Christmas (User: melons)
Mahalia Jackson - Silent Night, Holy Night (User: melons)
Joseph Spence - Santa Claus Is Comin' To Town (User: melons)
Pharoah Sanders - Prince of Peace (User: melons)
The Walkmen - The Christmas Party (feat. Nicole Sheahan) (User: melons)
Brenda Lee - Rockin' Around the Christmas Tree (User: melons)
Frank Sinatra - Let It Snow! Let It Snow! Let It Snow! (with The B. Swanson Quartet) (User: melons)
Bing Crosby - White Christmas (User: melons)
John Lennon - Happy Xmas (War Is Over) - Remastered 2010 (User: melons)
Elton John - Step Into Christmas (User: melons)
Wham! - Last Christmas (User: melons)
Kylie Minogue - Santa Baby (User: melons)
Bobby Helms - Jingle Bell Rock (User: melons)
Dean Martin - Let It Snow! Let It Snow! Let It Snow! (User: melons)
Andy Williams - It's the Most Wonderful Time of the Year (User: melons)
The Jackson 5 - Santa Claus Is Coming To Town (User: melons)
Slade - Merry Xmas Everybody (User: melons)
Tom Petty and The Heartbreakers - Christmas All Over Again (User: melons)
Joseph Spence - Santa Claus Is Comin' To Town (User: melons)
Tom Petty and The Heartbreakers - Christmas All Over Again (User: melons)
José Feliciano - Feliz Navidad (User: melons)
Shakin' Stevens - Merry Christmas Everyone (User: melons)
Jona Lewie - Stop the Cavalry (User: melons)
Paul McCartney - Wonderful Christmastime - Edited Version / Remastered 2011 (User: melons)
The Waitresses - Christmas Wrapping (User: melons)
Spice Girls - Stop (User: melons)
Wizzard - I Wish It Could Be Christmas Everyday (User: melons)
Chris Rea - Driving Home for Christmas (User: melons)
Tom Jones - Green Green Grass Of Home (User: melons)
Danny Williams - Moon River (User: melons)
Girls Aloud - Sound of the Underground (User: melons)
Slade - Merry Xmas Everybody (User: melons)
Elvis Presley - Return to Sender - From "Girls! Girls! Girls!" (User: melons)
Mud - Lonely This Christmas (User: melons)
Perry Como - It's Beginning to Look a Lot Like Christmas (with Mitchell Ayres & His Orchestra) (User: melons)
Faith No More - Easy (User: melons)
Bing Crosby - Mele Kalikimaka - Single Version (User: melons)
Calexico - Christmas All Over Again (User: melons)
Tom Petty and The Heartbreakers - Christmas All Over Again (User: melons)
Shakin' Stevens - Merry Christmas Everyone (User: melons)
Wham! - Last Christmas (User: melons)
Ed Sheeran - Merry Christmas (User: melons)
Donny Hathaway - This Christmas (User: melons)
Boney M. - Mary's Boy Child / Oh My Lord (User: melons)
Ryuichi Sakamoto - Merry Christmas Mr. Lawrence (User: melons)
Nina & Frederik - Little Donkey (User: melons)
Peggy Lee - The Christmas Waltz (User: melons)
Gilbert O'Sullivan - Christmas Song (I'm Not Dreaming Of A White Christmas) (User: melons)
Disco Tex & His Sex-O-Lettes - Get Dancin' (User: melons)
The Beach Boys - Little Saint Nick - 1991 Remix (User: melons)
Sly & The Family Stone - Hot Fun In The Summertime (User: melons)
Frank Black - Headache (User: melons)
The Bug Club - Christmas Lullaby (User: melons)
The Vandals - My First Christmas (as a Woman) (User: melons)
CeeLo Green - All I Need Is Love (feat. Disney's The Muppets) (User: melons)
Terry Hall - I Want a Hippopotamus for Christmas (User: melons)
The Joe Gibbs Family Of Artists (feat. Horace Andy) - Oh Little Town Of Bethlehem (User: melons)
The Ethiopians - Ding Dong Bell (User: melons)
The Kingstonians - Merry Christmas (User: melons)
Lee "Scratch" Perry - Merry Christmas Happy New Year (User: melons)
Eek-a-Mouse - The Night Before Christmas (User: melons)
Boris Gardiner - The Meaning of Christmas (User: melons)
Elton John - Step Into Christmas (User: melons)
Freddie McGregor - Come All Ye Faithful (User: melons)
The Crystals - Parade Of The Wooden Soldiers (User: melons)
Saint Etienne - I Was Born On Christmas Day (User: melons)
Slade - Merry Xmas Everybody (User: melons)
The Waitresses - Christmas Wrapping - Long version (User: melons)
Monty Python - Christmas in Heaven (User: melons)
The Waitresses - Christmas Wrapping - Long version (User: melons)
Monty Python - Christmas in Heaven (User: melons)
Bob Dylan - Must Be Santa (User: melons)
Bob Dylan - Must Be Santa (User: melons)
The Weavers - We Wish You A Merry Christmas (User: melons)
Sufjan Stevens - Put the Lights on the Tree (User: melons)
Sufjan Stevens - Put the Lights on the Tree (User: melons)
Paddy Roberts - Merry Christmas You Suckers (User: melons)
Wham! - Last Christmas (User: melons)
Andy Williams - It's the Most Wonderful Time of the Year (User: melons)
Aztec Camera - Walk Out To Winter (User: melons)
LCD Soundsystem - Christmas Will Break Your Heart (User: melons)
Aztec Camera - Walk Out To Winter (User: melons)
Mariah Carey - All I Want for Christmas Is You (User: melons)
Run–D.M.C. - Christmas In Hollis (User: melons)
Mariah Carey - All I Want for Christmas Is You (User: melons)
Danielson - Rubbernecker (User: melons)
The Charlatans - How High (User: melons)
Tom Petty and The Heartbreakers - Christmas All Over Again (User: melons)
Bob Marley & The Wailers - Coming In From The Cold (User: melons)
The Flirtations - Christmas Time Is Here Again (User: melons)
Deer Tick - Christmas All Summer Long (User: melons)
Lou Blic - Minéralité (User: melons)
Molly Burch - Holiday Dreaming (User: melons)
The Polyphonic Spree - Happy Xmas (War Is Over) (User: melons)
Slow Club - Christmas (Baby Please Come Home) (User: melons)
Why? - Auld Lang Syne (User: melons)
Mt. Joy - Every Holiday (User: melons)
Pedro the Lion - Yellow Bike (User: melons)
Feet - Vegetarian Christmas (User: melons)
Pedro the Lion - Yellow Bike (User: melons)
Sharon Van Etten - silent night (User: melons)
Goldfrapp - Winter Wonderland (User: melons)
Phoenix - Alone On Christmas Day (User: melons)
Goldfrapp - Winter Wonderland (User: melons)
The Delgados - Coming in From the Cold (User: melons)
Kishi Bashi - All I Want For Christmas Is You - Holiday Party Version (User: melons)
The Beths - Have Yourself A Merry Little Christmas (User: melons)
Camera Obscura - The Blizzard (User: melons)
U.S. Girls - Santa Stay Home (User: melons)
The Magnetic Fields - Everything Is One Big Christmas Tree (User: melons)
Marika Hackman - Driving Under Stars (User: melons)
Courtney Barnett - Boxing Day Blues (Revisited) (User: melons)
Ginger Root - Linus n' Lucy (Theme from Peanuts) (User: melons)
Remi Wolf - Last Christmas (User: melons)
Helvetia - Helvetia Xmas (User: melons)
Kramer - Winter Lady (User: melons)
Mark Dippel - Christmas In Hollis (User: melons)
Dale Crover - Christmas Time Is Here (User: melons)
Serengeti - Noël (User: melons)
Deerhoof - I Wonder As I Wander (User: melons)
Why? - The Hanukkah Blessings (User: melons)
Sleep Party People - Silent Night (User: melons)
Rob Crow - Alone In The World (User: melons)
The Ophelias - Last Christmas (User: melons)
Danielson - Visions of the Sugar Plum Fairy (User: melons)
Lou Barlow - Glittery (User: melons)
Mike Adams At His Honest Weight - It’s Christmas All Over Again (User: melons)
Kramer - Winterlong (User: melons)
No Joy - Theme from Gremlins (User: melons)
The Ophelias - Silver & Gold (User: melons)
Tall Tall Trees - Free Jazz Drummer Boy (User: melons)
C.J. Boyd - Winter Wanderer (User: melons)
Jad Fair - Baking Cookies for Santa (User: melons)
Sound of Ceres - Walking in the Air (User: melons)
Kidbug - Just Like Xmas (User: melons)
Paul Leary - We Wish You a Merry Christmas (User: melons)
JESS JOY - OkCupid Xmas (User: melons)
Why? - Auld Lang Syne (User: melons)
Bobby Burg - Little Bobby Boy (User: melons)
Stranger Cat - All I Want For Christmas Is You (User: melons)
Yoni Wolf - Rock of Ages (User: melons)
Psychic Temple - We Got to Have Peace (User: melons)
Jad Fair - The Snow Day (User: melons)
Richard Edwards - Jesus Christ (User: melons)
Sedcairn Archives - Flake Drem (User: melons)
Oneida - Christmas With The Freaks (User: melons)
Dumb Numbers - X-Mas Time in the Mountains (User: melons)
C.J. Boyd - Ode To Joy (User: melons)
No Joy - Snow (User: melons)
The Low Anthem - Fairy On The Christmas Tree (User: melons)
Danielson - Peppermint Pattycake (User: melons)
Finom - Jing-a-Ling, Jing-a-Ling (User: melons)
Psychic Temple - Hey Santa (User: melons)
Oneida - It's Chill (User: melons)
Thor Harris - Carol of the Tubular Bells (User: melons)
Eerie Wanda - Listen the Snow is Falling (User: melons)
Nick Lowe - Christmas At The Airport (User: melons)
Stranger Cat - All I Want For Christmas Is You (User: melons)
Kishi Bashi - All I Want For Christmas Is You - Holiday Party Version (User: melons)
Terry Dactyl and the Dinosaurs - Sea Side Shuffle (User: melons)
Jona Lewie - Bossa Soccer Nova (User: melons)
Jona Lewie - Louise (User: melons)
Jona Lewie - Stop the Cavalry (User: melons)
Tony Bennett - Winter Wonderland (User: melons)
Stubborn Heart - Starting Block (User: melons)
Ramones - Merry Christmas (I Don't Want to Fight Tonight) (User: melons)
Mahalia Jackson - Silent Night, Holy Night (User: melons)
Galaxie 500 - Listen, the Snow is Falling (User: melons)
Monty Python - Christmas in Heaven (User: melons)
Jim Reeves - Silver Bells (User: melons)
Kelly Clarkson - Underneath the Tree (User: melons)
The Waitresses - Christmas Wrapping - Long version (User: melons)
Fountains of Wayne - I Want An Alien For Christmas (User: melons)
The Walkmen - The Christmas Party (feat. Nicole Sheahan) (User: melons)
Paul McCartney - Wonderful Christmastime - Edited Version / Remastered 2011 (User: melons)
Best Coast - Little Saint Nick (User: melons)
The Big Thing - Tell Me Something (User: melons)
Wesley Gonzalez - Red Man Is Back Again (With A Lonely Dose of Pain) (User: melons)
The Family Baloo - Winter Garden (User: melons)
Low - Long Way Around The Sea (User: melons)
Low - Just Like Christmas (User: melons)
Belle and Sebastian - The Fox in the Snow (User: melons)
Shakin' Stevens - Merry Christmas Everyone (User: melons)
Kojo Donkoh - The Soul of Christmas (User: melons)
Kojo Donkoh - A Groovy Christmas and New Year (User: melons)
The Sonics - Don't Believe in Christmas (User: melons)
Joy Zipper - Christmas Song (User: melons)
Bauhaus - Terror Couple Kill Colonel (User: melons)
The Kinks - Did You See His Name? - Stereo Mix; 2018 Remaster (User: melons)
Dinosaur Jr. - Just Like Heaven (User: melons)
MC5 - The Human Being Lawnmower (User: melons)
Siouxsie and the Banshees - Carousel (User: melons)
Pretenders - Tattooed Love Boys - 2006 Remaster (User: melons)
David Bowie - The Jean Genie - 2013 Remaster (User: melons)
Spoon - Written In Reverse (User: melons)
Spoon - Written In Reverse (User: melons)
Jim O'Rourke - Sosej Bins A Chips (User: melons)
Pixies - Tame (User: melons)
King Khan - Born in 77 (User: melons)
Buzzcocks - Love You More - 2001 Remastered Version (User: melons)
The House of Love - Destroy the Heart - Remastered Edition (User: melons)
Peter, Paul & Mary - Boa Constrictor (User: melons)
The Cure - Subway Song (User: melons)
Television - See No Evil (User: melons)
Joe Jackson - In Every Dream Home (A Nightmare) (User: melons)
Roxy Music - In Every Dream Home a Heartache (User: melons)
Billy Swan - I Can Help (User: melons)
The Beatles - Hello, Goodbye - Remastered 2009 (User: melons)
Wild Beasts - End Come Too Soon (User: melons)
The Contours - Do You Love Me (User: melons)
Buffalo Springfield - Broken Arrow (User: melons)
Fugazi - No Surprise (User: melons)
Jamie xx - KILL DEM (User: melons)
Tanya Donelly - The Storm (User: melons)
World of Twist - The Storm (User: melons)
Djo - Gloom (User: melons)
The Lazy Eyes - Hippo (User: melons)
The Lazy Eyes - Intro (User: melons)
The Lazy Eyes - Fuzz Jam (User: melons)
The Smile - You Will Never Work in Television Again (User: melons)
Cowboyy - Gmaps (User: melons)
Yard Act - Rich (User: melons)
GoGo Penguin - Ascent (User: melons)
Oliver Sim - Romance With A Memory (User: melons)
Nilüfer Yanya - midnight sun (User: melons)
Mercury Rev - Goddess On A Hiway (User: melons)
alt-J - Hard Drive Gold (User: melons)
Kojey Radical - Payback (feat. Knucks) (User: melons)
Denzel Curry - Walkin (User: melons)
Arlo Parks - Softly (User: melons)
Momma - Speeding 72 (User: melons)
Fazerdaze - Come Apart (User: melons)
Gang of Youths - in the wake of your leave (User: melons)
Sorry - There’s So Many People That Want to Be Loved (User: melons)
Mitski - Love Me More (User: melons)
Yeah Yeah Yeahs - Burning (User: melons)
Alfie - You Make No Bones (User: melons)
Sky Ferreira - Don’t Forget (User: melons)
The Big Moon - Wide Eyes (User: melons)
Hurray For The Riff Raff - Pierced Arrows (User: melons)
Sunflower Bean - Who Put You Up To This? (User: melons)
Self Esteem - Fucking Wizardry (User: melons)
Rolling Blackouts Coastal Fever - The Way It Shatters (User: melons)
Ministry - Effigy (I'm Not An) (User: melons)
Kae Tempest - More Pressure (User: melons)
Jockstrap - Concrete Over Water (User: melons)
The Afghan Whigs - Debonair (User: melons)
The Zombies - This Will Be Our Year (User: melons)
Depeche Mode - Never Let Me Down Again (User: melons)
Grant Lee Buffalo - Fuzzy (User: melons)
Unit 4 + 2 - Concrete And Clay (User: melons)
The Beatles - You're Going To Lose That Girl - Remastered 2009 (User: melons)
Jane Wiedlin - Rush Hour (User: melons)
R.E.M. - Can't Get There From Here (User: melons)
Teenage Fanclub - What You Do To Me (User: melons)
R.E.M. - Carnival Of Sorts (Boxcars) (User: melons)
Sweeping Promises - Hunger for a Way Out (User: melons)
Four Tet - Two Thousand And Seventeen (User: melons)
The Beatles - I Want You (She's So Heavy) - Remastered 2009 (User: melons)
The Damned - Eloise (User: melons)
R.E.M. - So. Central Rain (User: melons)
Harry Nilsson - Gotta Get Up (User: melons)
The Olivia Tremor Control - A Place We Have Been To (User: melons)
The Olivia Tremor Control - Black Foliage (Animation 3) (User: melons)
The Olivia Tremor Control - Paranormal Echoes (User: melons)
The Olivia Tremor Control - I Have Been Floated (User: melons)
The Olivia Tremor Control - Black Foliage (Animation 2) (User: melons)
The Olivia Tremor Control - A New Day (User: melons)
The Olivia Tremor Control - Grass Canons (User: melons)
The Olivia Tremor Control - A Sleepy Company (User: melons)
Elvis Presley - Wear My Ring Around Your Neck (User: melons)
Bourgeois Tagg - I Don't Mind At All (User: melons)
R.E.M. - (Don't Go Back to) Rockville (User: melons)
R.E.M. - Shaking Through (User: melons)
R.E.M. - Near Wild Heaven (User: melons)
R.E.M. - Talk About the Passion (User: melons)
R.E.M. - Green Grow The Rushes - Remastered (User: melons)
R.E.M. - So. Central Rain (User: melons)
R.E.M. - (Don't Go Back to) Rockville (User: melons)
R.E.M. - All the Way to Reno (You're Gonna Be a Star) (User: melons)
R.E.M. - So. Central Rain (User: melons)
R.E.M. - 7 Chinese Bros. (User: melons)
R.E.M. - Cuyahoga - 2011 Remaster (User: melons)
R.E.M. - Radio Free Europe (User: melons)
R.E.M. - Driver 8 - Remastered (User: melons)
R.E.M. - Pretty Persuasion (User: melons)
Marijata - No Condition Is Permanent (User: melons)
Speedometer - Rubberneck (User: melons)
Shina Williams & His African Percussionists - Agboju Logun (User: melons)
Oscar Sulley & The Uhuru Dance Band - Bukom Mashie (User: melons)
Nana Kwame Ampadu - Wompe Masem (User: melons)
The Hygrades - Rough Rider (User: melons)
Manu Dibango - Soul Makossa (User: melons)
Orlando Julius - Disco Hi - Life (User: melons)
The Ogyatanaa Show Band - Disco Africa (User: melons)
Oscar Sulleys Nzele Soundz - Bukom (User: melons)
Gyedu-Blay Ambolley and His Creations - Akoko Ba (User: melons)
Vis-a-Vis - Obi Agye Me Dofo (User: melons)
Vaudou Game - Pas Contente (User: melons)
Lafayette Afro Rock Band - Malik - Remastered (User: melons)
K. Frimpong - Kyenkyen Bi Adi M'awu (User: melons)
Freedom Family - Lala Li (User: melons)
Kiki Gyan - Disco Dancer (User: melons)
Eddie Okwedy - Happy Survival (User: melons)
Sir Victor Uwaifo - Dododo - (Ekassa No. 1) (User: melons)
Rex Williams - You Are My Heart (User: melons)
The Immortals - Hot Tears (User: melons)
Eric Akaeze - Wetin de Watch Goat, Goat Dey Watcham (User: melons)
Faces - Tug of War (User: melons)
Tony Tete Harbor - Tete Muo Bu Muo (User: melons)
Chief Checker - Africa Irie (User: melons)
Dynamic Africana - Igbehin Lalayo Nta (User: melons)
Peter King - African Dialects (User: melons)
Peacocks Guitar Band - Eddie Quansa (User: melons)
Olufemi Ajasa - Aiye Le (User: melons)
Ashanti Afrika Jah - Onyame (User: melons)
Bola Johnson - Ezuku Buzo (User: melons)
Ify Jerry Krusade - Everybody Likes Something Good (User: melons)
Sir Shina Peters - Yabis (User: melons)
Jungle Fire - Comencemos (Let's Start) (User: melons)
Jon Batiste - FREEDOM (User: melons)
Swamp Dogg - Good, Better, Best (User: melons)
Don Covay & The Goodtimers - Mercy, Mercy (User: melons)
Jalen Ngonda - Just Like You Used To (User: melons)
Don Covay & The Goodtimers - Mercy, Mercy (User: melons)
The Bamboos - Hard Up (User: melons)
The Bamboos - Hard Up (User: melons)
Heatwave - Boogie Nights (User: melons)
Monophonics - Last One Standing (User: melons)
Cornelius Brothers & Sister Rose - Too Late To Turn Back Now (User: melons)
Orlando Weeks - Big Skies, Silly Faces (User: melons)
Pauline Oliveros - Sound Patterns (User: melons)
Alice Shields - Study for Voice and Tape (User: melons)
Tilman Ehrhorn - Sfaira (User: melons)
Michel Chion - Dies irae (User: melons)
Halim El-Dabh - Wire Recorder Piece (User: melons)
Pierre Schaeffer - Concert de bruit: No. 2, Étude aux chemis de fer "Imposée" (User: melons)
Joe Meek & The Blue Men - Orbit Around the Moon (User: melons)
H. Hawkline - Milk For Flowers (User: melons)
The Units - High Pressure Days (Rory Phillips Remix) (User: melons)
Rotary Connection - Sunshine Of Your Love (User: melons)
David Byrne - One Fine Day (User: melons)
Rotary Connection - Sunshine Of Your Love (User: melons)
Captain Beefheart & His Magic Band - Big Eyed Beans from Venus (User: melons)
The KLF - Madrugada Eterna - Club Mix (User: melons)
Friendly Fires - Before Your Eyes (User: melons)
Marxist Love Disco Ensemble - 1905 (User: melons)
Marxist Love Disco Ensemble - 1905 (User: melons)
Bruce Haack - Cherubic Hymn (User: melons)
Renee - Change Your Style (User: melons)
The Pop Group - Thief of Fire (User: melons)
David Behrman - Leapday Night - Scene 1 (User: melons)
The Poets of Rhythm - Smilin' (While You're Crying) (User: melons)
Bambara - Birds (User: melons)
Lou Hayter - Time Out of Mind (User: melons)
Slayyyter - Mine (User: melons)
Carl Ditters von Dittersdorf - Symphony No. 1 in C major, "Die 4 Weltalter" (The 4 Ages of the World): I. Larghetto (User: melons)
Şatellites - Seni Sen Olduğun İçin Sevdim (User: melons)
Low - Canada (User: melons)
Kraftwerk - Computer Love - 2009 Remaster (User: melons)
Low - Canada (User: melons)
Magnet - Corn Rigs (User: melons)
LoneLady - Hinterland (User: melons)
Aidan Noell - Sharevari (User: melons)
Heartworms - Consistent Dedication (User: melons)
John Grant - Boy from Michigan (User: melons)
The Primitives - Spacehead (User: melons)
Katy J Pearson - Talk Over Town (User: melons)
The Rolling Stones - She's A Rainbow (User: melons)
Sparks - Angst in My Pants (User: melons)
Flamin' Groovies - I Can't Hide (User: melons)
Kiss - Hard Luck Woman (User: melons)
Yo La Tengo - I'm So Lonesome I Could Cry (User: melons)
XTC - Life Begins At the Hop (User: melons)
Todd Rundgren - I Saw the Light - 2015 Remaster (User: melons)
Superchunk - Slack Motherfucker (User: melons)
Volcano Suns - Cover (User: melons)
Al "Carnival Time" Johnson & The Soul Apostles - Carnival Time (User: melons)
Snapper - Gentle Hour (User: melons)
Yo La Tengo - Before We Stopped To Think (User: melons)
Dominik Hauser - The Odd Couple - Theme (User: melons)
Ramones - Listen to My Heart - 2016 Remaster (User: melons)
The Velvet Underground - I Found a Reason - 2015 Remaster (User: melons)
Niagara - L'amour à la plage (User: melons)
Wesley Fuller - Change Your Mind (User: melons)
Gemma Ray - Come Caldera (User: melons)
Stefan Schultze - Return (User: melons)
The Impressions - I'm So Proud - Single Version (User: melons)
The Pastels - Nothing To Be Done (User: melons)
The Pop Group - She Is Beyond Good and Evil (User: melons)
Ella Fitzgerald - Get Ready (User: melons)
Cate Le Bon - Crab Day (User: melons)
Ice Cube - It Was A Good Day (User: melons)
Gary Wilson - 6.4 = Make Out (User: melons)
