The Smiths - Shoplifters of the World Unite - 2011 Remaster (User: melons)
The Triffids - The Seabirds (User: melons)
? & The Mysterians - 96 Tears (User: melons)
Andrea True Connection - More, More, More (User: melons)
The Jesus and Mary Chain - Sometimes Always (User: melons)
Jason Isbell - The Life You Chose (User: melons)
Nick Cave & the Bad Seeds - (Are You) The One That I've Been Waiting For? - 2011 Remastered Version (User: melons)
The Housemartins - Five Get Over Excited (User: melons)
Belle and Sebastian - The Loneliness of a Middle Distance Runner (User: melons)
The Beatles - Yes It Is - Remastered 2009 (User: melons)
The Michael Zager Band - Let's All Chant (User: melons)
The Flaming Lips - Do You Realize?? (User: melons)
Girls Aloud - Call the Shots (User: melons)
R.E.M. - Star Me Kitten (User: melons)
Sufjan Stevens - Should Have Known Better (User: melons)
Wilco - A Shot In The Arm (User: melons)
Ride - From Time to Time - Best Of Edit (User: melons)
Pet Shop Boys - Heart (User: melons)
A Girl Called Eddy - People Used to Dream About the Future (User: melons)
Ugly Cat - Empty Blast (User: melons)
Pet Shop Boys - One More Chance - 2018 Remaster (User: melons)
The Beatles - This Boy - Remastered 2009 (User: melons)
The Human League - Love Action (I Believe in Love) (User: melons)
The Beatles - We Can Work It Out - Remastered 2015 (User: melons)
The Move - Omnibus (User: melons)
Yo La Tengo - Tears Are in Your Eyes (User: melons)
Stephen Duffy - Sugar High (User: melons)
Smokey Robinson & The Miracles - The Tracks Of My Tears (User: melons)
The Isley Brothers - This Old Heart Of Mine (Is Weak For You) (User: melons)
Viktoria Tolstoy - Red Rain (User: melons)
Bee Gees - Nights On Broadway (User: melons)
Julian Cope - An Elegant Chaos (User: melons)
Elvis Presley - Too Much (User: melons)
The Beatles - Everybody's Got Something to Hide Except Me and My Monkey - Remastered 2009 (User: melons)
The Beach Boys - Wouldn't It Be Nice - Remastered 2000 / Stereo Mix (User: melons)
The Beatles - A Hard Day's Night - Remastered 2009 (User: melons)
Cream - Badge (User: melons)
Richard Harris - MacArthur Park (User: melons)
XTC - Mayor Of Simpleton - 2001 Remaster (User: melons)
Elvis Costello & The Attractions - New Amsterdam (User: melons)
The Rutles - I Must Be in Love - 2006 Remaster (User: melons)
The Kinks - All Day and All of the Night (User: melons)
Neneh Cherry - Buffalo Stance (User: melons)
Aztec Camera - Oblivious (User: melons)
Suede - So Young (User: melons)
Joe Jackson - Is She Really Going Out With Him? (User: melons)
Orange Juice - Rip It Up (User: melons)
Mika - Grace Kelly (User: melons)
Harry Nilsson - I Guess the Lord Must Be in New York City (User: melons)
The Specials - Ghost Town (User: melons)
Crowded House - Distant Sun (User: melons)
Madonna - Live to Tell (User: melons)
Pet Shop Boys - Left To My Own Devices (User: melons)
The Lilac Time - Return To Yesterday (User: melons)
Bee Gees - Love You Inside Out (User: melons)
The Colourfield - Thinking of You (User: melons)
George Michael - Fastlove, Pt. 1 (User: melons)
R.E.M. - Good Advices (User: melons)
Nina Simone - The Pusher (User: melons)
Gilbert O'Sullivan - Alone Again (Naturally) (User: melons)
sprites - Wish I'd Kept a Scrapbook (User: melons)
The Special Places - Fall 4 U (User: melons)
Darren Hanlon - Our Days in Kansas (User: melons)
Casper & the Cookies - Who Needs What (User: melons)
The Poison Control Center - The Last Song (User: melons)
Moustache of Insanity - The Punks Are Writing Love Songs (User: melons)
The Awesomelies - Godspeed (User: melons)
Master Track - DIY Queen (User: melons)
Gold-Bears - Skyway (User: melons)
The Galactic Heroes - Pop Songs Your New Boyfriend's Too Stupid To Know About (User: melons)
Folklore - Look how We Killed the Riot Grrrls (User: melons)
Fishboy - Rumble with the Gang Debs (User: melons)
L.A. Tool & Die - If You Take Away the Make Up (Then the Vampires, They Will Die) (User: melons)
Math and Physics Club - Superboy & Supergirl (User: melons)
The Smittens - Sweet (User: melons)
The Cat Empire - Two Shoes (User: melons)
Hotpants Romance - Wild Bikini (User: melons)
The Medusa Snare - Every Little Thing (User: melons)
The Besties - Our Days in Kansas (User: melons)
Iji - Josie (User: melons)
Bunnygrunt - Not Quite Burning Bridges (User: melons)
Hot Lava - Pink Lemonade (User: melons)
Dionne Warwick - What The World Needs Now (Is Love) (User: melons)
Dionne Warwick - Do You Know the Way to San Jose (User: melons)
The Evens - Cut from the Cloth (User: melons)
Micachu & The Shapes - Golden Phone (User: melons)
Micachu & The Shapes - Golden Phone (User: melons)
Lee Ranaldo - Waiting on a Dream (User: melons)
Amason - Älgen (User: melons)
Sleater-Kinney - You're No Rock n' Roll Fun (User: melons)
The Nails - Home of the Brave (User: melons)
Gang of Four - Paralysed (User: melons)
Do Nothing - New Life (User: melons)
The Raincoats - In Love (User: melons)
Martin Rev - Secret Teardrops (User: melons)
Prince Rama - So Destroyed (Channelling Rage Peace) (User: melons)
Giant Drag - Kevin Is Gay (User: melons)
The Glove - Perfect Murder (User: melons)
Public Image Ltd. - Seattle (User: melons)
Peter Bjorn and John - Objects Of My Affection (User: melons)
Japan - The Art of Parties - 2003 - Remaster (User: melons)
Japan - The Art of Parties - 2003 - Remaster (User: melons)
We Barbarians - Strange Overtones (User: melons)
The Notwist - One With the Freaks (User: melons)
Parade Ground - Moans (User: melons)
Klaus Johann Grobe - Between the buttons (User: melons)
Echo & the Bunnymen - Do It Clean (User: melons)
Carpenters - All I Can Do (User: melons)
The Orielles - Sugar Tastes Like Salt (User: melons)
Cornelius - Point of View Point (User: melons)
Nicolas Godin - Orca (User: melons)
The Lemonheads - Big Gay Heart (User: melons)
Bauhaus - Third Uncle - Single Edit (User: melons)
Warmduscher - Fatso (User: melons)
Clinic - Voodoo Wop (User: melons)
Black Moth Super Rainbow - Jump Into My Mouth and Breathe the Stardust (User: melons)
Sault - Stop Dem (User: melons)
Mike Patton - Ore d'amore (User: melons)
Joe Jackson - Another World (User: melons)
The Byker Grove Fan Club - Accountant (User: melons)
Kraftwerk - The Model - 2009 Remaster (User: melons)
The Isley Brothers - Ohio / Machine Gun (User: melons)
The Cars - Just What I Needed (User: melons)
Jacques Dutronc - L'Espace D'Une Fille (User: melons)
The Damned - Eloise (User: melons)
Roxy Music - Re-Make/Re-Model (User: melons)
Mary Wells - Whisper You Love Me Boy - Single Version (User: melons)
Fabrizio De André - Primo Intermezzo (User: melons)
Riton - Let's Stick Around (Feat. Jarvis Cocker) (User: melons)
Chime School - Taking Time to Tell You (User: melons)
Mr Jukes - Grant Green (User: melons)
The Magnetic Fields - Strange Powers (User: melons)
FOONYAP - Woolf and Plath (User: melons)
Herbie Hancock - Bring Down The Birds - Outtake (User: melons)
Bow Wow Wow - Go Wild in the Country (User: melons)
The Magnetic Fields - A Chicken With Its Head Cut Off (User: melons)
Q.a.s.b. - The Jet Leg (User: melons)
The Crayon Fields - Mirror Ball (User: melons)
The Magnetic Fields - Andrew In Drag (User: melons)
Topper - Hapus (User: melons)
Divinyls - I Touch Myself (User: melons)
The Sugarcubes - Walkabout (User: melons)
Fiction Factory - (Feels Like) Heaven (User: melons)
Eugene McGuinness - Shotgun (User: melons)
Sparks - Angst in My Pants (User: melons)
Wire - Eardrum Buzz - 12" Version (User: melons)
Orchestral Manoeuvres in the Dark - Extended Souvenir - 2003 Digital Remaster (User: melons)
John Lennon - Working Class Hero - Remastered 2010 (User: melons)
Memes - Second Thought (User: melons)
Clinic - Distortions (User: melons)
R.E.M. - Romance (User: melons)
Bill Callahan - Too Many Birds (User: melons)
Shuggie Otis - Strawberry Letter 23 (User: melons)
Nolan Porter - If I Could Only Be Sure (User: melons)
Tom Waits - Temptation (User: melons)
Talking Heads - Psycho Killer (User: melons)
Wire - Two People In A Room - 2006 Remastered Version (User: melons)
Goat - Let It Burn (User: melons)
The Youngbloods - Get Together (User: melons)
Sufjan Stevens - John Wayne Gacy, Jr. (User: melons)
Jacqueline Taieb - Bravo (User: melons)
Shop Assistants - Train From Kansas City (User: melons)
Andrew Lloyd Webber - Jacob and Sons / Joseph's Coat (User: melons)
David Hasselhoff - Jump In My Car (User: melons)
Billy Ocean - Love Really Hurts Without You (User: melons)
Madonna - Holiday (User: melons)
Prince - 1999 - Edit (User: melons)
Kid Cudi - Day 'N' Nite - Crookers Remix (User: melons)
Shanice - I Love Your Smile (User: melons)
The Stranglers - Golden Brown (User: melons)
a-ha - Take On Me (User: melons)
Shirley Bassey - Spinning Wheel - 1994 Remaster (User: melons)
P.P. Arnold - The First Cut Is the Deepest (User: melons)
Rocketship - Let's Go Away (User: melons)
The Zombies - Care of Cell 44 (User: melons)
The Passions - I'm in Love With a German Film Star (User: melons)
Danny Brown - Grown Up (User: melons)
The Drifters - You Got To Pay Your Dues (User: melons)
The Lemonheads - Mallo Cup (User: melons)
Veronica Falls - Shooting Star (User: melons)
Ghostpoet - Many Moods At Midnight (User: melons)
Jean-Claude Vannier - La horse - Bande originale du film "La horse" (User: melons)
Paris Street - Screen Prints (User: melons)
Mike Patton - Deep Down (User: melons)
Toots Thielemans - Theme from "Midnight Cowboy" (User: melons)
Ella Fitzgerald - Get Ready (User: melons)
Chic - I Want Your Love - 2018 Remaster (User: melons)
The Band - The Weight - Remastered 2000 (User: melons)
The Magnetic Fields - Busby Berkeley Dreams (User: melons)
Oceanic - Insanity - Dream Tripper Old Skool Radio Edit (User: melons)
Leland - I've Got Some Happiness (User: melons)
Them - It's All Over Now, Baby Blue (feat. Van Morrison) (User: melons)
Young Fathers - In My View (User: melons)
The Magnetic Fields - I Don't Believe in the Sun (User: melons)
Holiday Ghosts - Off Grid (User: melons)
Amadou & Mariam - Sabali (User: melons)
Au Pairs - We're So Cool (User: melons)
Sergio Mendes & Brasil '66 - For What It's Worth (User: melons)
The Jackpots - Jack in the Box (User: melons)
Woody Guthrie - This Land Is Your Land (User: melons)
Davie Jones and the King Bees - Liza Jane (User: melons)
Lorraine Ellison - Stay With Me (User: melons)
David Holmes - I Heard Wonders (User: melons)
The Cowsills - The Rain The Park And Other Things (User: melons)
Silver Apples - Oscillations (User: melons)
The Fall - Lost In Music (User: melons)
Lil' Kim - Big Momma Thang (User: melons)
Le Tigre - Deceptacon (User: melons)
Broadcast - Echo's Answer (User: melons)
Yo La Tengo - Autumn Sweater (User: melons)
Pavement - Summer Babe (User: melons)
R.E.M. - Nightswimming (User: melons)
PJ Harvey - Rid of Me (User: melons)
Blur - Girls & Boys (User: melons)
Sonic Youth - Tunic (Song for Karen) (User: melons)
Craig Mack - Flava In Ya Ear Remix (feat. Notorious B.I.G., L.L. Cool J, Busta Rhymes, Rampage) (User: melons)
The Orb - Little Fluffy Clouds (User: melons)
Salt-N-Pepa - Shoop (User: melons)
Radiohead - Karma Police (User: melons)
Will Oldham - I See a Darkness (User: melons)
A Tribe Called Quest - Check the Rhime (User: melons)
The Aztec Mystic - Knights of Jaguar (User: melons)
Missy Elliott - The Rain (Supa Dupa Fly) (User: melons)
R.E.M. - It's the End of the World as We Know It (and I Feel Fine) (User: melons)
Bikini Kill - Rebel Girl (User: melons)
my bloody valentine - Only Shallow (User: melons)
Built to Spill - Carry the Zero (User: melons)
Weezer - Say It Ain't So (User: melons)
No Doubt - Just a Girl (User: melons)
R.E.M. - Losing My Religion (User: melons)
Spice Girls - Wannabe (User: melons)
Orbital - Halcyon And On And On (User: melons)
Galaxie 500 - Fourth of July (User: melons)
Michael Farneti - The River (User: melons)
George Formby - Leaning On a Lamp Post (User: melons)
George Formby - When I'm Cleaning Windows (User: melons)
Michael Jackson - Love Never Felt So Good (User: melons)
Bruno Mars - 24K Magic (User: melons)
Robin Williams - Prince Ali - Remastered 2022 (User: melons)
Jonas Brothers - What A Man Gotta Do (User: melons)
Girls Aloud - Love Machine (User: melons)
The Rembrandts - I'll Be There For You (theme from "Friends') (User: melons)
Darius - Colourblind (User: melons)
Labrinth - Earthquake (feat. Tinie Tempah) (User: melons)
SIX - Get Down (User: melons)
McFly - Sink or Sing (User: melons)
Little Mix - Wings (User: melons)
DJ Fresh - Golddust - Original Mix (User: melons)
Gayla Peevey - I Want a Hippopotamus for Christmas (Hippo the Hero) (User: melons)
Elton John - Ho! Ho! Ho! (Who'd Be A Turkey At Christmas) (User: melons)
Fountains of Wayne - I Want An Alien For Christmas (User: melons)
Stevie Wonder - What Christmas Means to Me (User: melons)
Booker T. & the MG's - Silver Bells (User: melons)
Mariah Carey - All I Want for Christmas Is You (User: melons)
Eartha Kitt - Santa Baby (with Henri René & His Orchestra) (User: melons)
The Pogues - Fairytale of New York (feat. Kirsty MacColl) (User: melons)
Pretenders - 2000 Miles - 2007 Remaster (User: melons)
Ella Fitzgerald - Have Yourself a Merry Little Christmas (User: melons)
Solomon Burke - Presents for Christmas (User: melons)
Chuck Berry - Run Rudolph Run (User: melons)
Shakin' Stevens - Merry Christmas Everyone (User: melons)
Run the Jewels - A Christmas Fucking Miracle (User: melons)
The Pointer Sisters - Dirty Work (User: melons)
Blurt - The Fish Needs a Bike (User: melons)
Handsome Boy Modeling School - The Truth (User: melons)
Stubborn Heart - Starting Block (User: melons)
Echo & the Bunnymen - Rescue (User: melons)
Talking Heads - Burning Down the House (User: melons)
Sleater-Kinney - I Wanna Be Your Joey Ramone (User: melons)
Du Blonde - Medicated (User: melons)
Manic Street Preachers - You're Tender and You're Tired (User: melons)
Gang of Four - To Hell With Poverty (User: melons)
Toydrum - Biological Clockwork (The Train) (User: melons)
Robbie Robertson - Somewhere Down the Crazy River (User: melons)
The Beatles - While My Guitar Gently Weeps - Anthology 3 Version (User: melons)
R.E.M. - Sitting Still (User: melons)
R.E.M. - Horse to Water (User: melons)
R.E.M. - Fall On Me - 2011 Remaster (User: melons)
R.E.M. - Radio Free Europe (User: melons)
R.E.M. - Laughing (User: melons)
R.E.M. - Half a World Away (User: melons)
R.E.M. - Crush With Eyeliner - Remastered (User: melons)
R.E.M. - World Leader Pretend - Remastered (User: melons)
R.E.M. - All the Way to Reno (You're Gonna Be a Star) (User: melons)
R.E.M. - Country Feedback (User: melons)
R.E.M. - Life And How To Live It - Remastered (User: melons)
R.E.M. - Orange Crush - Remastered 2013 (User: melons)
R.E.M. - Wolves, Lower (User: melons)
R.E.M. - Moral Kiosk (User: melons)
R.E.M. - Near Wild Heaven (User: melons)
Bang Gang - Find What You Get (User: melons)
Blancmange - What's The Time? (User: melons)
The Love Singers - All You Need Is Love (User: melons)
Uzimon - New York City (User: melons)
K Gabrielle - I'm Losing You (User: melons)
Jonathan Frith - Beautiful Boy (User: melons)
Felt - Primitive Painters (User: melons)
Paper Cutouts - Working Class Hero (User: melons)
Bailey Outerbridge - Revolution (User: melons)
Mia Chambray - Don't Let Me Down (User: melons)
Biggie Irie - Woman (User: melons)
Rachel Brown - Watching the Wheels (User: melons)
Heather Nova - Norwegian Wood (User: melons)
Rhino Edwards - Come Together (User: melons)
Errol Reid - Borrowed Time (User: melons)
Christina Frith - Julia (User: melons)
Bailey & Tallula Tzuke - Oh My Love (User: melons)
Nils Lofgren & Andy Newmark - Anytime at All (User: melons)
Maxi Priest - All My Loving (User: melons)
Paul Carrack - Girl (User: melons)
Judie Tzuke - Love (User: melons)
Bryan Ferry - Jealous Guy (User: melons)
Yoko Ono - Walking on Thin Ice (User: melons)
Contrapunctus - Gone (User: melons)
Sleez Sisters - Theme (User: melons)
Penetration Moon - I'm Trash (User: melons)
Bored! - Little Suzie (User: melons)
The Humpers - St. Jon (User: melons)
Mother Mother - Hayloft (User: melons)
Kim Salmon - Lightning Scary (User: melons)
Satan's Sadists - Gloomy Sunday (User: melons)
Monsieur Jeffrey Evans - Snake, Rattle and Roll (User: melons)
Panther Burns - Surfside Date (User: melons)
Spectrum - True Love Will Find You in the End (User: melons)
The Lovedolls - Rock in the Sea (User: melons)
The Devil Dogs - Get on Your Knees (User: melons)
Pink Slip Daddy - Signorini Signoritti (User: melons)
Claw Hammer - Succotash (User: melons)
American Soul Spider - Spanish Doll (User: melons)
Red Planet Rocketts - Tic Tok (User: melons)
Chrome Cranks - Way Out Lover (User: melons)
The Lazy Cowgirls - D.I.E. in Indiana (User: melons)
Sludge - Suicide Drive (User: melons)
The Zeros - I Don't Wanna (User: melons)
Crowbar Salvation - Sack Lunch (User: melons)
Blundertongue - Long Tall Willy (User: melons)
Turbonegro - Zonked Out on Hashish (User: melons)
Miracle Workers - Way Back When (User: melons)
The Friggs - Wild Love (User: melons)
Gargoyles - Lou (User: melons)
Gibson Bros. - Barbara (User: melons)
The Black Flies - True Love (User: melons)
Ron Urini - Wild Venus on Wheels (User: melons)
Pixies - Vamos - Remastered (User: melons)
El Vez - Maria's the Name (User: melons)
God Bullies - How Low Can You Go (User: melons)
Ethyl Meatplow - Queenie (User: melons)
Sacred Miracle Cave - Heavy Black Noise (User: melons)
Hole - Phonebill Song (User: melons)
Nirvana - About a Girl (User: melons)
The Beatles - You're Going To Lose That Girl - Remastered 2009 (User: melons)
Coneheads - The Happiest Day of Her Life (User: melons)
Daggers - Kiss That Girl (User: melons)
Jonestown - I Love You Big Dummy (User: melons)
The Muffs - New Love (User: melons)
Trash Can School - Baby Lust (User: melons)
The Nomads - Primordial Ooze (User: melons)
The Vacant Lots - Neighborhood Girls (User: melons)
Shitbirds - Baby What's New (User: melons)
The Cannanes - Lamington Lane (User: melons)
Hydroplane - Completed Extract From The Previous 7 " (User: melons)
The Shapiros - Gone By Fall (User: melons)
Love Positions - Light Of Day (User: melons)
Maestros & Dipsos - Dot (User: melons)
Even as We Speak - I Won't have to think about you (User: melons)
Bart & Friends - There may come a time (User: melons)
Ya Ya Choral - Waiting Time (User: melons)
The Pearly Gatecrashers - In The Summer (User: melons)
The Ampersands - Affected (User: melons)
The Particles - driving me (User: melons)
Nuclear 45 - Democracy (User: melons)
The Waiting Rain - Electrify Me (User: melons)
The Misantropes - The Coming Of Hate And Distrust (User: melons)
Woulfedog - All The People (User: melons)
The Boom Band - Big Smile (User: melons)
This Concrete - Elaboration (User: melons)
Vilhelm Fort - See Me (User: melons)
This Perfect Day - Hey Little Girl (User: melons)
Mary Go Round - Into the Morgue (User: melons)
Fågelstryk - Heartache And Pain (User: melons)
Fågelstryk - Heartache And Pain (User: melons)
Holger Danske - Silver And Gold (User: melons)
Livingstone - A Better Way (User: melons)
This Perfect Day - Beyond My Tether (User: melons)
Mary Go Round - locked (User: melons)
Femte Kolonn - Dansen (User: melons)
Waterheads - What If I (User: melons)
Barbara - I Promise (User: melons)
West European Politics - Shine Baby (User: melons)
Sister James - This current doom (User: melons)
Happydeadmen - Never Love (User: melons)
Messerschmitts - K.O.'69 (User: melons)
The Wannadies - The Beast Cures the Lover (User: melons)
Gregor Samsa - Pride and guilt (User: melons)
All Steel Coaches - wave of fame (User: melons)
Rudy Norman - Back To The Streets (User: melons)
Damon Danielson - how Long has it Been (User: melons)
The Breathers - Don't It Make You Feel (User: melons)
Chuck Senrick - Don't Be So Nice (User: melons)
Madness - Madam Operator (User: melons)
Country Comfort - To Be Lonely (User: melons)
Gary Marks - Sailing (User: melons)
AJ Loria - Please Analyze (User: melons)
Canyon - Country Lovin (User: melons)
Salty Miller - One More Time (User: melons)
Calvin Johnson - Dance Of Love (User: melons)
Rob Galbraith - Tell Me With Your Eyes (Just Be You) (User: melons)
Paul Skyland - give me your love (User: melons)
Jeff Harrington - Kristi (User: melons)
Steps - Your Burning Love (User: melons)
Solenoid - Acquaintances (User: melons)
Johnny Gamboa - That Good Old Feeling Back Again (User: melons)
Ned Doheny - Before I Thrill Again (User: melons)
Michael Miglio - Never Gonna Let You Go (User: melons)
Jim Spencer - Wrap Myself Up In Your Love (User: melons)
Shirley Hurt - Empty Hands (User: melons)
Mt Vice - blue boy (User: melons)
JW Francis - Dream House (User: melons)
Orchid Mantis - Time Flows (User: melons)
strongboi - cold (User: melons)
Morabeza Tobacco - Saturnus (User: melons)
S.C.A.B. - Six Songs Into Your Spotify Playlist (User: melons)
spill tab - CRÈME BRÛLÉE! (User: melons)
Honeymoan - Shortcuts (User: melons)
Boyhood - Stranger (User: melons)
two blinks, i love you - i love you (User: melons)
Born At Midnite - Alternity (User: melons)
True Blue - Lucy - Club (User: melons)
girl in red - it would feel like this (User: melons)
Franz Gordon - The French Library (User: melons)
Go Go Machine Orchestra - 序曲 (User: melons)
Sō Percussion - Flame (User: melons)
Caregiver - Everything (User: melons)
Sō Percussion - Flame (User: melons)
David Lang - Heroin (arr. D. Lang for voice and cello) (User: melons)
Kreng - Na De Sex (User: melons)
Ryan Streber - What Will It Be For Me (User: melons)
John Luther Adams - Canticles of the Sky: I. Sky with Four Suns (User: melons)
Sloppy Jane - Wonderama (User: melons)
Sagor & Swing - Apollons aftonsång (User: melons)
The Young Scamels - Full Fathom Five (Thy Father Lies) (User: melons)
Corey Dargel - Someone Else's Pain (User: melons)
Pixies - Hang Wire (User: melons)
Oddlogic - Illumination Groovation (User: melons)
Heavyhearted - [Ominous Music Playing] (User: melons)
seskamol - Pop (User: melons)
sunnk - No One in the Whole World Will Ever Come to You (User: melons)
Tina Charles - I Love to Love (User: melons)
Mary Hopkin - Knock Knock Who's There (User: melons)
Vaeprism - Ælkemic Predlekshn (User: melons)
Man From Sol - Subjectivity Chasms (User: melons)
Abroxis - The Rust (User: melons)
NUAN SONAR - Breaks to Break Ya (User: melons)
Soup! - Only Time (User: melons)
Hang Ten - Balloon (User: melons)
Funk Society - Hang Ten (User: melons)
The Fun Sons - Hang Ten (User: melons)
Music For Cats - I Hate Those Meeces To Pieces - Bit Throne Remix (User: melons)
Hermes PH1 Sound-Effects - Cat Purr-Ing (Long Version) (User: melons)
Music For Cats - Don't Worry. Be Tabby. (User: melons)
Soup - Diamond Eater (User: melons)
Soup! - Daily Bread (User: melons)
The Soup Dragons - Hang-Ten ! (User: melons)
Black Francis - I Sent Away (User: melons)
Young Guv - Too Far Gone (User: melons)
Sweeping Promises - Hunger for a Way Out (User: melons)
Freddy Fender - Before The Next Teardrop Falls (User: melons)
Will Young - Leave Right Now (User: melons)
Jeannie C. Riley - Harper Valley P.T.A. (User: melons)
Youth Valley - I Don't Want to Go Out With You, Veronica (User: melons)
Woog Riots - Beatnik (User: melons)
White Shoes & The Couples Company - Irama Cita (Radio Version) (User: melons)
Whimsical - Quicksand (User: melons)
Weeping Willows - Shine Your Light On Me (User: melons)
The WaterStriders - Can I Settle For A Night - Radio Edit (User: melons)
Vega Rally - Infinity '93 (User: melons)
Urbanism - No More Without You (User: melons)
The Undercover Dream Lovers - Come a Little Closer (User: melons)
The Umbrellas - Write It In The Sky (User: melons)
The Ukrainians - Batyar (Bigmouth Strikes Again) (User: melons)
TV Goth - ghost dance ˙˚˙ᵕ꒳ᵕ˙˚˙‧̍̊ (User: melons)
Turnover - Ain't Love Heavy (User: melons)
Turmallina - Cinzas (User: melons)
Triángulo de Amor Bizarro - Un Actor Mejicano (User: melons)
Treemer - Paper Cuts (User: melons)
The Treasures Of Mexico - Always The Shadows (User: melons)
Tom Liwa - Schon wieder Februar (User: melons)
Tiny Fighter - If I Could See (User: melons)
Thomas Stenström - Moviestar (User: melons)
Tears On Demand - The Best Way To Get Convicted (User: melons)
Tempers - Unfamiliar (User: melons)
Tears On Demand - The Best Way To Get Convicted (User: melons)
Tallies - No Dreams Of Fayres (User: melons)
The Sylvia Platters - Pristine Disarray (Radio Edit) (User: melons)
Swiss Portrait - Play With Fire (User: melons)
Swimming Pools And Movie Stars - Stay (User: melons)
Svvell. - Woozy (User: melons)
Sunstinger - Only In The Morning (User: melons)
Sunflower Station - Today (User: melons)
The Suncharms - Distant Lights (User: melons)
Sugar World - We Fell in Love (User: melons)
Sugar For The Pill - Falling Back To You (User: melons)
The Spanish Amanda - (I've Given You Everything You Need) To Destroy Me (User: melons)
Rodney Cromwell - Memory Box (User: melons)
Royal Arch - Road To The Light (User: melons)
Richie Blacker - Never Enough (User: melons)
Richard Evans - Brave New World (User: melons)
Resplandor - Adore (User: melons)
Red Sleeping Beauty - Solid Gold (User: melons)
RAT BOY - RAM RAID (User: melons)
Dummy - Daffodils (User: melons)
Rachel Grimes - Second Self-Portrait Series (User: melons)
Pulse Park - Antibody (User: melons)
Prim - citylights (User: melons)
Poploader - Books Of Love (User: melons)
Pluto Is A Planet - Mars (User: melons)
Planet - Need More (User: melons)
Pink Turns Blue - We Always Wanted More (User: melons)
Petter - Slutet av dagen (User: melons)
Pete Astor - Time On Earth (User: melons)
Pelicat - The Ballad of Faustino Asprilla (User: melons)
The Peach Fuzz - Elaine (User: melons)
Pastis - It's a Wonderful Life (User: melons)
Papercuts - I Want My Jacket Back (User: melons)
Palm Ghosts - Amaya (User: melons)
The Orchids - Didn't We Love You (User: melons)
Occult X - Take Me Back (User: melons)
No Suits In Miami - What it's All About (User: melons)
Northern Portrait - Once Upon a Bombshell (User: melons)
New German Cinema - I Become Heavy (User: melons)
Nevver - Amaneciendo Y Anocheciendo - Extended Version (User: melons)
Marietta - You've Got the Map Backwards, Matt (User: melons)
NAH... - Rainy Days And Wednesdays (User: melons)
MY RAINING STARS - If You (User: melons)
My Favorite - The Happiest Days of My Life (User: melons)
The Muldoons - Audacity (User: melons)
Mt. Misery - Spinning Top (User: melons)
Mousefolk - I Don't Love You - Four Track Demo (User: melons)
MOTO BANDIT - YOU TOO (User: melons)
moon pics - Blush (User: melons)
The Monochrome Set - Hello, Save Me (User: melons)
Misty Coast - The End of the Beginning (User: melons)
Mint Julep - Cruel Summer (User: melons)
Minck - Die Nacht (User: melons)
Michael Head & The Red Elastic Band - Kismet (User: melons)
Melllo - Heaven Knows (User: melons)
Maybird - I'll Miss You When I Wake Up (User: melons)
Maxwell Farrington - I Had It All (User: melons)
The Mary Onettes - What I Feel In Some Places (User: melons)
Martin Sternhufvud - Let Your Love Shine (User: melons)
Marine Research - Angel in the Snow (User: melons)
Lurve - Even If I'm Happy I'm in Pain (User: melons)
Lunar Isles - Tow (User: melons)
Lucid Express - Lime (User: melons)
Luby Sparks - One Last Girl (User: melons)
Lovespirals - Smile (User: melons)
Lizzy & the Fanatics - East Angus 1998 (User: melons)
Lightning In A Twilight Hour - The Circling Of The Seasons (User: melons)
Letting Up Despite Great Faults - She Spins (User: melons)
Lehmanski - Hundert Jahre sind kein Tag (User: melons)
The Legends - For Love (User: melons)
Lavender Sunday - Whatcha Wanna Do Tonight? (User: melons)
Lavender Blush - Caldecott (User: melons)
Launder - Become (User: melons)
La Casa Azul - No Hay Futuro (User: melons)
Kubra Commander - Doldrum (User: melons)
Kreuder - Wer geht vor? (User: melons)
Kevin Morby - Bittersweet, TN (User: melons)
Karamelien - Ascension Heights (User: melons)
Kai Tak - Tung Chung (User: melons)
Just Mustard - Mirrors (User: melons)
John Doe - Destroying Angels (User: melons)
Jimmy Knows - Flowered (User: melons)
Jim Bob - Beach Ready Boys (User: melons)
Jetzt! - Hilf dem Widerstand (User: melons)
Jetstream Pony - Courses for Obstacles (User: melons)
The Jeremy Days - Beauty In Broken (User: melons)
Japanese Heart Software - Beer and Skittles (User: melons)
Indie Butterflies Dream - My Love (User: melons)
I'm the Villain - Song 1 (User: melons)
Imandra Lake - Viludus - Single Version (User: melons)
Humdrum - Superbloom (User: melons)
Holy Now - Places (User: melons)
The Holiday Crowd - Bullet Train (User: melons)
Hipflasks - A Lovely Scar (User: melons)
Herr Wade - Dummer Sommersong (User: melons)
HERR MÜLLER UND SEIN CHAUFFEUR - Lebenslänglich (User: melons)
The Hepburns - Mermaid (User: melons)
Hazel English - All Dressed Up (User: melons)
Hater - Renew, Reject (User: melons)
Hatchie - Giving the World Away (User: melons)
Grazer - The Lonely Example (User: melons)
Graveyard Club - Nowhere (User: melons)
Grand Splendid - Heartstrings (User: melons)
Gordon McIntyre - Tiny Marks (User: melons)
The Goa Express - Everybody in the UK (User: melons)
Glom - I Wanted the Real Thing (User: melons)
GLARE - Soft (User: melons)
Gizpel - Mundor Has To Say (User: melons)
ginla - You (User: melons)
Geowulf - Whirlwind (User: melons)
The Gift - Crashing Down (User: melons)
A Fawn at Dawn - 17 (User: melons)
MC Solaar - Prose Combat (User: melons)
Gabriel's Dawn - Gentle Chimes (User: melons)
Future Conditional - Demolitions (User: melons)
Fizzy Orange - Wonder (User: melons)
Fun with Ether - Lucent (User: melons)
Freedom Fry - True to Ourselves (User: melons)
Low - Just Make It Stop (User: melons)
Frankie Machine - The Sky (User: melons)
Fontaines D.C. - Jackie Down The Line (User: melons)
foliage - Can't Go Anywhere (User: melons)
Flu Flu - Come To Me (User: melons)
Flemming Borby - Heaven and That Guy (User: melons)
The Fisherman and His Soul - A White Actor (These Walles Have Ears) (User: melons)
Fine China - Trees at Night (User: melons)
Films on Song - City Love (User: melons)
Feutre - Apocalypse (User: melons)
Fers - Neverland (User: melons)
Featherfin - The Moon Is Our Sun (The Winter Song) (User: melons)
A Fawn at Dawn - 17 (User: melons)
Fanta Panda - Radiant Radish (User: melons)
Embrace - Death is Not the End (User: melons)
Eggs - Still Life (User: melons)
Echoberyl - Silent Monster (The Other Side of the Mirror) (User: melons)
Dylan Mondegreen - A Sound Rings True (User: melons)
Dress Thèque - If Heaven Exists (User: melons)
Dreamcoaster - Step Outside (User: melons)
DMA's - I Don't Need To Hide (User: melons)
Dims - Evil War (User: melons)
Die Sterne - Die Welt wird knusprig (User: melons)
Future Islands - Little Dreamer (User: melons)
Detective Larsson - Castello (User: melons)
Future Islands - In the Fall (feat. Katrina Ford) (User: melons)
Desario - Strange Shapes (User: melons)
The Death of Pop - Record High (User: melons)
The Death of Pop - Record High (User: melons)
Future Islands - On the Water (User: melons)
DC Gore - Sisyphus - Single Version (User: melons)
Future Islands - The Happiness of Being Twice (User: melons)
Day Wave - Loner (User: melons)
Future Islands - Hit the Coast (User: melons)
The Daylight - Hidden Love (User: melons)
Day & Dream - Security Blanket (User: melons)
Future Islands - Pinnochio (User: melons)
Future Islands - Aladdin (User: melons)
Crystal Eyes - Wishes (User: melons)
Future Islands - Before the Bridge (User: melons)
The Cry - Untethered (User: melons)
Future Islands - Ancient Water (User: melons)
Cristina Quesada - Primavera (User: melons)
Future Islands - Born in a War (User: melons)
Coyle Girelli - Do You Wanna Dance? (User: melons)
collect call - Chase the Light (User: melons)
Cold Showers - Lock and Key (User: melons)
Club 8 - Late in Life (User: melons)
Circa Waves - Hell On Earth (User: melons)
Cinema Engines - Springtime Remains (User: melons)
The Churchhill Garden - Always There (User: melons)
The Chesterfields - Mr. Wilson Goes To Norway (User: melons)
Chase & Status - Mixed Emotions (User: melons)
The Chalk Giants - Here Still (User: melons)
Cats on Trees - Lost Found Love (User: melons)
Cathedral Bells - Fall into Place (User: melons)
Casino Garden - Tunnels (User: melons)
Capitol - Taste of Cindy (User: melons)
Cape Weather - Too Close (User: melons)
Camera Obscura - Making Money (User: melons)
The Bunbury - Act Of Treason (User: melons)
Bubblegum Lemonade - Sun Kiss of Life (User: melons)
Bubblegum Lemonade - Sun Kiss of Life (User: melons)
Jason Crest - Here We Go ’Round The Lemon Tree (User: melons)
Broken Chanter - Allow Yourself (User: melons)
Boy with apple - Strawberry Boy (User: melons)
Ebo Taylor - will you promise (User: melons)
The Boo Radleys - Call Your Name (User: melons)
Blushing - Ours (User: melons)
the blue herons - Autumn Leaves (User: melons)
Blossoms - Edith Machinist (User: melons)
Blood Knows - Body (User: melons)
Billow - Box (User: melons)
Billow - Box (User: melons)
The Big Pink - NO ANGELS (User: melons)
Big Image - Something (User: melons)
Belle and Sebastian - Do It For Your Country (User: melons)
Bellavista - Shelter Shock (User: melons)
Beatnik Filmstars - Amazing Sense Of Style (User: melons)
A Beacon School - Dot (User: melons)
Guided by Voices - Girls of Wild Strawberries (User: melons)
Virna Lindt - Wild Strawberries (User: melons)
Bainbridge & Co. - Struggling to Sleep (User: melons)
Babeheaven - Sink Into Me (User: melons)
Azure Blue - Define Your Dreams (User: melons)
The Away Days - Life After Love (User: melons)
Atomic - Cry Like A Wolf (User: melons)
Atmos Bloom - When We Met (User: melons)
Another Sunny Day - Anorak City (User: melons)
Acid House Kings - Honey, Honey (User: melons)
52 Hertz Whale - Dmytro (User: melons)
The Rub - The Death of Pop (User: melons)
40 Days Without Water - Shed (User: melons)
R.E.M. - Moral Kiosk (User: melons)
Life - Moral Fibre (User: melons)
Thala - Takemeanywhere (User: melons)
Adelhard Roidinger - Wein 7 (User: melons)
Spector - Norwegian Air (User: melons)
Caramel - Chasing a Sound (User: melons)
LCD Soundsystem - New York, I Love You But You're Bringing Me Down (User: melons)
yunè pinku - Fai Fighter (User: melons)
Cruza - Seltzer (User: melons)
Furrows - Never Here (User: melons)
Shirley Hurt - Empty Hands (User: melons)
JW Francis - Dream House (User: melons)
Orchid Mantis - Time Flows (User: melons)
strongboi - cold (User: melons)
Morabeza Tobacco - Saturnus (User: melons)
Alex Siegel - Bicycle (User: melons)
S.C.A.B. - Six Songs Into Your Spotify Playlist (User: melons)
spill tab - CRÈME BRÛLÉE! (User: melons)
Honeymoan - Shortcuts (User: melons)
two blinks, i love you - i love you (User: melons)
Zach Schimpf - Ten Whole Years (User: melons)
Slik - Forever And Ever (User: melons)
Yo La Tengo - Tears Are in Your Eyes (User: melons)
The Rutles - I Must Be in Love - 2006 Remaster (User: melons)
Mika - Grace Kelly (User: melons)
Pet Shop Boys - Left To My Own Devices (User: melons)
R.E.M. - Good Advices (User: melons)
Orange Juice - Rip It Up (User: melons)
The Beatles - A Day In The Life - Remastered 2009 (User: melons)
Pretenders - Back on the Chain Gang - 2007 Remaster (User: melons)
Elvis Costello & The Attractions - Oliver's Army (User: melons)
Mcbaise - She's a Big Boy (User: melons)
Quentin Crisp - Where Did They Go? - Dance (User: melons)
Felt - Primitive Painters (User: melons)
Piero Milesi - Modi 2 (extract) (User: melons)
The Spencer Davis Group - Time Seller (User: melons)
Louis Philippe - L'Aventure (User: melons)
Martin Newell - Stella & Charlie Got Married (User: melons)
The Sharks - Schizoid Man (User: melons)
The Meteors - Mutant Rock (User: melons)
Momus - Bishonen (User: melons)
BMX Bandits - Something About Us (User: melons)
Toog - Cyclope-Haine (User: melons)
The Passage - Love Is As (User: melons)
Fantastic Something - If She Doesn't Smile (User: melons)
Dead Kennedys - Too Drunk to Fuck (User: melons)
two daughters - Return Call / We Are (User: melons)
Medicine Head - When Night Falls (User: melons)
McCarthy - An Mp Speaks (User: melons)
Ron Geesin - Smoked Hips (The Time Dance) (User: melons)
Ben Watt - North Marine Drive (User: melons)
Alien Sex Fiend - Ignore the Machine - Electrode Mix (User: melons)
Band of Holy Joly - Who Snatched the Baby? (User: melons)
John Holt - Sister Big Stuff (User: melons)
Dean Parrish - I'm On My Way (User: melons)
The Folk Implosion - Free To Go (User: melons)
PINS - Aggrophobe (User: melons)
The Aloof - One Night Stand (7" Version) (User: melons)
Pulp - She's a Lady (User: melons)
Kool & The Gang - Get Down On It - Single Version (User: melons)
Split Enz - I Got You (User: melons)
Chicago Gangsters - Let Me Go (User: melons)
Jonathan Richman - Velvet Underground (User: melons)
Dexys Midnight Runners - Thankfully Not Living in Yorkshire It Doesn't Apply - 2000 Remaster (User: melons)
Blondie - Once I Had A Love (AKA The Disco Song) - 1975 Version / Remastered 2001 (User: melons)
Clinic - Fantasy Island (User: melons)
William Onyeabor - Atomic Bomb (User: melons)
The Harmonettes - Can't Go Halfway (User: melons)
The Cure - Fire in Cairo (User: melons)
The Julie Ruin - I'm Done (User: melons)
Fantastic Something - If She Doesn't Smile (User: melons)
Safariari - A Taste of Killing (User: melons)
Sportique - Just friends (User: melons)
Kincaid - Trackside (User: melons)
Squeeze - Up The Junction (User: melons)
Cab Calloway & His Orchestra - Everybody Eats When They Come To My House (User: melons)
Manfred Mann - Walking Round (User: melons)
Manfred Mann - Up the Junction (User: melons)
The Middle Class - Out of Vogue (User: melons)
Resavoir - Escalator (User: melons)
Kendrick Lamar - DNA. (User: melons)
Styx - Mr. Roboto (User: melons)
Sufjan Stevens - Visions of Gideon (User: melons)
Zarelli - Falling Light (User: melons)
Sister Nancy - Bam Bam (User: melons)
Childish Gambino - Redbone (User: melons)
Gil Scott-Heron & Brian Jackson - The Bottle (User: melons)
Amadou & Mariam - Sabali (User: melons)
The Fortunes - Here Comes That Rainy Day Feeling Again (User: melons)
Suede - Indian Strings (Remastered) (User: melons)
King Charles - Bam Bam (User: melons)
The Kinks - She's Bought a Hat Like Princess Marina - Mono Mix (User: melons)
Talk Talk - It's My Life (User: melons)
Afrika Bambaataa - Planet Rock (User: melons)
Sisters of Black Mountain - Edgar Allan Poetry (User: melons)
The Flower Pot Men - Let's Go To San Francisco - Pt. 1 (User: melons)
Orbital - Easy Serv (User: melons)
The High Llamas - Harpers Romo (User: melons)
David Bowie - Changes - 2015 Remaster (User: melons)
David Bowie - Changes - 2015 Remaster (User: melons)
The Beatles - Blue Jay Way - Remastered 2009 (User: melons)
Arrested Development - People Everyday (User: melons)
The Beatles - Sexy Sadie - Anthology 3 Version (User: melons)
The Beatles - Sexy Sadie - Anthology 3 Version (User: melons)
The Avalanches - Radio (User: melons)
Eddie Cochran - C’Mon Everybody (User: melons)
Júníus Meyvant - Be A Man (User: melons)
Kazumasa Hashimoto - Noaro (User: melons)
Bernadette La Hengst - Meets Cybermohalla (User: melons)
Asao Kikuchi - Kula Botanical Gardens (User: melons)
Anne Laplantine - December (User: melons)
Lullatone - Wooden Toy Trumpet (User: melons)
Nobukazu Takemura - vibrante (User: melons)
Harald Sack Ziegler - Ritterball (User: melons)
Asa-Chang & 巡礼 - Kobana (User: melons)
Devendra Banhart - Make It Easier (User: melons)
Oren Ambarchi - Creepy Crawl (User: melons)
Devendra Banhart - Make It Easier (User: melons)
Kammerflimmer Kollektief - Alles Glühen (User: melons)
F.S. Blumm - Fa (F.S. Blumm Meets Anne Laplantine) (User: melons)
Rdl - mn2 (User: melons)
Guido Möbius - Sweet Raphael - Edit (User: melons)
Rdl - mn2 (User: melons)
Arrow Tour - Humidity of Mountains (User: melons)
World Standard - Tic Tac (User: melons)
La Grande Illusion - Let's Pretend (User: melons)
Yuichiro Fujimoto - country musicfellow (User: melons)
Dr. Rockit - Lullaby For William (User: melons)
Lawrence - Falling Down a Dam of Mashed Potatoes (User: melons)
Hassle Hound - Lucky Bugs Win Prizes (User: melons)
Maher Shalal Hash Baz - Good Morning (User: melons)
Romero - Honey (User: melons)
Kate NV - Not Not Not (User: melons)
Damaged Bug - Eggs At Night (User: melons)
Skinned Teen - Ex-Boyfriend Beat (User: melons)
Skinned Teen - Ex-Boyfriend Beat (User: melons)
Le Tigre - Friendship Station (User: melons)
that dog. - Ms. Wrong (User: melons)
that dog. - Ms. Wrong (User: melons)
Clap Your Hands Say Yeah - Satan Said Dance (User: melons)
Fairport Convention - Tale In Hard Time (User: melons)
Public Service Broadcasting - Blue Heaven (User: melons)
Broken Social Scene - Cause = Time (User: melons)
Public Service Broadcasting - Blue Heaven (User: melons)
Broken Social Scene - Cause = Time (User: melons)
Colleen Green - Highway (User: melons)
Ariel Pink - bright Lit blue skies (User: melons)
La Ligne Claire - Staphylocoque (User: melons)
Two Bunnies in Love - In My Dreams (User: melons)
Cocofka - Bêtise (User: melons)
Ava Carrère - Who Cares (User: melons)
Kim - Run to Me (User: melons)
Amour Versus - Electric Blue (User: melons)
Pousse Mort - Vegetable Man (User: melons)
Traditional Monsters - I Want a Girlfriend (User: melons)
Dwight - Things I Can't (User: melons)
Caandides - In the Cave (User: melons)
La Femme - La femme ressort (User: melons)
The Apartments - We Talked Through Till Dawn (User: melons)
Duncan Lamont - The Apartment (User: melons)
Adolph Deutsch - Blue Christmas (User: melons)
Hank Levine And His Orchestra & Singers - Georgy Girl (from "Georgy Girl") (User: melons)
Norman Percival & His Orchestra - Airport (Love Theme) (User: melons)
Robert Bentley - An Affair to Remember (User: melons)
Malcolm Lockyer And His Orchestra - Around the World (from "Around the World in 80 Days") (User: melons)
The Mike Morrison Congregation - I Got You Babe (User: melons)
Hank Levine and His Orchestra & Chorus - Tequila (User: melons)
Marty Paich And His Orchestra & Chorus - Music to Watch Girls By (User: melons)
The Fireside Folksingers - Leaving On a Jet Plane (User: melons)
Wally Stott & His Orchestra - Mack The Knife (From "The Three Penny Opera") (User: melons)
The Romantic Strings Orchestra - Fly Me To The Moon (User: melons)
Marty Paich And His Orchestra & Chorus - Up, Up and Away (User: melons)
Frank DeVol And His Chorus & Orchestra - The Glory of Love (Theme To "Guess Who's Coming to Dinner") (User: melons)
Ronnie Price - I Left My Heart In San Francisco (User: melons)
Nick Ingman & His Orchestra - Gonna Fly Now (Theme from "Rocky") (User: melons)
!!! - Me and Guiliani Down by the School Yard - A True Story (User: melons)
The Music Machine - Cherry Cherry (User: melons)
Mad Anthony - Rina (User: melons)
One Thousand Violins - I Think It's Time I Broke Down (User: melons)
My Idea - Crutch (User: melons)
Microdisney - Idea (User: melons)
Dr. Alimantado - Poison Flour (User: melons)
Sugar - A Good Idea (User: melons)
Pale Blue Eyes - Little Gem (User: melons)
Wooden Shjips - Already Gone (User: melons)
The Gun Club - Carry Home - Remastered 2020 (User: melons)
Flotation Toy Warning - Happy 13 (User: melons)
Emily Breeze - Ordinary Life - Radio Edit (User: melons)
Ronnie Spector - She Talks to Rainbows (User: melons)
The Electric Soft Parade - Empty At The End (User: melons)
Pale Saints - Porpoise (User: melons)
Bob Destiny - Wang Dang (User: melons)
Hamish Hawk - The Mauritian Badminton Doubles Champion, 1973 (User: melons)
Elastica - Nothing Stays the Same (User: melons)
Adam & The Ants - Scorpios (User: melons)
The Specials - Do Nothing - 2015 Remaster (User: melons)
Sun's Signature - Golden Air (User: melons)
XTC - Dear God - Remastered 2001 (User: melons)
Monie Love - It's a Shame (My Sister) (User: melons)
Julee Cruise - Falling (User: melons)
Johnny Dynell - Jam Hot (Rhumba Rock) (User: melons)
Beats International - Dub Be Good To Me (User: melons)
Usher - You Make Me Wanna... (User: melons)
Basement Jaxx - Red Alert - Jaxx Radio Mix (User: melons)
The Sugarcubes - Hit (User: melons)
of Montreal - Everything Disappears When You Come Around (User: melons)
The Orb - Little Fluffy Clouds (7" Edit) (User: melons)
Sylo - AIR (User: melons)
Morabeza Tobacco - Saturnus (User: melons)
Chelsea Days - It Goes (User: melons)
Medium Build - Never Learned To Dance (User: melons)
Jude Shuma - Workin So Hard (User: melons)
The Haunted Youth - Broken (User: melons)
Kenny Hamber & Group - Tears In My Eyes (User: melons)
Brady Only - Room Key (User: melons)
BNNY - Breaking Up (User: melons)
The Laurels - Message Of Love (User: melons)
The Invisible - Life’s Dancers (User: melons)
Stevie Zita - Silver Surfer (User: melons)
Goon - Yet Another Window (User: melons)
GLOSSER - Movies (User: melons)
Abby Sage - The Florist (User: melons)
Brown Bear Collective - Fever (User: melons)
strongboi - cold (User: melons)
Vox Rea - Julia (User: melons)
Yo La Tengo - Autumn Sweater (User: melons)
The Goon Sax - Make Time 4 Love (User: melons)
yunè pinku - Fai Fighter (User: melons)
Caramel - Chasing a Sound (User: melons)
Here We Go Magic - How Do I Know (User: melons)
Cults - Bumper (User: melons)
Fever Ray - Carbon Dioxide (User: melons)
Lomeli - Interrupter (User: melons)
Sunnbrella - A Week Or So (User: melons)
✝✝✝ (Crosses) - Vivien (User: melons)
Pro Teens - My Room (User: melons)
CD Ghost - Familiar (User: melons)
Cigarettes After Sex - Pistol (User: melons)
Quelle Rox - BIRDY'S (User: melons)
flowerovlove - Out For The Weekend (User: melons)
Tokyo Tea Room - If You Love Her (User: melons)
flowerovlove - Out For The Weekend (User: melons)
Gal Shaya - Let It Out (User: melons)
Modern Aerobics - Telephonic (User: melons)
Silver Liz - High at The Gym (User: melons)
Modern Aerobics - Telephonic (User: melons)
Work Wife - Too Young to Understand (User: melons)
Glom - Pebble (User: melons)
Lucinda Williams - Fruits Of My Labor (User: melons)
Mazey Haze - The Weight of the Weekend (User: melons)
Maz - Maybe Love (User: melons)
Seb - loving u is harder (User: melons)
Shirley Hurt - Empty Hands (User: melons)
Joji - NIGHT RIDER (User: melons)
Real Pleasure - Was It Love? (User: melons)
Conflict at Serenity Pools - don't feed bear (User: melons)
afternoon bike ride - Not Ideal (User: melons)
two blinks, i love you - i love you (User: melons)
Cruza - Seltzer (User: melons)
Andy Shauf - Wasted On You (User: melons)
Andy Shauf - Wasted On You (User: melons)
Beach Fossils - May 1st (Piano) (User: melons)
Scott McKenzie - Look In Your Eyes (User: melons)
Lucinda Williams - Fruits Of My Labor (User: melons)
The Invincibles - Heart Full of Love (User: melons)
Parsley Sound - Ease Yourself and Glide (User: melons)
Tim Hill - Payador (User: melons)
Mazzy Star - In the Kingdom (User: melons)
The Invincibles - Heart Full of Love (User: melons)
Mother Funk - Sunshine (User: melons)
Gusttavo Lima - Pot-Pourri: Pão de Mel/ Locutor - Ao Vivo (User: melons)
Bolter - Daj mi tę noc (User: melons)
Weekend - Jesteś zajebista (User: melons)
Dr. Octagon - No Awareness (User: melons)
Dr. Octagon - Earth People (User: melons)
Chain and the Gang - Certain Kinds of Trash (User: melons)
Rip Rig & Panic - You're My Kind of Climate (User: melons)
Nine Below Zero - Eleven Plus Eleven (User: melons)
Yazoo - Situation - 2008 Remastered Version (User: melons)
David Axelrod - Miles Away (User: melons)
Klaatu - Sub-Rosa Subway (User: melons)
Talking Heads - Paper - 2005 Remaster (User: melons)
Colorama - Dere Mewn (User: melons)
Al Green - I Can't Get Next to You (User: melons)
Meic Stevens - Y Brawd Hwdini (User: melons)
The Pale Fountains - Jean's Not Happening (User: melons)
EXEK - Several Souvenirs (User: melons)
The Communards - Don't Leave Me This Way (with Sarah Jane Morris) (User: melons)
Sérgio Mendes & Brasil '66 - Wichita Lineman (User: melons)
Roxy Music - In Every Dream Home a Heartache (User: melons)
Steven Universe - We Deserve To Shine (feat. Estelle, Charlene Yi, Erica Luttrell, Deedee Magno Hall, Michaela Dietz, Zach Callison, Grace Rolek & AJ Michalka) (User: melons)
Julia Bardo - Please Don't Tell Me (User: melons)
The Brunettes - Loopy Loopy Love (User: melons)
Young Marble Giants - Brand - New - Life (User: melons)
Sidney Gish - What Do You Want From Me Tonight? (User: melons)
Star Tropics - Windfall (User: melons)
Broadcast - The Book Lovers (User: melons)
The Pastels - Comin' Through (User: melons)
