Gnarls Barkley - Crazy (User: melons)
The Tams - Hey Girl Don't Bother Me (User: melons)
Cody Ash - Stuck in the Groove (User: melons)
Bonny Doon - BLOOD IN THE BATHTUB (User: melons)
The Lazy Eyes - Fuzz Jam (User: melons)
Charles Brand - Baby Blue Motorcycle (User: melons)
The Specials - Ghost Town (User: melons)
Natural Child - Dogbite (User: melons)
The Blank Tapes - Ebbs And Flows (User: melons)
Sports - Whatever You Want (User: melons)
Buzzcocks - What Do I Get? (User: melons)
The Legendary Bang - Love (User: melons)
Half Japanese - One Million Kisses (User: melons)
Air Miami - Airplane Rider (User: melons)
Spiderbait - Calypso (User: melons)
The Revolving Paint Dream - Flowers in the Sky (User: melons)
14 Iced Bears - Come Get Me (User: melons)
Pop Will Eat Itself - Black Country Chainstore Massacree - Remastered (User: melons)
The Rumble Strips - Girls and Boys in Love (User: melons)
The Champs - Tequila (User: melons)
Frente! - Bizarre Love Triangle - 2014 remaster (User: melons)
Poisson - 13000K (User: melons)
Scarlett Johansson - The Moon Song - Film Version (User: melons)
Steriogram - Walkie Talkie Man (User: melons)
Operator Please - Just a Song About Ping Pong (User: melons)
Elastica - Stutter (User: melons)
Yeah Yeah Yeahs - Date With the Night (User: melons)
Du Blonde - I'm Glad That We Broke Up (User: melons)
The Good Life - I Am an Island (User: melons)
The Vines - Get Free (User: melons)
The Von Bondies - C'mon C'mon (User: melons)
Neutral Milk Hotel - Communist Daughter (User: melons)
Blur - Lot 105 - 2012 Remaster (User: melons)
Midlake - Anabel (User: melons)
Catherine Scontras - Canal (User: melons)
Hockey Dad - Homely Feeling (User: melons)
Alan Hawkshaw - Studio 69 (User: melons)
Yo La Tengo - One PM Again (User: melons)
Roy Orbison - Only the Lonely (User: melons)
Radiohead - Banana Co (User: melons)
Montell Fish - fall in love with you. (User: melons)
Rites of Spring - Hain's Point (User: melons)
The Monks of Pluscarden Abbey - Kyrie IX - Remastered (User: melons)
Captain Beefheart & His Magic Band - Frownland (User: melons)
The Pleasure Seekers - What A Way To Die (User: melons)
Alain Goraguer - La femme (User: melons)
The Nerves - Many Roads To Follow (demo) (User: melons)
Javelin - Estevez (User: melons)
Margo Guryan - Sunday Morning (User: melons)
Connie Converse - One By One (User: melons)
The Stooges - Tight Pants - Remastered Studio (User: melons)
Otoboke Beaver - S'il vous plait (User: melons)
PJ Harvey - My Beautiful Leah (User: melons)
The Monochrome Set - Eine Symphonie Des Grauens (User: melons)
Blondie - Out In The Streets - Remastered (User: melons)
The Velvet Angels - I'm In Love (User: melons)
Sporto Kantès - Car Video (User: melons)
Marshall Family - Children Go Where I Send Thee (User: melons)
The Hotelier - The Scope of All of This Rebuilding (User: melons)
Orchid - Lights Out (User: melons)
The Brothers Johnson - Get The Funk Out Ma Face (User: melons)
Daniel Johnston - True Love Will Find You In The End (User: melons)
Mid-Air Thief - Parasol (User: melons)
Cassius - The Sound of Violence (User: melons)
Daughters - The Virgin (User: melons)
Metá Metá - Exu (User: melons)
Surf Curse - Freaks (User: melons)
Cibo Matto - Beef Jerky (User: melons)
Scratch Acid - She Said (User: melons)
Gorillaz - White Light (User: melons)
Machine Girl - Athoth a Go!! Go!! (None) (User: melons)
Björk - You've Been Flirting Again (User: melons)
Culture - Calling Rasta For I (User: melons)
Robert Pollard With Doug Gillard - Pop Zeus (User: melons)
The Dixie Cups - Iko Iko (User: melons)
Pet Shop Boys - Go West (User: melons)
Jaunter - Reset (User: melons)
Lecrae - I Love You (feat. Chris Lee) [Bonus Track] (User: melons)
Réciprok - Balance-Toi (Radio Version) (User: melons)
Gerry Guthrie - Did She Mention My Name (User: melons)
Deeparture - Only Tears (User: melons)
The British Collective - Flow (User: melons)
Poni Hoax - The Wild (User: melons)
Lonnie Mack - From Me To You (User: melons)
Sébastien Tellier - Ma Calypso (User: melons)
Sébastien Tellier - Ma Calypso (User: melons)
Sébastien Tellier - Ma Calypso (User: melons)
Manowar - Courage (User: melons)
Tina - Affaire de boy (User: melons)
Lonnie Smith - Funk Reaction (Club Mix) (User: melons)
Beth Bombara - It Slips Away (User: melons)
Julien Clerc - Chanson d'Émilie Jolie et du grand oiseau (Version edit) (User: melons)
Parni Valjak - Dok Je Tebe (User: melons)
Aerocity - Stranger (User: melons)
Vinai - I Was Made (User: melons)
Roma - Amigo Cantor (User: melons)
Respek BA - Touch the Sky (User: melons)
Jean-Jacques Perrey - Gypsy in Rio (User: melons)
The Rationals - Gloria (User: melons)
Diana Rein - Come Back Home (User: melons)
Claude Nougaro - Une Petite Fille (User: melons)
Pierre Bachelet - Vingt Ans (User: melons)
Nina Sky - Move Ya Body (feat. Vybz Kartel & Jabba) [Remix] (User: melons)
Soul Asylum - Runaway Train (User: melons)
Bob Sinclar - World, Hold On (User: melons)
Sate - The Answer (User: melons)
Levante - Non Me Ne Frega Niente (User: melons)
Amor Blitz - Gloria (User: melons)
PinkPantheress - All my friends know (Anz Remix) (User: melons)
Jack White - Fear of the Dawn (User: melons)
R.E.M. - Orange Crush (User: melons)
Lhasa de Sela - Love Came Here (User: melons)
Nathan Dawe - Lighter (User: melons)
Chiwoniso - Listen to the Breeze (User: melons)
Axel Flovent - Tourist (User: melons)
Poco - Rose Of Cimarron (User: melons)
Roch Voisine - Hélène (User: melons)
Jean-Jacques Perrey - Island in Space (User: melons)
Dino Dvornik - Zašto praviš slona od mene (User: melons)
Mint Condition - Someone To Love (User: melons)
Madonna - Like A Prayer (7" Version) (User: melons)
Pauline Ester - Oui, je l'adore (User: melons)
UB40 - I Got You Babe (feat. Chrissie Hynde) (User: melons)
Alain Souchon - Ultra moderne solitude (User: melons)
Kazéro - Thaï Na Na (User: melons)
Kazero - Thaï na na (User: melons)
The Bangles - Walk Like an Egyptian (User: melons)
Donna Summer - On the Radio (User: melons)
Billy Idol - Flesh for Fantasy (User: melons)
Billy Idol - Flesh For Fantasy - Remastered (User: melons)
Francis Lalanne - On se retrouvera (User: melons)
Jean-Jacques Goldman - Pas toi (User: melons)
The Belle Stars - Sign Of The Times (User: melons)
Blue Feather - Let's Funk Tonight (User: melons)
Super Cat - Fight Fi Power (User: melons)
Black Majesty - Voice Of Change (User: melons)
The Kid LAROI - Stay (User: melons)
Hatik - La meilleure (feat. Jok’Air) (User: melons)
Hatik - La meilleure (User: melons)
The Dark Element - The Dark Element (User: melons)
Drakkar - Ride The Storm (User: melons)
Birdy - Not About Angels (User: melons)
Bat for Lashes - The Haunted Man (User: melons)
The Electric Prunes - Antique Doll (User: melons)
White Lightning - Madame Sunrise (User: melons)
Arctic Monkeys - 505 (User: melons)
The Rolling Stones - Paint It, Black (User: melons)
The Midnight Shift - Price to Pay (User: melons)
Slightly Stoopid - 2 AM (User: melons)
The Everly Brothers - Bird Dog (User: melons)
Scarla LR - Du ca$h (User: melons)
Lonnie Mack - From Me To You (User: melons)
The Beatles - The Night Before (User: melons)
The Beatles - Tell Me Why (Remastered 2009) (User: melons)
David Cassidy - Cherish (remastered) (User: melons)
Dire Straits - Walk of Life (User: melons)
Billy Bauer Band - You Never Know (User: melons)
Da Brat - What'chu Like (User: melons)
Siddharta - Medrevesa (User: melons)
Cleo Sol - Why Don't You (User: melons)
Imélie Monteiro - Notre amour sonne faux (User: melons)
Soulplay - Dois Amores (User: melons)
Bugge Wesseltoft - Sharing (User: melons)
Love and Theft - Inside Out (User: melons)
Bryan Adams - Summer of '69 (User: melons)
Fugees - Killing Me Softly with His Song (User: melons)
Unheilig - Geboren um zu leben (User: melons)
Jacques Romain Georges Brel - Vesoul (User: melons)
Mark Chesnutt - I'll Think Of Something (User: melons)
Tracy Lawrence - Excitable Boy (User: melons)
The Beatles - Birthday (Remastered 2009) (User: melons)
Radiohead - The Daily Mail (User: melons)
Tayc - Dis moi comment. (User: melons)
Sound of Legend - Push the Feeling On (User: melons)
Stone Temple Pilots - Wicked Garden - 2017 Remaster (User: melons)
Jasmin Stavros - Guraj STAKI (User: melons)
Wings - My Love (User: melons)
Alida - In Your Eyes (feat. Alida) (User: melons)
Negrocan - Cada Vez (Grant Nelsons Vocal Mix) (User: melons)
Robin Beck - First Time (User: melons)
Avicii - Wake Me Up (User: melons)
Paramore - Hard Times (User: melons)
Mohamed Allaoua - Lhubiw amezwaru (User: melons)
Bert Jansch - Bittern (User: melons)
Animal Collective - Brother Sport (User: melons)
Beach House - Dark Spring (User: melons)
Denzel Curry - Zatoichi (User: melons)
Monie Love - Monie In The Middle (User: melons)
Dove Cameron - Boyfriend (User: melons)
Sigala & Becky Hill - Wish You Well (User: melons)
Bonnie Tyler - Holding Out for a Hero (User: melons)
Dave - Clash feat. Stormzy (User: melons)
Jaheim - Just In Case (User: melons)
Adele - Oh My God (User: melons)
The Ian Carey Project - Get Shaky (Ian Carey Original Mix) (User: melons)
Art Garfunkel - Bright Eyes (User: melons)
Prince - Gett Off (User: melons)
R.E.M. - Losing My Religion (User: melons)
Ikon N.E. - Pt. 04 (None) (User: melons)
Ikon N.E. - Pt. 12 (None) (User: melons)
Ed Sheeran - The Joker and the Queen (feat. Taylor Swift) (User: melons)
Kano - Ps & Qs (User: melons)
Clean Bandit - Rather Be (feat. Jess Glynne) (User: melons)
Mimi Webb - House on Fire (User: melons)
Björk - Big Time Sensuality (The Fluke Remix) (User: melons)
Juice WRLD - Cigarettes (User: melons)
D-Block Europe - Make You Smile feat. AJ Tracey (User: melons)
Caryl Parry Jones - Gad Fi Ar Ben Fy Hun (User: melons)
Catherine-Ann MacPhee - A Ghaoil Leig Dhachaidh/Leannan Mo Ghaoil (User: melons)
Dusty Springfield - I Only Want To Be With You (User: melons)
Bambi Bains - Beautiful Girl (User: melons)
Shaun Escoffery - Days Like This (User: melons)
Tiana Major9 - 2 seater (User: melons)
MK - Piece of Me (Extended Mix) (User: melons)
Beyoncé - Single Ladies (Put a Ring on It) (User: melons)
Anita Ward - Ring My Bell (User: melons)
Boney M. - Rivers of Babylon (User: melons)
DJ Jet - Price Tag (Remix 2019) (User: melons)
David Grant & Jaki Graham - Could It Be I'm Falling In Love (User: melons)
Mari Mathias - Rebel (User: melons)
Goldie - Lost (User: melons)
Nemzzz - 2MS (User: melons)
Oscar López - Dance of the Sun (User: melons)
Chase & Status - End Credits (User: melons)
New Order - Regret (User: melons)
Slade - Take Me Bak Ome (User: melons)
Wings - Goodnight Tonight (User: melons)
Oasis - Wonderwall (User: melons)
James - Getting Away With It (All Messed Up) (User: melons)
Jacob Elwy - Brigyn Yn y Dwr (User: melons)
Atif Aslam - Doorie (User: melons)
Ckay - Emiliana (User: melons)
The Green Dolphins - TBC 7 (User: melons)
Luude - Down Under feat. Colin Hay (User: melons)
Bloodmoon - Disarm (User: melons)
Milton Nascimento - Fairy Tale Song (Cadê) (User: melons)
Yazmin Lacey - Morning Matters (User: melons)
Billie Davis - Wasn't It You (User: melons)
Pixies - Human Crime (User: melons)
Glass Animals - Heat Waves (User: melons)
Toni Braxton - You're Makin' Me High (User: melons)
9 Diuz - Eminem ft Imanbek vs Roses (User: melons)
SAINt JHN - Roses (User: melons)
Tate McRae - she's all i wanna be (User: melons)
Skepta - That's Not Me (User: melons)
Atomic Kitten - Right Now (User: melons)
Tammy Wynette - D-I-V-O-R-C-E (User: melons)
Jurgen Vries - The Theme (User: melons)
Warp Brothers - Phatt Bass (User: melons)
Aquagen - Phatt Bass (Warp Brothers Single Cut) - Warp Brothers Single Cut (User: melons)
Robert Miles - Children (User: melons)
Johnnie Black - Stay (feat. S. Smith) (User: melons)
Sam Smith - Stay with Me (User: melons)
Doja Cat - Say So (User: melons)
Mimi Webb - House on Fire (User: melons)
Little Mix - No (Galantis Remix) (User: melons)
Wyclef Jean;Destiny's Child - No, No, No Part 2 (featuring Wyclef Jean) (Album Version) (User: melons)
Kanye West - Through the Wire (User: melons)
The B-52's - Love Shack (Single Version) (User: melons)
Elton John - Don't Go Breaking My Heart (User: melons)
ATB - 9 PM - Till I come >The U.K. Mixes< (Sequential One 1999 Remix) (User: melons)
Saweetie - Closer (feat. H.E.R.) (User: melons)
Charlie Puth - Light Switch (User: melons)
Enya - Orinoco Flow (User: melons)
DJ Khaled - I'm the One (User: melons)
Sub Sub - Ain't No Love (Ain't No Use) (User: melons)
Sinéad O'Connor - Nothing Compares 2 U (User: melons)
Sophie B. Hawkins - Right Beside You (User: melons)
The Statler Brothers - Flowers on the Wall (User: melons)
The Bobby Fuller Four - I Fought The Law - Single Version (User: melons)
Jinsang - Herewego (User: melons)
Eagles of Death Metal - Wannabe in L.A. (User: melons)
Pescado Rabioso - Todas Las Hojas Son Del Viento (User: melons)
Mitski - Washing Machine Heart (User: melons)
Crumb - Ghostride (User: melons)
The Velvet Underground - That's The Story Of My Life (User: melons)
Cloud Rat - Wonder (User: melons)
The Microphones - I Felt Your Shape (User: melons)
Aksak Maboul - Inoculating Rabies (User: melons)
mclusky - To Hell With Good Intentions (User: melons)
The United States of America - Stranded in Time (User: melons)
The Lemonheads - Rockin Stroll - Remastered (User: melons)
tricot - 混ぜるな危険 (User: melons)
Tori Amos - Agent Orange - 2016 Remaster (User: melons)
Todd Rundgren - Izzat Love? - 2015 Remaster (User: melons)
Daryl Hall & John Oates - Rich Girl (User: melons)
The Chordettes - Mr. Sandman (User: melons)
Creedence Clearwater Revival - Fortunate Son (User: melons)
The Shins - Girl Inform Me - 2021 Remaster (User: melons)
Portishead - Deep Water (User: melons)
Elvis Presley - A Little Less Conversation (User: melons)
Belle and Sebastian - Dear Catastrophe Waitress (User: melons)
Beach Bunny - Cloud 9 (User: melons)
Dick Dale - Misirlou (User: melons)
Buzzcocks - Love You More - 2001 Remastered Version (User: melons)
The Hennesseys - Grangetown Whale (User: melons)
Alan Hawkshaw - Grange Hill (User: melons)
Fountains of Wayne - Lost in Space (User: melons)
The Thermals - Let Your Earth Quake, Baby (User: melons)
Millie Small - My Boy Lollipop (User: melons)
Johnny Cash - Get Rhythm (User: melons)
The Soft Boys - Queen of Eyes (User: melons)
The Sugarcubes - Motorcrash (User: melons)
Buzzcocks - I Don't Mind (User: melons)
Bud Powell - Tempus Fugit (User: melons)
The Jesus and Mary Chain - Sometimes Always (User: melons)
Deerhunter - Revival (User: melons)
Los Lobos - Come on, Let's Go (User: melons)
Deerhoof - The Eyebright Bugler (User: melons)
Fats Domino - Whole Lotta Loving (User: melons)
Wire - Outdoor Miner - 2006 Remastered Version (User: melons)
The Magnetic Fields - Yeah! Oh, Yeah! (User: melons)
The Undertones - Teenage Kicks (User: melons)
Aretha Franklin - Think (User: melons)
The Kinks - You Really Got Me - Mono Mix (User: melons)
Kishi Bashi - Chester's Burst Over the Hamptons (User: melons)
Nada Surf - Blizzard of '77 (User: melons)
Jack Logan - 15 Years In Indiana (User: melons)
The Juliana Hatfield Three - Spin The Bottle (User: melons)
Pixies - Something Against You - Remastered (User: melons)
The Kinks - People Take Pictures of Each Other - 2018 Stereo Remaster (User: melons)
The Beach Boys - Caroline, No - Stereo / Remastered (User: melons)
Pixies - Allison (User: melons)
my bloody valentine - Touched (User: melons)
Arcade Fire - The Suburbs (Continued) (User: melons)
The White Stripes - Little Room (User: melons)
Tom Waits - Clang Boom Steam (User: melons)
Elvis Costello - Welcome To The Working Week (User: melons)
Madvillain - Curls (User: melons)
Scott Walker - 30 Century Man (User: melons)
Spoon - Car Radio (User: melons)
Wire - Three Girl Rhumba - 2006 Remastered Version (User: melons)
Frankie Cosmos - Fool (User: melons)
Remember Sports - Tiny Planets (User: melons)
Joyce Manor - Constant Headache (User: melons)
Sneaks - True Killer (User: melons)
Antioch Arrow - Too Bad You're Gonna Die (User: melons)
Buck Biloxi and the Fucks - Rock and Roll Sucks, Pt. 2 (User: melons)
Los Crudos - Tiempos De Miseria (User: melons)
Wilco - Jesus, Etc. (User: melons)
The Band - Ophelia - Remastered 2000 (User: melons)
Don Fredrick - Moonlight (User: melons)
The Velveteins - Don't Yah Feel Better? (User: melons)
Mild High Club - Rollercoaster Baby (User: melons)
Sam Evian - Right Down the Line (User: melons)
Deer Tick - Houston, TX (User: melons)
Johnny Thunders & The Heartbreakers - It's Not Enough - Remastered (User: melons)
The Sheepdogs - Let It Roll (User: melons)
The Nude Party - Records (User: melons)
Justice Der - NEW LIGHT (User: melons)
Charles Brand - Baby Blue Motorcycle (User: melons)
E.B. The Younger - When the Time Comes (User: melons)
Heartless Bastards - Only for You (User: melons)
King Floyd - Groove Me (User: melons)
Monster Rally - The Big Surf (User: melons)
Bob Marley & The Wailers - High Tide Or Low Tide - Jamaican Version (User: melons)
Rose City Band - Rip City (User: melons)
Banes World - You Say I'm in Love (User: melons)
Michael Nau - Smooth Aisles (User: melons)
Gus Dapperton - I'm Just Snacking (User: melons)
Good Morning - On The Street (User: melons)
May Erlewine - Days Go By (User: melons)
Bonny Doon - Saw a Light (User: melons)
Scoundrels - All On My Own (User: melons)
Spirit Ghost - Cult King (User: melons)
The Ruminaters - Mr Bubbles (User: melons)
Frankie Valli & the Four Seasons - Beggin' (User: melons)
Summer Salt - Rockaway (User: melons)
François de Roubaix - Les Amis - Actual Magic Remix (User: melons)
The Babies - Wandering (User: melons)
Sugar Candy Mountain - Tired (User: melons)
The Symposium - River Forest (User: melons)
Sashamon - Necta (Butterfly) (User: melons)
The Modern Lovers - Ride On Down The Highway - Live At Long Branch Saloon, Berkeley, CA / 1972 (User: melons)
Current Joys - New Flesh (User: melons)
Fruit Bats - Gideon (User: melons)
Archer Oh - Easy Eyes (User: melons)
Jurassic Shark - Miracle (User: melons)
The Irons - Goodbye Too Soon (User: melons)
Jr Jr - Skeletons (User: melons)
Bakar - Hell N Back (User: melons)
Mako Road - The Green Superintendent (User: melons)
Benny Sings - Rolled Up (User: melons)
Papa Bear & His Cubs - Sweetest Thing on This Side of Heaven (User: melons)
POPPONGENE - Eternally Alone - Snowy Band Remix (User: melons)
The Cars - Double Life (User: melons)
Jimi Hendrix - Gypsy Eyes (User: melons)
Little Joy - Brand New Start (User: melons)
The Ventures - Windy And Warm (User: melons)
Worn-Tin - Something's Coming (User: melons)
The Ventures - Windy And Warm (User: melons)
Mommy - hammock (User: melons)
Naked Giants - Turns Blue (User: melons)
Grouplove - Raspberry (User: melons)
Scoundrels - The Arch (User: melons)
Jacuzzi Boys - Planet Of The Dreamers (User: melons)
Jacuzzi Boys - Born Dancer (User: melons)
Jacuzzi Boys - Born Dancer (User: melons)
Jeff Kaale - pillow talk (User: melons)
Requin Chagrin - Adélaïde (User: melons)
Retro Dizzy - Feel Alright (User: melons)
Coma Cinema - Running Wide Open (User: melons)
Gee Tee - Commando (User: melons)
Gee Tee - Commando (User: melons)
Tijuana Panthers - End of My Rope (User: melons)
Tears for Fears - Tears Roll Down (User: melons)
Marc Almond - Tears Run Rings (User: melons)
Gary Toms Empire - Do Your Thing (User: melons)
Sandra Kerr - Opening (User: melons)
Ilene Woods - A Dream Is A Wish Your Heart Makes (User: melons)
The April Fools - Loretta Lane (User: melons)
Towa Tei - Technova (User: melons)
Towa Tei - Alpha (User: melons)
Jun Togawa - パンク蛹化の女 - 2016 Remaster (User: melons)
Jun Togawa - 好き好き大好き - 2016 Remaster (User: melons)
Hikashu - 20世紀の終りに (User: melons)
P-Model - フ・ル・ヘッ・ヘッ・ヘッ (User: melons)
Plastics - Top Secret Man (User: melons)
Ippu-Do - すみれ September Love(2006リマスタリング) (User: melons)
Masami Tsuchiya - Kafka (User: melons)
Susumu Hirasawa - A Tree in the Dark (User: melons)
はっぴいえんど - Jak Się Masz Kochanie (Original) (User: melons)
The Happy End - Rhumba Por Nicaragua (User: melons)
Akiko Yano - ただいまの歌 ~ふたりぼっちで行こうver.~ (User: melons)
Alfa - Cin Cin (User: melons)
Sketch Show - Mars (User: melons)
Sunny Day Service - In the Sun Again (User: melons)
never young beach - やさしいままで (User: melons)
Haruomi Hosono - Owari No Kisetsu (User: melons)
Rei Harakami - owari no kisetsu (User: melons)
Fishmans - Go Go Round This World! (User: melons)
Haruomi Hosono - Rock-a-bye My Baby (User: melons)
Yasuaki Shimizu - Seiko 3 (User: melons)
Yasuaki Shimizu - Kono yoni yomeri (sono 2) (User: melons)
Fumio Miyashita - 風に舞うエンジェル (User: melons)
Yutaka Hirose - Through The Windows (User: melons)
Yoshiaki Ochi - Beat the Water (User: melons)
Yoshio Chin Suzuki - ミート・ミー・イン・ザ・シープ・メドウ (User: melons)
Shiho Yabuki - Winterland (User: melons)
Masahiro Sugaya - Umi no Sunatsubu (User: melons)
Susumu Yokota - Azukiiro No Kaori (User: melons)
Yoshio Ojima - Orientate (User: melons)
Hiroshi Yoshimura - Blink (User: melons)
Rei - ぎゅ (User: melons)
Toshi Tsuchitori - Ishiura (abridged) (User: melons)
Inoyamaland - 8・31 (User: melons)
Haruomi Hosono - SUNNYSIDE OF THE WATER/水と光 (User: melons)
Satoshi Ashikawa - Still Space (User: melons)
Yumiko Morioka - Komorebi (User: melons)
Sound Therapy Masters - Hen with Cat (User: melons)
Lamps - Horse Cow Goat Pig Dog (User: melons)
Bot Ashley - Songs to my playlist (User: melons)
Empty Elevator - Elevator Factory (User: melons)
Swell Maps - Read About Seymour (User: melons)
Minutemen - Viet Nam (User: melons)
Irma Thomas - It's Raining (User: melons)
Sam Cooke - (What A) Wonderful World - Mono (User: melons)
Agnes Obel - Tokka (User: melons)
The Dave Clark Five - Catch Us If You Can - 2019 - Remaster (User: melons)
The Bostweeds - Faster Pussycat Kill Kill (User: melons)
Guided by Voices - Game of Pricks (User: melons)
The Breeders - No Aloha (User: melons)
Jerry Lee Lewis - Great Balls of Fire (User: melons)
Alan Price - Simon Smith and the Amazing Dancing Bear (Bonus Track) (User: melons)
Unit 4 + 2 - Concrete And Clay (User: melons)
The Amps - She's a Girl (User: melons)
The Donays - Devil In His Heart (User: melons)
Gerry & The Pacemakers - How Do You Do It? - Mono (User: melons)
Green-House - Soft Meadow (User: melons)
KAN SANO - Dream In - TiMT Remix (User: melons)
Grace Jones - Pull Up To The Bumper (User: melons)
DLJ - Suspended (User: melons)
Robert de Boron - SICK (User: melons)
Vegyn - Britnaeys new baby [125 BPM] (User: melons)
ORANCHA - SMOKY BANANA (User: melons)
Yakkle - Rush Hour (User: melons)
illmore - goodbye (User: melons)
Ill Sugi - Downtown Speaks (User: melons)
niafrasco - you (User: melons)
Shin-Ski - D's Swing (User: melons)
Tamuraryo - Uh-Huh-Huh (User: melons)
Bird - special (User: melons)
AMI - Don't Cry (User: melons)
Kōya Ogata - Many "Scratch" Perry (User: melons)
sakamoto junnosuke - DeFacto (User: melons)
KO-ney - Circulate (User: melons)
SMOKIN’theJAZZ - MOVE FORWARD (User: melons)
Stuts - Moments of the Night (User: melons)
SUKISHA - Here, There (User: melons)
BROCKBEATS - daydream (User: melons)
Akio Watanabe - daytime moon (User: melons)
I love you Orchestra Swing Style - Sweet Spare (User: melons)
Dakchi - Moonlight (User: melons)
Bugseed - Down East (User: melons)
SHULA - Early Morning (User: melons)
Rui Fujishiro - My Holiday (User: melons)
Akio Watanabe - ema (User: melons)
NICKELMAN - MidnightBlue (User: melons)
MIDICRONICA 181 - Win the Lottery (User: melons)
Mr. Shirai - Berlin Tsukin (User: melons)
MAHBIE - potatoL (User: melons)
M%O - 2GI NO NA2 (User: melons)
SUKISHA - Raining (User: melons)
paniyolo - Yoake (User: melons)
Wataru Fujiwara - Tequila at midnight (User: melons)
SMOKIN’theJAZZ - Peace to the HIP-HOP crowd (User: melons)
Aoi - petals falling from the cherry tree (User: melons)
Linn Mori - Dedicated To J Dilla (User: melons)
maeshima soshi - Butterfly (User: melons)
NARISK - Starting point (User: melons)
SUKISHA - Curtain Call (User: melons)
パジャマで海なんかいかない - Dream Journey (User: melons)
Bugseed - Arch (User: melons)
BROCKBEATS - ingenuity (User: melons)
tajima hal - Dipping Time (User: melons)
TOMC - Curiosity (User: melons)
Nabowa - timmit (HIRAKU YAMAMOTO tim←metro→mit REMIX) (User: melons)
Yakkle - BIG BLUE (User: melons)
SMOKIN’theJAZZ - Gypsy Woman (User: melons)
Studio75 - Kalanchoe "Green apple" (User: melons)
Malus & Lyrical Waterside - More Peace and More Love (Instrumental) (User: melons)
80KIDZ - Two 3 Four (User: melons)
SUKISHA - Step to Your Mind (User: melons)
Gas Lab - Getaway (User: melons)
tajima hal - Migratory Bird (User: melons)
Goro Kumai - Swing (User: melons)
Eccy - Miles Above (User: melons)
Doubutsu System - Stay Vision (User: melons)
Tokoyo - this time (User: melons)
Sweet William - Please Think Twice (User: melons)
SUKISHA - Breakin' up (User: melons)
Aoi - afternoon shower (User: melons)
Bird - probably (User: melons)
Rin Ishi - Know (User: melons)
Burgundy Groove - Reassurance Cycle (User: melons)
yutaka hirasaka - say it all (User: melons)
sakamoto junnosuke - Dusk Moon (User: melons)
Stuts - Conflicted (User: melons)
tajima hal - Minor Sights (User: melons)
SPECIAL OTHERS - Good song (User: melons)
Grooveman Spot - Feynman (User: melons)
paniyolo - Our Planet (User: melons)
Tha omedetaz - CHOP SUMMER (User: melons)
Otoji + Ray - Nomadic tribe - DJ Mitsu The Beats Remix (User: melons)
Takahiro Izumikawa - Kizanka (User: melons)
The Lasttrak - fog morning (User: melons)
Masaki Hori - Blind (User: melons)
Haruka Nakamura - Ria (User: melons)
maeshima soshi - bitter soil (User: melons)
Yakkle - The Black Cat (User: melons)
A.O. - Long Live the King - Instrumental (User: melons)
Daisuke Miyatani - Memories of Furniture (User: melons)
the bed room tape - Slice (User: melons)
U-Zhaan - City Creatures (User: melons)
n'sawa-saraca - dialogue (User: melons)
Soul Food Horns - Oak (User: melons)
A.O. - Morning Bird - Instrumental (User: melons)
Brains Mcloud - User Friendly (User: melons)
Silibil n' Brains - Medicine (User: melons)
jizue - ARUKAS (User: melons)
NEW K - Lamp2 (User: melons)
Masatomo Yoshizawa - No.18 Sketch in the Shade (User: melons)
ORANCHA - Lokki (User: melons)
Blooky Jeeky - ICHIMONJI (User: melons)
TAMTAM - Summer Ghost - Ghost Dub (User: melons)
Meitei - Shurayuki hime (User: melons)
Robert de Boron - SICK (User: melons)
KAN SANO - On My Way Home (User: melons)
n'sawa-saraca - one minute story 5 (User: melons)
Shin Sakiura - Need You (User: melons)
KO-ney - Void (User: melons)
A.O. - Legend - Instrumental (User: melons)
storkes - China Town (User: melons)
John Looke - Redder Than The Moon (User: melons)
Inventions - Continuous Portrait (User: melons)
Chihei Hatakeyama - Twilight Sea (User: melons)
Porter Robinson - Wind Tempos (User: melons)
The Black Dog - Meditation No #4 (User: melons)
Naran Ratan - Forevertime Journeys (User: melons)
Windy & Carl - Forest Trails (User: melons)
Nils Frahm - First Defeat (User: melons)
The Sweet Enoughs - Marshmallow (User: melons)
Alister Fawnwoda - Night Bunny (User: melons)
Spencer Zahn - Key Biscayne (User: melons)
Sea Oleena - Untethering (User: melons)
Farelane - Nacreous (Spa) (User: melons)
Carmen Villain - Two Halves Touching (User: melons)
Green-House - Soft Meadow (User: melons)
Pruski - zorza (User: melons)
popadiclo - Bamboo (User: melons)
Domenique Dumont - People On Sunday (User: melons)
Mary Lattimore - Sometimes He's In My Dreams (User: melons)
PETER BARK - cold summer (User: melons)
yes/and - Ugly Orange (User: melons)
No Spirit - New Age (User: melons)
Nala Sinephro - Space 1 (User: melons)
URCHN - Crescent (User: melons)
Green-House - Sunflower Dance (User: melons)
Ana Roxanne - Suite Pour L'invisible (User: melons)
Rafael Aragon - Ik Vari Do Vari (User: melons)
Hazy Noir - Chill in Lydda (User: melons)
Hello Psychaleppo - 100=1 (User: melons)
Jewlz - Targa (User: melons)
Saib - Samui Sunrise (User: melons)
Suwanti - Sassy (User: melons)
Dysphoria - I still dream of you (User: melons)
SMLR - stay (User: melons)
Wishkid - I Need a Drink (User: melons)
Barney Coleman - Sunset (User: melons)
Kohai - Please Don't Say Goodbye (User: melons)
Toonorth - Effervescent (User: melons)
Kupla - In Your Eyes (User: melons)
Redrose - i'm here (User: melons)
Dontcry - Edamame (User: melons)
Sebastian Kamae - Q&A (User: melons)
DANKUSH - we're broke but we're lucky (User: melons)
idealism - Controlla (User: melons)
SeanBeats - 5:00 Pm (User: melons)
rufi-o - oblivion (User: melons)
Tears In The Rain - DoYouStillFeelTheSame (User: melons)
Speechless - Nightfall (User: melons)
bearbare - u said we were meant to be (User: melons)
Aarigod - Bask (User: melons)
STEEZY PRIME - Compassion (User: melons)
DANKUSH - naked people that don't seem to mind (User: melons)
Spencer Hunt - Lux (User: melons)
bearbare - i'm not letting go (User: melons)
123 Sleep - Paper Rattle (User: melons)
Dontcry - Maki (User: melons)
Miro - hygge (User: melons)
Dontcry - Maki (User: melons)
FETS - Kingdom Dreams (User: melons)
dryhope - Amber (User: melons)
mell-ø - Breathe (User: melons)
Lofi Fruits Music - Dream Eyes (User: melons)
mell-ø - Breathe (User: melons)
BAMF - Starry Night (User: melons)
DYL - Flash Drive (User: melons)
Sereen - If You Show Me Love (User: melons)
Jayh - Coco - Instrumental (User: melons)
Kray Stax - Adults (User: melons)
Shxdai Beats - Backwood (User: melons)
Dylan Sitts - Hotel (User: melons)
Lilac - Anata (User: melons)
Moseqar - Mawj (User: melons)
Lbandy Music - Papi - Instrumental (User: melons)
Bobby Dreamz BIG - The Red (User: melons)
Sxteen - Tank - Instrumental (User: melons)
Gio - Draai Je Om - Instrumental (User: melons)
JordanXL - Palms (User: melons)
Toby Tranter - Selflessly (User: melons)
DaMoJaNad - Xvibe (User: melons)
Josylvio - HAAT - Instrumental (User: melons)
Djamil - Deserted Tree (User: melons)
Ardian Bujupi - Wie im Traum - Instrumental (User: melons)
Slumberville - Ladybug (User: melons)
Amine Maxwell - Be Mine (User: melons)
Aldo Levitt - Breakaway (User: melons)
Cushy - Convo (User: melons)
EQuBE - Voodoo - Instrumental (User: melons)
Mad Q - Grace (User: melons)
Van - #Untitled_02 (User: melons)
Kawakb - Instant Knafeh (User: melons)
Hazy Noir - Birdie_ - Instrumental (User: melons)
Ardian Bujupi - Rahat - Instrumental (User: melons)
Samtozi - Sadkid (User: melons)
C Y G N - Signs (User: melons)
Deeb - سمراء (User: melons)
PandRezz - It's Ok (User: melons)
Ballpoint - Spectra (User: melons)
Homebody - Groovly (User: melons)
Djamil - Arrival (User: melons)
Ooyy - Heliolingus (User: melons)
ElNasser - Stay at Home (User: melons)
Goldspell - Farmingdale (User: melons)
Off / Side - Skye (User: melons)
El 3ou - Dini Maak (User: melons)
Djamil - Eshkol (User: melons)
Azmito - Jigsaw (User: melons)
Médine - Le jour où j'ai arrêté le rap (Instrumental) (User: melons)
Sereen - west (User: melons)
Ballpoint - The Ace (User: melons)
Slumberville - Aconcagua (User: melons)
Sinan Öktem - SMOK (User: melons)
El Bles - Qahwah Con Leche (User: melons)
goosetaf - Chasin Daisys (User: melons)
helistofax - Crushing (User: melons)
Nadamondi - Peepers (User: melons)
Tom Doolie - Stay and Wander (User: melons)
Ozoyo - Daydream in Green (User: melons)
Nick AM - Take It Back (User: melons)
DJ Lethal Skillz - Lifted (User: melons)
Rafael Aragon - Ik Vari Do Vari (User: melons)
Moonbrew - Moon Landing (User: melons)
Hello Psychaleppo - 100=1 (User: melons)
Jewlz - Targa (User: melons)
Saib - Samui Sunrise (User: melons)
Moonbrew - Moon Landing (User: melons)
Channel Blue - Jocelyn Flores (User: melons)
dust and moonlight - in love with a view (you) (User: melons)
Formal Chicken - Feeling Good (User: melons)
Mattari - Gloaming (User: melons)
D-P - Alone without your embrace (User: melons)
Jhove - Reminiscing (User: melons)
goosetaf - Tripwire (User: melons)
Purrple Cat - Sugar Coat (User: melons)
Flughand - Feblu (User: melons)
Sebastian Kamae - Vondelpark (User: melons)
Kupla - Owls of the Night (User: melons)
FETS - Longer Days (User: melons)
Lofi Fruits Music - Pizza and You (User: melons)
hiraeth. - I know you better (User: melons)
Spencer Hunt - Melatonin (User: melons)
anybodyy - in my head (User: melons)
Sleepermane - Hourglass (User: melons)
Miro - hey x (User: melons)
DANKUSH - looking through old pictures of us (User: melons)
Lofi Fruits Music - Great Fairy's Fountain (User: melons)
dryhope - Down River (User: melons)
Arbour - Sundown (User: melons)
Ezra Furman - Point Me Toward the Real (User: melons)
goosetaf - Transcend (User: melons)
Wun Two - Again (User: melons)
Towerz - Solitude (User: melons)
anybodyy - a lifetime (User: melons)
mell-ø - Stay the Same (User: melons)
Avocuddle - Little People (User: melons)
Sway - Imágenes Violentas (User: melons)
Reuben Wilson - Bambu (User: melons)
Joe Williams - Get Out Of My Life Woman (User: melons)
Lee Morgan - The Sidewinder - Remastered 1999/Rudy Van Gelder Edition (User: melons)
Blue Mitchell - Hi-Heel Sneakers (User: melons)
Don Wilkerson - Dem Tambourines - Remastered (User: melons)
Jimmy Smith - The High and the Mighty (User: melons)
Bobby Hutcherson - Montara (User: melons)
Horace Silver - Song For My Father (User: melons)
Eddie Gale - Black Rhythm Happening - Remastered (User: melons)
Bennie Green - Encore - Stereo Version (User: melons)
Duke Pearson - Chili Peppers - Remastered (User: melons)
Art Taylor - Epistrophy - Remastered 2006 / Rudy Van Gelder Edition (User: melons)
Eric Dolphy - Out To Lunch - Remastered 1998/Rudy Van Gelder Edition (User: melons)
James Hurt - Waterfall (User: melons)
Erik Truffaz - Round-Trip (User: melons)
Stanley Turrentine - Meat Wave (User: melons)
Larry Young - Plaza De Toros (User: melons)
Ravi Coltrane - Spirit Fiction (User: melons)
Sam Rivers - Beatrice (User: melons)
The Rongetz Foundation - GOGO SOUL (User: melons)
Wayne Shorter - Speak No Evil - Remastered 1998 / Rudy Van Gelder Edition (User: melons)
Chico Hamilton - Abdullah And Abraham (User: melons)
Bobby Hutcherson - Little B's Poem - Remastered 1994 (User: melons)
Hank Mobley - The Morning After (User: melons)
Horace Parlan - Congalegre (User: melons)
Robert Glasper - Maiden Voyage / Everything In Its Right Place (User: melons)
Jackie McLean - Cancellation - Digital Remaster/2006 (User: melons)
English Teacher - R&B (User: melons)
Goblin - La via della droga - Originale (User: melons)
The Zodiac - Taurus - The Voluptuary (User: melons)
Carsick Cars - 中南海 (User: melons)
Mick Ronson - Growing Up and I'm Fine (User: melons)
Death - Politicians in My Eyes (User: melons)
Julian Cope - Charlotte Anne (User: melons)
Wussy - Airborne (User: melons)
Tristen - Athena (User: melons)
Syd Barrett - Gigolo Aunt (User: melons)
Zvuki Mu - Grubyy zakat (User: melons)
The Go-Betweens - Apology Accepted - Remastered (User: melons)
Clor - Love + Pain (User: melons)
Gruff Rhys - Shark Ridden Waters (User: melons)
Television - Days - 2003 Remaster (User: melons)
Television - Days - 2003 Remaster (User: melons)
The Vampire Sound Inc. - We Don't Care (User: melons)
The Raveonettes - I Wanna Be Adored (User: melons)
Felt - Look At the Sun (User: melons)
Zounds - Can't Cheat Karma (User: melons)
Michael Nesmith - Calico Girlfriend (User: melons)
Sloan - Penpals (User: melons)
Japan - Adolescent Sex (User: melons)
Dorothy Ashby - Love Is Blue (User: melons)
Japan - Adolescent Sex (User: melons)
Brian Eno - I'll Come Running - 2004 Digital Remaster (User: melons)
Lushroom - Goodbye to a World (User: melons)
Qumu - Sweden (From "Minecraft") (User: melons)
Mikel - Pokémon Gym (User: melons)
Lofi Fruits Music - Il Vento D'oro (User: melons)
Clay K Slider - Buttercup (User: melons)
TouchTone Da SoundGawd - Goodbye to a World - LoFi Mix (User: melons)
Wevak - Minecraft Calm - Remix (User: melons)
DanLofiMem - It's Been So Long Lofi (User: melons)
Super Mario 64 - Piranha Plant's Lullaby - Original (User: melons)
łtchi - This Is America by Childish Gambino but It's a Lofi Beat (User: melons)
Closed on Sunday - sweden ~ minecraft lofi (User: melons)
Jaydensmusic - Giorno's Theme Lofi Jojo (User: melons)
Baoluu - Bubblegum Kk (User: melons)
Porter Robinson - Goodbye To A World (User: melons)
SamFmusic - Lofi Goodbye to a World (User: melons)
thiaguiness - Il Vento D'Oro - Lo-Fi Remix (User: melons)
Lofi Dreams - Sweden Lofi Edit (User: melons)
Closed on Sunday - animal crossing ~ new horizons lofi (User: melons)
L.Dre - The Office (User: melons)
Jack Stauber's Micropop - Coffee (User: melons)
Jack Stauber's Micropop - Coffee (User: melons)
The Oh Hellos - Soldier, Poet, King (User: melons)
Ross From Friends - Life In A Mind (User: melons)
Les Trois Etrangers - Luna (User: melons)
Wrong Kind of Stone Age - Ravi Dubbi (User: melons)
The Horse He 's Sick - Terminal Rebound (User: melons)
Matt Mawson - Open The Goddam Door (User: melons)
Shanghai Au Go-Go - I Cried All Winter (User: melons)
Jayne Mansfield - That Makes It (User: melons)
Musarrat Nazir - Suey We Cheere Waliya (User: melons)
Aeroplane Footsteps - Arabia (User: melons)
Mr Knott - Poor Galileo (He Has Gone Mad) (User: melons)
Andy Rantzen - harmonic eye (User: melons)
Braden Schlager - Morning - Du Heaume Mix (User: melons)
Blue October - Into the Ocean (User: melons)
Lenky - Space Invaders (User: melons)
Modern Jazz - Zoom Dub (User: melons)
Height/Dismay - Blood Pressure in the Sand (User: melons)
The Frenzied Bricks - (Can I) Bridge The Gap (User: melons)
Ümlaut - Wintercoat (User: melons)
The Beatings - Bad Feeling (User: melons)
Chow Chow - Dear Francis (User: melons)
Help She Can't Swim - Pass The Hat Around (User: melons)
Angelica - Why Did You Let My Kitten Die? (User: melons)
Buffseeds - Sparkle Me (User: melons)
The Victorian English Gentlemens Club - Impossible Sightings Over Shelton (User: melons)
Astrid - Distance (User: melons)
Janet Jackson - That's the Way Love Goes (User: melons)
Erasure - Stop! (User: melons)
Guillemots - Who Left the Lights Off Baby (User: melons)
Isobel Campbell - (Do You Wanna) Come Walk With Me? (User: melons)
Bearsuit - Foxy boxer (User: melons)
Ikara Colt - At the Lodge (User: melons)
Bob Vylan - GDP (User: melons)
Water Melon - Moon Shaker (User: melons)
Akala - Shakespeare (User: melons)
Denim - Summer Smash (User: melons)
The Rolling Stones - Emotional Rescue - Remastered 2009 (User: melons)
Nerf Herder - Van Halen (User: melons)
Duran Duran - Skin Trade (User: melons)
Janet Jackson - That's the Way Love Goes (User: melons)
Erasure - Stop! (User: melons)
Nerf Herder - We Opened for Weezer (User: melons)
Mr.Black - Mucho Bien (User: melons)
Luis Alvarado - The Muzik - Radio Mix (User: melons)
Seduction - Two To Make It Right (User: melons)
Beth Ditto - I Wrote the Book (User: melons)
Kali Uchis - telepatía (User: melons)
Little Mix - Black Magic (User: melons)
Erasure - A Little Respect - 2009 - Remaster (User: melons)
Depeche Mode - Enjoy the Silence (User: melons)
Exposé - Point Of No Return (User: melons)
Marina - How to Be a Heartbreaker (User: melons)
Gwen Guthrie - Ain't Nothin' Goin' On But The Rent (User: melons)
Hannah Montana - The Best of Both Worlds - From "Hannah Montana"/Soundtrack Version (User: melons)
MFSB - Love Is the Message (feat. The Three Degrees) - Love Groove Bonus (User: melons)
Ava Max - My Head & My Heart (User: melons)
Robin S - Show Me Love (User: melons)
Fedde Le Grand - Let Me Think About It (Celebration Mix) (User: melons)
Fedde Le Grand - Let Me Think About It (Celebration Mix) (User: melons)
Jessie Ware - What’s Your Pleasure? (User: melons)
The Emotions - Best of My Love (User: melons)
Martha Wash - Carry On (User: melons)
Douglas Hodge - I Am What I Am (User: melons)
Judy Garland - Over the Rainbow (User: melons)
Boys Town Gang - Can't Take My Eyes Off You - Original Extended Version (User: melons)
Indeep - Last Night a D.J. Saved My Life (User: melons)
The Source - You Got The Love - New Voyager Radio Edit (User: melons)
Anita Ward - Ring My Bell (Re-Recorded) [Remastered] (User: melons)
Cheryl Lynn - Got To Be Real (User: melons)
Lauren Sanderson - Girl From The Internet (User: melons)
Maggie Lindemann - She Knows It (User: melons)
carpetgarden - Yr the Best! (User: melons)
Chika - Can't Explain It (feat. Charlie Wilson) (User: melons)
Ricky Montgomery - Mr Loverman (User: melons)
Kim Petras - Heart to Break (User: melons)
L Devine - Like You Like That (User: melons)
DARKoO - She Like (feat. Blanco) (User: melons)
Claud - Wish You Were Gay (User: melons)
GIRLI - More Than a Friend (User: melons)
Hayley Kiyoko - L.O.V.E. ME (User: melons)
Smoothboi Ezra - A Shitty Gay Song About You (User: melons)
dodie - She (User: melons)
The Internet - Come Over (User: melons)
G Flip - Queen (User: melons)
The Internet - Come Over (User: melons)
Bronze Avery - Boys! (User: melons)
Bronze Avery - Boys! (User: melons)
BROCKHAMPTON - SOMETHING ABOUT HIM (User: melons)
Tash Sultana - Pretty Lady (User: melons)
Rina Sawayama - Cherry (User: melons)
King Princess - Pussy Is God (User: melons)
The Aces - Volcanic Love (User: melons)
The Internet - Girl (feat. KAYTRANADA) (User: melons)
Hope Tala - Lovestained (User: melons)
Baby Queen - American Dream (User: melons)
The Japanese House - Saw You in a Dream (User: melons)
Frances Forever - Space Girl (User: melons)
Caroline Polachek - Door (User: melons)
serpentwithfeet - bless ur heart (User: melons)
Shura - religion (u can lay your hands on me) (User: melons)
Mykki Blanco - Love Me (User: melons)
Kele Okereke - My Guy (User: melons)
Georgia - Started Out (User: melons)
MUNA - Silk Chiffon (User: melons)
MUNA - Silk Chiffon (User: melons)
Caroline Polachek - So Hot You're Hurting My Feelings (User: melons)
Ethel Cain - Crush (User: melons)
Sophie - It's Okay to Cry (User: melons)
LAVA LA RUE - Goofy Hearts Club (User: melons)
Squirrel Flower - So Hot You're Hurting My Feelings (User: melons)
Foo Fighters - Breakout (User: melons)
Swing Out Sister - Breakout (User: melons)
Fuzzy Sun - Morning Light (User: melons)
Hothouse Flowers - Don't Go (User: melons)
Munich Meistersingers - Jägersburger March (User: melons)
Neue Böhmische Blasmusik - Rosamunde (User: melons)
Die Tiroler Blasmusikanten - Im Kahlenberger Dörfl (User: melons)
Oktoberfest Players - Komm Und Tanz (User: melons)
Munich Meistersingers - Kufstein Polka (User: melons)
Bayernkapelle - In München steht ein Hofbräuhaus (User: melons)
Die Tiroler Blasmusikanten - Holzknecht-Polka (User: melons)
Ladislav Kubes - Mamincina Soudeska (User: melons)
The Bavarian Oompah Band - Oompah Polka (User: melons)
Original Münchner Blaskapelle/ Ltg.Bert Himmer - Bayerische Löwen (User: melons)
Shketz Oktoberfest Band - Wien Bleibt Wien (User: melons)
The Official Oktoberfest Band - Tick Tock Polka (User: melons)
Orville Peck - Dead of Night (User: melons)
His Electro Blue Voice - Energie (User: melons)
Voka Gentle - Horse Latitudes - Radio Edit (User: melons)
provoker - Blue Sheen (User: melons)
Kai Kwasi - Cracks (User: melons)
Vanishing Twin - Phase One Million (User: melons)
Joy Room - Johnny (User: melons)
Baba Ali - Draggin' On (User: melons)
Baby Dave - Clarence's Dead Dad (User: melons)
Soft Sports - 86 (User: melons)
The Real People - Window Pane (User: melons)
Dolly Mixture - Will He Kiss Me Tonight (User: melons)
Mehalah Ray - 501 (User: melons)
George O'Hanlon - How Are You Feeling? (User: melons)
Deep Tan - beginners' krav maga (User: melons)
I Hate Myself Because - obedient dog (User: melons)
Exit Kid - We're Strange (User: melons)
Home Counties - Back to The 70s (User: melons)
Home Counties - Village Spirit (User: melons)
Priestgate - Eyes Closed For The Winter (User: melons)
Vex Message - No You Don't (User: melons)
Thom Southern - Suzanne I'm Sorry (User: melons)
Girl Afraid - Nobody Talks (User: melons)
Tom A. Smith - Dragonfly (User: melons)
Spring Silver - Little Prince (User: melons)
Wiki - Can't Do This Alone (User: melons)
Queens of the Stone Age - God Is in the Radio (User: melons)
Queens of the Stone Age - In The Fade/Feel Good Hit Of The Summer (Reprise) (User: melons)
Mark Lanegan - Undertow (User: melons)
Soulsavers - Revival (User: melons)
Mark Lanegan - Undertow (User: melons)
Mark Lanegan - Where Did You Sleep Last Night (User: melons)
Mark Lanegan - Mockingbirds (User: melons)
Mark Lanegan - Strange Religion (User: melons)
Martina Topley-Bird - Crystalised - Original Mix (User: melons)
Mark Lanegan - Ode To Sad Disco (User: melons)
Isobel Campbell - Snake Song (User: melons)
The Twilight Singers - Number Nine (User: melons)
Creedence Clearwater Revival - Have You Ever Seen the Rain (User: melons)
Clodagh Rodgers - Jack in the Box (User: melons)
The Isley Brothers - Love The One You're With (User: melons)
Ray Stevens - Bridget The Midget (The Queen Of The Blues) (User: melons)
Hot Chocolate - You Could've Been a Lady (User: melons)
Crosby, Stills, Nash & Young - Love the One You're With (User: melons)
Deep Purple - Strange Kind of Woman (User: melons)
C.C.S. - Walking (User: melons)
New World - Rose Garden (User: melons)
Kon Kan - I Beg Your Pardon (I Never Promised You a Rose Garden) (User: melons)
Lynn Anderson - Rose Garden (User: melons)
Barbra Streisand - Stoney End (User: melons)
The Partridge Family - I Think I Love You (User: melons)
Showstoppers - Ain't Nothin But A Houseparty (User: melons)
The Byrds - Chestnut Mare (User: melons)
Grand Funk Railroad - Inside Looking Out - Remastered (User: melons)
Edgar Broughton Band - Apache Drop Out - 2001 Remaster (User: melons)
Dana - Who Put The Lights Out (User: melons)
Atomic Rooster - Tomorrow Night (User: melons)
Benjamin Schoos - Line Flowers (User: melons)
Luby Sparks - Depression (User: melons)
Pixies - Break My Body - Remastered (User: melons)
Dustin Boyer - Woman Downstairs (feat. Mark Lanegan) (User: melons)
The Goa Express - second time (User: melons)
Map Of Africa - Bone (User: melons)
Daniel Romano - Modern Pressure (User: melons)
Jake Holmes - Dazed and Confused (User: melons)
Bertrand Burgalat - Follow Me (User: melons)
Martha and the Muffins - Paint By Number Heart - Remastered (User: melons)
Adrian Belew - Oh Daddy (User: melons)
Benjamin Schoos - Je Ne Vois Que Vous (User: melons)
Dennis Parker - Like an Eagle - Original (User: melons)
The Psychedelic Furs - Sister Europe - Remastered (User: melons)
The Jesus and Mary Chain - Happy When It Rains (User: melons)
