Señor Coconut - The Robots (User: melons)
Girl Ray - Don't Go Back at Ten (User: melons)
The Cardigans - Sabbath Bloody Sabbath (User: melons)
Luna - Sideshow By The Seashore (User: melons)
Arab Strap - The Shy Retirer (User: melons)
The Monkees - Porpoise Song (User: melons)
New York Dolls - Lonely Planet Boy (User: melons)
The Monkees - Porpoise Song (User: melons)
The Shaggs - Philosophy of the World (User: melons)
Pixies - Motorway to Roswell (User: melons)
Public Service Broadcasting - Spitfire (User: melons)
PJ Harvey - Dress (User: melons)
Big Audio Dynamite - Union, Jack (User: melons)
Mad Season - River of Deceit (User: melons)
Screaming Trees - Subtle Poison (User: melons)
Warm Graves - Nightfall/Daylight (User: melons)
Jeff Phelps - Wrong Space, Wrong Time (User: melons)
Henryk Debich - Dyskusja (User: melons)
Helena Deland - Swimmer (User: melons)
Brian Reitzell - I Put a Spell on You (feat. Mark Lanegan) (User: melons)
The Separate - Happy Together (User: melons)
Marianne Faithfull - It's All Over Now Baby Blue (User: melons)
Martyn Lenoble - Cat People (Putting Out Fire) [feat. Mark Lanegan & Dave Gahan] (User: melons)
I Am Super Ape - Monki feat. Mark Lanegan (User: melons)
James Williamson - Wild Love (User: melons)
James Williamson - Wild Love (User: melons)
Jonny Polonsky - Solar Child (User: melons)
Andrew Joslyn - Desiderata (User: melons)
Beat Happening - Polly Pereguinn (User: melons)
Tinariwen - Nànnuflày (User: melons)
Beat Happening - Polly Pereguinn (User: melons)
Crippled Black Phoenix - Constant Limbo (Constant Rain) (User: melons)
Steve Fisk - One More Valley (User: melons)
Gary Heffern - All His Children (User: melons)
Nicole Atkins - November Rain (User: melons)
Mark Morton - Axis (User: melons)
My Jerusalem - Hit the Lights (User: melons)
Werk - Long cold race (User: melons)
Auf der Maur - Taste You (User: melons)
Magnus - Singing Man (User: melons)
Ted Weems - Chick, Chick, Chick, Chick, Chicken (Lay a Little Egg for Me) (User: melons)
Black Mountain - Heart Of Snow (User: melons)
Screaming Trees - Dollar Bill (User: melons)
Screaming Trees - All I Know (User: melons)
Domkraft - Where We Part Ways (User: melons)
The Soundtrack Project - Sweet Life (User: melons)
Burning Brides - Vampire Waltz (User: melons)
Ian Ottaway - I'm Always (User: melons)
Hey Colossus - The Mirror (User: melons)
Wax Tailor - Just a Candle (User: melons)
AGrio - A Drink of Poison Water (User: melons)
The Devils - Devil Whistle Don't Sing (User: melons)
Cult of Luna - Inside of a Dream (User: melons)
Kira Skov - Idea of Love (User: melons)
Mark Lanegan - You Only Live Twice (User: melons)
Lynn Castle - Clear Night for Love (User: melons)
The Afghan Whigs - I'll Make You See God (User: melons)
Cosmo-Daemonic Telegraph Company - Dominance And Submission (feat. Mark Lanegan, Nick Oliveri and Sam Coomes) (User: melons)
Marianne Faithfull - The Stations (User: melons)
The Armed - THE MUSIC BECOMES A SKULL (User: melons)
UNKLE - Looking for the Rain (User: melons)
Bomb the Bass - Black River feat. Mark Lanegan (User: melons)
The Weathermen - It's The Same Old Song (User: melons)
Ashton, Gardner & Dyke - Resurrection Shuffle - Remastered (User: melons)
The Dawn - Candida (User: melons)
Melanie - What Have They Done To My Song, Ma? (User: melons)
Bobby Bloom - Heavy Makes You Happy (User: melons)
Juris - I Love You Goodbye (User: melons)
Karen Peris - You Are The Light (User: melons)
Val McDermid - Rachgier - Ein Fall für Carol Jordan und Tony Hill, Kapitel 4 (User: melons)
Children's Favourites - Rupert The Bear (User: melons)
The Mixtures - Push Bike Song (User: melons)
Christie - San Bernadino (User: melons)
Dorothy Squires - My Way - Original Hit Recording (User: melons)
Anne Murray - Snowbird (User: melons)
Matthews' Southern Comfort - Woodstock (User: melons)
The Spinners - It's A Shame (User: melons)
Kavana - Will You Wait For Me (User: melons)
Judy Collins - Amazing Grace (User: melons)
White Plains - Julie Do Ya Love Me (User: melons)
Don Fardon - Indian Reservation (User: melons)
Ken Dodd - Brokenhearted (User: melons)
Gerry Monroe - My prayer (User: melons)
Chairmen Of The Board - (You’ve Got Me) Dangling On A String (User: melons)
Glen Campbell - It's Only Make Believe (User: melons)
Johnny Johnson & The Bandwagon - (Blame It) On the Pony Express (User: melons)
Neil Diamond - Cracklin' Rosie (User: melons)
McGuinness Flint - When I'm Dead And Gone - Remastered (User: melons)
Dave Edmunds - I Hear You Knocking (User: melons)
Rod Stewart - Maggie May (User: melons)
10,000 Maniacs - Because the Night (User: melons)
Procol Harum - A Salty Dog (User: melons)
Ronnie Lane - The Poacher (User: melons)
Ronnie Lane's Slim Chance - Don't Try ‘n’ Change My Mind (User: melons)
Slim Chance - how come (User: melons)
Seatbelts - Hey, Hey Tiger! (User: melons)
Gareth Emery - Because The Night (User: melons)
Norm MacDonald - Best Disease Ever (User: melons)
The Waterboys - Fisherman's Blues - 2006 Remaster (User: melons)
The Waterboys - Fisherman's Blues - 2006 Remaster (User: melons)
The Immediate - Twisted Lies (Juggernaut Song) (User: melons)
The Immediate - Twisted Lies (Juggernaut Song) (User: melons)
The Immediate - Unrequited (User: melons)
The Immediate Family - Slippin' and Slidin' (User: melons)
The Immediate - Big sad eyes (User: melons)
Breaka - Mass Gathering (User: melons)
Richard Marx - Take This Heart (User: melons)
NehruvianDOOM - Great Things (User: melons)
The Gutter Twins - Circle the Fringes (User: melons)
Honey Moon - Stop and Listen (User: melons)
Ultra Q - It's Permanent (User: melons)
Low Girl - So Cool (User: melons)
distraction4ever - Car Crash (User: melons)
Thom Southern - She’s So Precious (User: melons)
Honeyglaze - Shadows (User: melons)
Legss - Hollywood (User: melons)
Melt Yourself Down - Balance (User: melons)
Egyptian Blue - Salt (User: melons)
Lonnie Liston Smith & The Cosmic Echoes - Visions of a New World (Phase I) (User: melons)
The Gutter Twins - Seven Stories Underground (User: melons)
The Gutter Twins - Front Street (User: melons)
The Gutter Twins - All Misery/Flowers (User: melons)
The Gutter Twins - God's Children (User: melons)
The Gutter Twins - The Stations (User: melons)
Isobel Campbell - Come On Over (Turn Me On) (User: melons)
The Gutter Twins - Idle Hands (User: melons)
Isobel Campbell - Snake Song (User: melons)
Isobel Campbell - Snake Song (User: melons)
Isobel Campbell - Come Undone (User: melons)
Moby - The Lonely Night - Reprise Version (User: melons)
Eire Apparent - Rock 'n' Roll Band (User: melons)
Shipping News - Books on Trains (User: melons)
Systems Officer - East (User: melons)
Rob Crow - Up (User: melons)
Karate - There Are Ghosts (User: melons)
Three Mile Pilot - The Year of No Light (User: melons)
Pinback - Loro (User: melons)
Daniel Avery - Illusion Of Time (User: melons)
SLAP RASH - Holy Smoke (User: melons)
TV Priest - One Easy Thing (User: melons)
KEG - Farmhands (User: melons)
HighSchool - Jerry (User: melons)
Opus Kink - I Love You, Baby (User: melons)
Voka Gentle - DREAD/TKOE (User: melons)
wings of desire - Perfect World (User: melons)
Blanketman - The Signalman (User: melons)
VLURE - Euphoria (User: melons)
New German Cinema - I Become Heavy (User: melons)
Crows - Slowly Separate (User: melons)
Anorak Patch - Cousin Sam (User: melons)
Deep Tan - beginners' krav maga (User: melons)
The Goa Express - Everybody in the UK (User: melons)
Sprints - Little Fix (User: melons)
Body Type - Sex & Rage (User: melons)
Horsegirl - Billy (User: melons)
L'objectif - Same Thing (User: melons)
Nino Nardini - Beyond The Clouds (User: melons)
Fenella - Bright Curse - Edit (User: melons)
Belbury Poly - The Gone Away (User: melons)
Henry Mancini - Pink Panther Theme (User: melons)
Trap Remix Guys - Pink Panther - Trap Remix (User: melons)
Henry Mancini - Pink Panther Theme (User: melons)
Retep Folo - Galactic Pulse (User: melons)
Alain Goraguer - Le bracelet (User: melons)
Alexandra Klochkova - Dreamscape (User: melons)
The Dice Man - Polygon Window (User: melons)
Suzanne Ciani - The First Wave - Birth Of Venus (User: melons)
Kosmischer Läufer - Sandtrommel (User: melons)
Cluster - Oh Odessa (User: melons)
Isao Tomita - Reverie (User: melons)
Luke Abbott - Kagen Sound (User: melons)
Third Son - Roygbiv (User: melons)
Moonfish - Mahi Mahi (User: melons)
Third Son - Roygbiv (User: melons)
Roedelius - Sonnengeflecht (User: melons)
Sufjan Stevens - The Runaround (User: melons)
Leafcutter John - Yes! Come Parade With Us (User: melons)
Cluster - Avanti (User: melons)
Ashra - Deep Distance (User: melons)
Edgar Froese - Epsilon In Malaysian Pale - 2012 Remaster (User: melons)
Luke Abbott - Brazil (User: melons)
Oneohtrix Point Never - Chrome Country (User: melons)
John Carpenter - Main Title (User: melons)
Klaus Weiss - Survivor (User: melons)
Sam Prekop - Kreuzung (User: melons)
Moon Projection - Falling Snowflakes (User: melons)
Harmonia - Veteranissimo - Live (User: melons)
Field Works - Station 5 (User: melons)
Field Works - Station 5 (User: melons)
Bitchin Bajas - Moon Dance (User: melons)
METAHESH - you're not alone (User: melons)
David Borden - Esty Point, Summer 1978 (User: melons)
Harald Grosskopf - So Weit, So Gut (User: melons)
Queen - In The Space Capsule (The Love Theme) - Remastered 2011 (User: melons)
The Field - Is This Power (User: melons)
Chrome Canyon - Broken Theme (User: melons)
Eno Moebius Roedelius - The Belldog (User: melons)
Apocalipsis - Ayudame a Encontrar Mi Camino (User: melons)
Grupo C.I.M. - Joropo No.1 (User: melons)
Vytas Brenner - Caracas para Locos (User: melons)
Aldemaro Romero - Irene (User: melons)
Vytas Brenner - Bang-Going-Gone (User: melons)
Fernando Yvosky - Barcos De Papel (User: melons)
Miguel Angel Fuster - Polvo Lunar (User: melons)
Un, Dos, Tres, y Fuera - Machu Picchu (User: melons)
Pablo Schneider - Amor En Llamas (User: melons)
Vytas Brenner - Araguaney (User: melons)
ANGEL RADA - Panico a Las 5am (User: melons)
King Of Woolworths - Delia Derbyshire (User: melons)
Gang Gang Dance - Vacuum (User: melons)
The Focus Group - Kinky Korner Klub (User: melons)
Pram - Milky (User: melons)
Delia Derbyshire - Moogies Bloogies (User: melons)
Tool - Sober (User: melons)
Priestgate - Eyes Closed For The Winter (User: melons)
T-SQUARE - Mr. Coco's One (User: melons)
Ashley Eriksson - Ett Stilla Regn (User: melons)
Jack Wilkins - Red Clay (User: melons)
Francis Mailloux - Forest Dance (User: melons)
Verma - Salted Earth (User: melons)
Dance Hall Crashers - Salted (User: melons)
Dizzy Gillespie - Salt Peanuts (User: melons)
Metronomy - Salted Caramel Ice Cream (User: melons)
Matt Citron - Wanna Go (User: melons)
Rizzle Kicks - Traveller's Chant (User: melons)
The Cactus Blossoms - Travelers Paradise (User: melons)
HAMIDASYSTEM - Sonzai Shinai Zonzai na Ai (User: melons)
Dan Lyons - Mr. Meaner (User: melons)
Gerard Way - Happy Together (feat. Ray Toro) (User: melons)
Parker Ainsworth - Running For So Long (House A Home) (User: melons)
Antipop Consortium - Ghostlawns (User: melons)
Ghostlawns - Motorik (User: melons)
Ghostland Observatory - Sad Sad City (User: melons)
A1 - Like a Rose (User: melons)
Fabian Wegerer - Wenn ich von Liebe rede (User: melons)
The Almighty Alpacas - Oxygen (User: melons)
Schmieds Puls - Joy (User: melons)
Radio Free Alice - Square (User: melons)
Radio Flower - I'm Alive (User: melons)
Radio Flower - I'm Alive (User: melons)
Freak Slug - Radio (User: melons)
Freak Slug - Radio (User: melons)
Radio Futura - Veneno en la Piel (User: melons)
Colorama - Dere Mewn (User: melons)
The Eccentronic Research Council - Autobahn 666 (Travelogue #1) (User: melons)
Rajwant - Beacon Radio 303 (User: melons)
United Ghosts - Unhypnotized (User: melons)
Rusty Bear - Source To Sea (User: melons)
Carpool Conversation - Sealed Off (User: melons)
Dingus Khan - Made a List (User: melons)
Scars - Psychomodo - Demo (User: melons)
Charly Bliss - Glitter (User: melons)
Bryan Dunn - Animal Skin (User: melons)
Disparition - If We Live (User: melons)
Rachael Sage - Try Try Try (User: melons)
Airospace - andromeda (User: melons)
The Royal They - Full Metal Black (User: melons)
Mal Blum - Robert Frost (User: melons)
Robby Hecht - The Ends and the Means (User: melons)
The Dream Masons - All or Nothing (User: melons)
Erin McKeown - You Cannot (User: melons)
Four Eyes - Everyone I Know (Will Die) (User: melons)
Sammus - Qualified (User: melons)
P.O.S - Faded (User: melons)
Brook Pridemore - Listening to TPM (User: melons)
Lera Lynn - Letters (User: melons)
Carrie Elkin - New Mexico (User: melons)
Hop Along - Well-Dressed (User: melons)
The Klezmatics - Fisherlid (User: melons)
London Boys - Requiem (User: melons)
Clem Snide - Ex-factor (User: melons)
Kim Boekbinder - The Sky Is Calling (User: melons)
Katie Kuffel - Table Song (User: melons)
Al Riggs - Local Honey (User: melons)
Good San Juan - Sharon (User: melons)
Jayne Trimble - Meet You At the Gate (User: melons)
God Is an Astronaut - Endless Dream (User: melons)
David Wirsig - Black Eyes (User: melons)
Rebecca Angel - I Love You Oddly (User: melons)
Unwoman - The Heroine (User: melons)
AJJ - Children of God (User: melons)
Aby Wolf - Align (User: melons)
Kim Tillman - Evelyn (User: melons)
scarves - Tag! (User: melons)
Against Me! - True Trans Soul Rebel (User: melons)
Doomtree - The Bends (User: melons)
Stöj Snak - State of Mine (User: melons)
Danny Schmidt - Serpentine Cycle Of Money (User: melons)
The Rizzos - Anything I Want You To (User: melons)
Y.R Generation - Understood (User: melons)
Pigpen Theatre Co. - Bremen (User: melons)
Nicholas Stevenson - Here I Land (User: melons)
Carrie Elkin - Echo in the Hills (User: melons)
Charming Disaster - Ghost Story (User: melons)
Dessa - Call Off Your Ghost (User: melons)
Brendan Maclean - Stupid (User: melons)
Sara Watkins - Take Up Your Spade (User: melons)
Eliza Rickman - Pretty Little Head (User: melons)
Senim Silla - Keep It Coming (User: melons)
Daniel Knox - What Have They Done To You Now (User: melons)
Gabriel Royal - Remember Us (User: melons)
Black City Lights - Offering (User: melons)
Jack Campbell - Absentee (User: melons)
Brainpower - Mijn Manier (User: melons)
Tom Milsom - Having Fun (User: melons)
Squalloscope - Big Houses (User: melons)
Nelson Poblete - Palabras de papel (User: melons)
Hussalonia - Never be famous (User: melons)
Simone Felice - You & I Belong (User: melons)
Doomtree - Team The Best Team (User: melons)
Mary Epworth - Long Gone (User: melons)
Hella - Biblical Violence (User: melons)
John Vanderslice - Too Much Time (User: melons)
Dengue Fever - Sni Bong (User: melons)
Robin Aigner - Get Me Home (User: melons)
Mystic - Neptune's Jewels (User: melons)
Barton Carroll - Those Day Are Gone, And My Heart Is Breaking (User: melons)
Anaïs Mitchell - Of A Friday Night (User: melons)
Adam Green - Cigarette Burns Forever (User: melons)
rachel kann - i know this: (User: melons)
Jason Webley - Last Song (User: melons)
Danny Schmidt - This Too Shall Pass (User: melons)
Two Gallants - Despite What You've Been Told (User: melons)
Dio - Aye (User: melons)
Dan Bern - Jerusalem (User: melons)
Chuck Brodsky - Bill & Annie (User: melons)
The Bad Plus - Flim (User: melons)
Nico - These Days - Slowed + Reverb (User: melons)
Marcus Arch - These Animals (User: melons)
These and the Other Guy - Like a Queen (User: melons)
These Animals - Murder Of Crows (User: melons)
These Anchored Bones - Get Out (User: melons)
Smash - El Garrotin (User: melons)
Animals That Swim - Faded Glamour (User: melons)
S*M*A*S*H - Real Surreal (User: melons)
Morphine - Buena (User: melons)
TV21 - Ambition (User: melons)
The Primary 5 - Off Course (User: melons)
World of Twist - She's a Rainbow (User: melons)
The Pre New - Cathedral City Comedown (User: melons)
Earl Brutus - The S.A.S. And The Glam That Goes With It (User: melons)
Scars - Horrorshow - Demo (User: melons)
Rank and File - Rank And File - Alternate Version (User: melons)
Thinkman - Best Adventures (User: melons)
Mackenzies - New Breed (User: melons)
Jon Butcher Axis - Life Takes a Life (User: melons)
Michael Stanley Band - He Can't Love You (Remastered) (User: melons)
Little Steven - Forever (User: melons)
E. Scarsdale - I'm Not David Niven (User: melons)
Willie Loco Alexander - David Niven & Errol Flynn (User: melons)
Dave Brubeck - The Desert and the Parched Land (User: melons)
Thomas-Louis Bourgeois - Cantates françoises, Livre I, Ariane: II. Prélude "Déserts où m'abandonne un ingrat" (User: melons)
Louis Hayes - Desert Moonlight (User: melons)
Louise Verneuil - Désert (User: melons)
Sam Feldt - Follow Me (User: melons)
Dustin Saylor - Desert Land (User: melons)
Dustin Lewit - Theatre Production and Other Forms of Desert Wind Eccentricities (User: melons)
Dustin Wong - Desert Via Hovercamel (User: melons)
danny george wilson - We've Got a Lot to Learn (User: melons)
Newsboys - STAND (User: melons)
The Dentists - Space Man (User: melons)
The Young Fresh Fellows - Picture Book (User: melons)
The Fatima Mansions - Angel's Delight (User: melons)
Birdland Nature - Birds Singing In the Rain (User: melons)
Rob Jungklas - Make It Mean Something (User: melons)
Korona - Let Me Be (User: melons)
Robbie Patton - Don't Give It Up (User: melons)
Prism - Don't Let Him Know (User: melons)
Dwight Twilley - Girls (User: melons)
Martha Davis - Don't Tell Me the Time (User: melons)
Sly Fox - Let's Go All the Way (User: melons)
The Lover Speaks - Every Lover's Sign - New York Mix (User: melons)
Vitamin Z - Gentle Mushrooms (User: melons)
Peter Godwin - U Samovara (User: melons)
Industry - State of the Nation (User: melons)
Surfbort - FML (User: melons)
Thyla - Rabbit Hole (User: melons)
Tomberlin - happy accident (User: melons)
Priestgate - Eyes Closed For The Winter (User: melons)
Wunderhorse - 17 (User: melons)
Horsey - Seahorse (User: melons)
Key Glock - Gang Shit No Lame Shit (User: melons)
KEYGEN CHURCH - Hareklavit (User: melons)
Gwen McCrae - Keep the Fire Burning (User: melons)
The Who - I Can See For Miles - Smothers Brothers Comedy Hour Remixed Version (User: melons)
Vvlvx - valentine (User: melons)
Pau - Fiesta de los Muertos (Tatuara Remix) (User: melons)
Parallels - Stardust (User: melons)
The Simps - On Fye (User: melons)
The Velveteers - Charmer And The Snake (User: melons)
Kills Birds - Cough Up Cherries (User: melons)
The Mysterines - Dangerous (User: melons)
Daisy Brain - Digital Atlas (User: melons)
Lynda DeFuria - Something to Do with Love (User: melons)
Ultra Q - It's Permanent (User: melons)
The Smile - You Will Never Work in Television Again (User: melons)
Liily - TV or Not TV (User: melons)
Sohodolls - Bang Bang Bang Bang (User: melons)
Dehd - Bad Love (User: melons)
Pom Pom Squad - Popular (feat. Matthew Caws of Nada Surf) (User: melons)
Bappi Lahiri - Tamma Tamma Again (User: melons)
Threnody Ensemble - ThaRoman (User: melons)
JFDR - My Work - Live (User: melons)
David Lang - Death Speaks: No. 1. You will return (User: melons)
Martyn Heyne - 2400 (User: melons)
Goldmund - Threnody (User: melons)
Roberto Musci - Claudia, Wilhelm R and me (User: melons)
Susanne Sundfør - Bedtime Story (User: melons)
Milosh - Slow Down (User: melons)
The Gentleman Losers - Honey Bunch (User: melons)
Christoph Willibald Gluck - Orfeo ed Euridice, Wq. 30 (Arranged by Sgambati): Melodie dell'Orfeo (User: melons)
Hjaltalín - Halo - Live on Icelandic National Radio (User: melons)
Lambert - Stay in The Dark (User: melons)
Phil France - The Swimmer (User: melons)
Ekko - Rehearsal (User: melons)
Carwyn Ellis & Rio 18 - Olá! (User: melons)
Aïsha Devi - I'm Not Always Where My Body Is (User: melons)
Huw Marc Bennett - Tresilian Bay (User: melons)
Bully - Just For Love (User: melons)
Softcult - Uzumaki (User: melons)
Pillow Queens - Be By Your Side (User: melons)
Robert Knight - Love on a Mountaintop (User: melons)
Wooden Shjips - Everybody Knows (User: melons)
Modern Baseball - Your Graduation (User: melons)
The Auteurs - Lenny Valentino (User: melons)
Martha Reeves & The Vandellas - Heatwave - Mono (User: melons)
Slaughter Beach, Dog - Acolyte (User: melons)
The Smiths - What Difference Does It Make? - John Peel Session 18/05/83 (User: melons)
Donovan - Sunshine Superman (User: melons)
Nine Inch Nails - Dead Souls - From "The Crow" Soundtrack (User: melons)
Nine Inch Nails - Dead Souls - From "The Crow" Soundtrack (User: melons)
bryan's magic tears - Superlava (User: melons)
William Onyeabor - Atomic Bomb (User: melons)
Marc and the Mambas - Black Heart (User: melons)
Sex Gang Children - Sebastiane (User: melons)
Tones on Tail - go! - club mix (User: melons)
Dalis Car - His Box (User: melons)
Justin Timberlake - Man of the Woods (User: melons)
The Soggy Bottom Boys - I Am A Man Of Constant Sorrow - Radio Edit (User: melons)
Fake Fruit - I Am the Car (User: melons)
Smoke Bellow - Fee Fee (User: melons)
Dean Wareham - The Past is Our Plaything (User: melons)
Julia Shapiro - Death (XIII) (User: melons)
Cindy - Party Store (User: melons)
BNNY - Time Walk (User: melons)
Lily Konigsberg - Sweat Forever (User: melons)
Dummy - Final Weapon (User: melons)
Kiwi Jr. - Cooler Returns (User: melons)
The Umbrellas - Near You (User: melons)
motorists - Surrounded (User: melons)
Chime School - Taking Time to Tell You (User: melons)
Massage - Half A Feeling (User: melons)
The Reds, Pinks and Purples - New Light (User: melons)
Angelo Badalamenti - Laura Palmer's Theme - Instrumental (User: melons)
Ash Code - Drama (User: melons)
Sheridan Tongue - Counting Down (User: melons)
Bessie Jones - Buzzard Lope (User: melons)
Tarheel Slim - Number 9 Train (User: melons)
Rufus Harley - Crack (User: melons)
Damu The Fudgemunk - Tulips (User: melons)
Eddie Harris - I Don't Want Nobody (User: melons)
Benny Goodman - Four Brothers / Anita's Blues (Live) (User: melons)
Don-E - Love Makes The World Go Round (User: melons)
Bassheads - Back To The Old School (User: melons)
The Olympians - Pluto's Lament (User: melons)
Razika - Faen ta deg (User: melons)
Ringo Deathstarr - Gazin' (User: melons)
Lisa Hannigan - My Little Reason Why (User: melons)
Ringo Deathstarr - Gazin' (User: melons)
Heather Duby - The Most Terrible Trip In The World (User: melons)
Eire Apparent - Rock 'n' Roll Band (User: melons)
Readymade - Moten (User: melons)
Koleżanka - Vegan Sushi (User: melons)
Marc and the Mambas - In My Room (User: melons)
Paul Draper - Omega Man (feat. Steven Wilson) - Single Edit (User: melons)
Mick Karn - Sensitive (User: melons)
Pye Corner Audio - Theme Number Sixty Eight (User: melons)
Tim Garland - The Autumn Gate (User: melons)
Eve Adams - Blues Look the Same (User: melons)
old man of the woods - Running (User: melons)
7VWWVW - HMS Mammal (User: melons)
We Are Joiners - Combat Kid (User: melons)
Dummy - Daffodils (User: melons)
Molly Linen - Home (User: melons)
Ben Lamar Gay - Hood Rich Happy (User: melons)
Natalie Jane HIll - Euphoria (User: melons)
Sirconical - jambon mama (User: melons)
Mum & Dad - Dawn Rider (User: melons)
Kara's Flowers - Oliver (User: melons)
Owsley - Oh No The Radio (User: melons)
Matchbox Twenty - Busted (User: melons)
Letters to Cleo - Demon Rock (User: melons)
D-A-D - Reconstrucdead - 2009 - Remaster (User: melons)
Everlone - Dreaming is for Free (User: melons)
Third Eye Blind - The Red Summer Sun - 2008 Remaster (User: melons)
Candlebox - Best Friend (User: melons)
TV In Flames - Give It Up (User: melons)
Skid Row - My Enemy (User: melons)
Jane Child - Step Out of Time (User: melons)
Dramarama - Tiny Candles (User: melons)
Cecil - Lovetooth 14 (User: melons)
Scott Weiland - Opposite Octave Reaction (User: melons)
The Screamin' Cheetah Wheelies - Slow Burn (User: melons)
Scott Weiland - Opposite Octave Reaction (User: melons)
The Sheila Divine - Hum (User: melons)
Clutch - Animal Farm (User: melons)
Seven Mary Three - Cumbersome (User: melons)
For Love Not Lisa - Seasick (User: melons)
Talk Show - Ring Twice (User: melons)
Orgy - Eva (User: melons)
Neurotic Outsiders - Seattle Head (User: melons)
Biohazard - Modern Democracy (User: melons)
P.O.D. - Follow Me (User: melons)
Staind - Mudshovel (User: melons)
Kyuss - 100° (User: melons)
Magic Dirt - Heavy Business (User: melons)
Rocky Votolato - Portland Is Leaving (User: melons)
Sodastream - Twin Lakes (User: melons)
Crake - Enough Salt (For All Dogs) (User: melons)
Singing Adams - No Rock Song (User: melons)
Inside Looking Out - Skyrocketing Times - How to Loot Brazil Remix (User: melons)
Mel Tormé - Putting on the Ritz (User: melons)
Carmen Miranda - Disseram Que Voltei Americanizada (User: melons)
Goldie Hawn - I'll Be Your Baby Tonight (User: melons)
Coleman Barks - The Freshness (User: melons)
Debra Winger - The Mirror (User: melons)
Sonja Sohn - The Agony and Ecstasy of Divine Discontent (User: melons)
Laura Day - The Agony of Lovers (User: melons)
Gautama Chopra - The Mythical Lover (User: melons)
Sussan Deyhim - Defeated by Love (User: melons)
Sussan Deyhim - Defeated by Love (User: melons)
Robert Thruman - Dying To Love (User: melons)
Jared Harris - looking for your face (User: melons)
Blythe Donner - Behind The Scenes (User: melons)
Robert John Burke - I Am Yours (User: melons)
Martin Sheen - Caught in the Fire of Love (User: melons)
Deepak Chopra - Desire (User: melons)
Pixies - Where Is My Mind? - Remastered (User: melons)
Trygve Seim - In Your Beauty (User: melons)
Julius La Rosa - Eh, Cumpari! (User: melons)
Suicidal Tendencies - Institutionalized (User: melons)
The Verve Pipe - Villains (User: melons)
Taxiride - Get Set (User: melons)
Huffamoose - Wait (User: melons)
Pushmonkey - Handslide (User: melons)
Knapsack - Cellophane (User: melons)
Pete Droge - Under the Waves (User: melons)
[spung - Kicking Pigeons (User: melons)
Sponge - Molly (16 Candles) (User: melons)
oh my god elephant - Dan Dan Dan Dan (User: melons)
Material Issue - Valerie Loves Me (User: melons)
Maria McKee - Show Me Heaven - From "Days of Thunder" (User: melons)
Dora Jar - Polly (User: melons)
Summercamp - Drawer (User: melons)
Freedy Johnston - Bad Reputation (User: melons)
Splender - Yeah, Whatever (User: melons)
The Why Store - Lack Of Water (User: melons)
CIV - Can't WaIt One Minute More (User: melons)
The Flys - Got You (Where I Want You) (User: melons)
The Nixons - Sister (User: melons)
Dada - Dizz Knee Land (User: melons)
Marvelous 3 - Freak of the Week (User: melons)
Athenaeum - What I Didn't Know (User: melons)
School Of Fish - 3 Strange Days (User: melons)
Wax - California (User: melons)
Cowboy Mouth - Jenny Says (User: melons)
Gravity Kills - Guilty (User: melons)
I Mother Earth - One More Astronaut (User: melons)
Luscious Jackson - Naked Eye (User: melons)
Tracy Bonham - Mother Mother (User: melons)
For Squirrels - 8:02 PM (User: melons)
Geggy Tah - Whoever You Are (User: melons)
Datcha mandala - Stick It Out (User: melons)
Dirty Deep & Yarol - Two Rocks in a Whiskey (User: melons)
Stuck in the Sound - Vegan Porn Food (User: melons)
the last target - High Pride (User: melons)
7 Weeks - Gone (User: melons)
Noiseheads - Homecoming (User: melons)
Yard of Blondes - Murderology (User: melons)
The Harts Industry - Water Snakes (User: melons)
Purrs - Sink (User: melons)
dirty black summer - Your Great Deception (User: melons)
DEAD HORSE ONE - Echo Street (User: melons)
Cold Valley - Devil in sight (User: melons)
POGO CAR CRASH CONTROL - Déprime hostile (User: melons)
Murder at the Pony Club - Pretty Vicious Summer (User: melons)
Ready For Mars - O.E. (User: melons)
Servo - Tree (User: melons)
Jack and the Bearded Fishermen - Beware Of Birds (User: melons)
Ko Ko Mo - Self love age (User: melons)
Last Train - Disappointed (User: melons)
Big Mountain County - What? (User: melons)
New Favourite - Bad Milk (User: melons)
Trainfantome - Vulgar (User: melons)
Stuffed Foxes - Oh Lord, it came to me (User: melons)
L'Effondras - Anhedonia (User: melons)
Iron Lizards - It's About Time ! (User: melons)
Vain Valkyries - Table Rase (User: melons)
Nobody's Cult - Hangover (User: melons)
No One Is Innocent - Forces du désordre (User: melons)
Kamggarn - Lonesome Terror (User: melons)
Pales - Get Out (User: melons)
Cheap Teen - Fake Flowers (User: melons)
Hallowed Ground - I'm Not Shallow Anymore (User: melons)
MSS FRNCE - Pas la peine (User: melons)
Top Tier - Leaving This Behind (User: melons)
JIVRE - Jocelyne (User: melons)
Colision - KNEES (User: melons)
Blue Orchid - Here Comes the Sun (User: melons)
The Bad News - Never let you go (User: melons)
Team Ghost - A Glorious Time (User: melons)
Totorro - Chevalier Bulltoe (User: melons)
Pencey Sloe - Lust of the Dead (User: melons)
Lane (Love And Noise Experiment) - Voices (User: melons)
Alcest - Sapphire (User: melons)
MNNQNS - If Only They Could (User: melons)
Bison Bisou - Hypersects (User: melons)
Equipe de Foot - Fireworks (User: melons)
Mascara - Reach (User: melons)
Howard - Quicklime (User: melons)
Brama - Ai tant Montat (User: melons)
A Void - Stepping On Snails (User: melons)
Fils. - Vasy (User: melons)
You Said Strange - Cold Crusader (User: melons)
Jessica93 - R.I.P. in Peace (User: melons)
W!Zard - Bones (User: melons)
Fabulous Sheep - Parasite (User: melons)
J.C. Satàn - No Brain No Shame (User: melons)
Dewaere - Get Down (User: melons)
Lysistrata - Asylum (User: melons)
Bantam Lyons - Branque (User: melons)
Calum MacDonald - An Toll Dubh (Arr. Marcus Warner) (User: melons)
Von Pariahs - I Want Her (User: melons)
Cathedrale - Gold Rush (User: melons)
TH Da Freak - Peeling The Onion (User: melons)
Johnny Mafia - Split Tongue (User: melons)
The Inspector Cluzo - A Man Oustanding In His Field (User: melons)
DYE CRAP - Cooloroonie (User: melons)
Bandit Bandit - Siamese love (User: melons)
Park - Réveil heureux (User: melons)
Rendez Vous - Sentimental Animal (User: melons)
The Psychotic Monks - It's Gone (User: melons)
Mad Foxes - Crystal Glass (User: melons)
Unschooling - NYE (User: melons)
We Hate You Please Die - Can't Wait to Be Fine (User: melons)
Slift - Ummon (User: melons)
The Real Thing - You to Me Are Everything (User: melons)
Kenta Jirou - 12000 Mph (User: melons)
Stadio - Lunedì Cinema (User: melons)
Mc Aese - Regálame La Libertad (feat. Alfred Cave) (User: melons)
Sebastian Yatra - Como Mirarte (User: melons)
Romo One - el siempre juntos (User: melons)
Shé - A 700 km (con Elena) (User: melons)
Jennix - No Debiste Ilusionarme (User: melons)
Bamby Ds - Te Dejo En Paz (User: melons)
La Lenta Love Rap - Enséñame a Vivir Sin Ti (User: melons)
Mc J Rap - Nuestra Historia Llegó a Su Fin (User: melons)
Mc Jozeph - Duele Verte Con Él (User: melons)
Melodicow - Tan Solo Dile (User: melons)
Manhy - No Te Voy a Dejar (User: melons)
Jhobick Zamora - Me Enamore de Mi Mejor Amiga (1,2,3) (User: melons)
Mc davo - Debes De Saber (User: melons)
Mc Aese - Dile Que (feat. Romo One) (User: melons)
Xion MC - Todo Terminó (User: melons)
Porta - Palabras Mudas (User: melons)
Maniako - Mi Droga Favorita (User: melons)
Dezear - No Soy Ella (User: melons)
Signo Rap - Aún Me Amas (User: melons)
Smoky - Ya Es Muy Tarde (feat. Zinaloka) (User: melons)
Melodico - Tu Adiós (User: melons)
c-kan - Vuelve (feat. MC Davo) (User: melons)
Miguel Angel ElGenio - Si Pudiera (Acustico) (User: melons)
Kevin El Autorizado - Dime (User: melons)
santa rm - Me gustas (User: melons)
Guelo Deluxe - Necesito de Ti (User: melons)
Jhobick Zamora - Me Enamoré de Mi Mejor Amiga (User: melons)
Neztor Mvl - Aunque Ya No Volveras (User: melons)
Xion MC - Fuiste Tú (User: melons)
Mc Richix - Me Enamoré de la Persona Equivocada (User: melons)
LONDER Y JC - No Te Salgas De Mi Corazón (User: melons)
Melodico - No Te Merezco (User: melons)
Miguel Angel ElGenio - Te Volvi a Ver (User: melons)
Mc Jozeph - Sin mi estás mejor (User: melons)
santa rm - Cuídala bien (User: melons)
Guelo Deluxe - Lo Cambiaste Todo (User: melons)
Porta - La Bella Y La Bestia (Con Norykko) (User: melons)
Elias Ayaviri - Contigo Aprendi (User: melons)
Neztor Mvl - No Te Importo (User: melons)
La Lenta Love Rap - Dile A Tu Amiga (User: melons)
Mc Richix - Carta a un ex amor (User: melons)
TC - Where's my Money - Caspa Remix (User: melons)
Afrikan Boy - Lidl (User: melons)
Tinchy Stryder - Stryderman (User: melons)
"Weird Al" Yankovic - White & Nerdy (Parody Of "Ridin'" By Chamillionaire Feat. Krayzie Bone) (User: melons)
Ne-Yo - Closer (User: melons)
3 of a Kind - Babycakes (User: melons)
Gracious K - Migraine Skank - Main Mix (User: melons)
Soulja Boy - Crank That (Soulja Boy) (User: melons)
Ironik - Stay With Me (Everybody's Free) (User: melons)
Jordin Sparks - No Air (feat. Chris Brown) (User: melons)
Tahúres Zúrdos - Miles De Besos (User: melons)
Los Burros - Huesos (User: melons)
Burning - Mueve Tus Caderas (User: melons)
Isabel Montero - Cada Parte de Ti (User: melons)
Sergio Facheli - Fuego (User: melons)
Danny Daniel - ¿Te Quedas Con el o Te Vienes Conmigo? (User: melons)
Lorenzo Santamaria - Para Que No Me Olvides (User: melons)
Juan Bau - La Estrella de David (User: melons)
Santabarbara - Charly (User: melons)
Braulio - Dejalo Volver (User: melons)
LOS ANGELES - Mañana, Mañana (User: melons)
Los Diablos - Un Rayo de Sol (User: melons)
Mochi - Mami Panchita (User: melons)
Tony Ronald - Help, Get Me Some Help (User: melons)
Mari Trini - Yo No Soy Esa (User: melons)
Bacchelli - Abrazame (User: melons)
Sandro Giacobbe - El Jardin Prohibido (User: melons)
Jeanette - Soy Rebelde (User: melons)
Los Amaya - Vete (User: melons)
Rumba Tres - No Se, No Se (User: melons)
Los Payos - Maria Isabel (User: melons)
Santabarbara - Donde Estan Tus Ojos Negros (User: melons)
Micky - Enséñame A Cantar (User: melons)
Elsa Baeza - Credo (User: melons)
Andrés Do Barro - Me estoy volviendo loco (User: melons)
Víctor Manuel - El Abuelo Vitor (User: melons)
Emilio José - Soledad (User: melons)
Los Salvajes - Nacido para Ser Salvaje (User: melons)
Los Gritos - La Vida Sigue Igual (User: melons)
Los 3 sudamericanos - Me Lo Dijo Perez (User: melons)
Los Albas - Los Ejes de Mi Carreta (User: melons)
Los Idolos - No Desperdicies Tu Amor (User: melons)
Los Mismos - El Puente (User: melons)
Pop Tops - Mamy Blue (User: melons)
Los Stop - Tres cosas - Salud, dinero y amor (User: melons)
Los Mustang - La Plaga (User: melons)
Johnny & Charlie - La Yenka (User: melons)
Concha Velasco - Chica Ye Ye (User: melons)
Karina - El Baul de los Recuerdos (User: melons)
Richard Anthony - En Aranjuez Con Tu Amor (User: melons)
Nicola Di Bari - Corazon Gitano (User: melons)
Rita Pavone - Como Tu No Hay Ninguno (User: melons)
Salvatore Adamo - cae la nieve (User: melons)
Jimmy Fontana - El Mundo (User: melons)
Frida Boccara - La Casa del Sol Naciente (User: melons)
Jorge Sepúlveda - Mirando al mar (User: melons)
Bonet de San Pedro - Bajo el Cielo de Palma (User: melons)
Los 5 Latinos - Un Telegrama (User: melons)
José Guardiola - Soy Americano (User: melons)
Andy Russell - Soy un Extraño (User: melons)
Gloria Lasso - Luna de Miel (User: melons)
Mélonade - Dreams We Share (User: melons)
Johnny Pacheco - Esto Si Se Llama Querer (User: melons)
Melony - Fire (User: melons)
Neck Deep - Can't Kick Up the Roots (User: melons)
bzur - Memories (User: melons)
Lemonade Market - Space Administration (User: melons)
Spill Gold - Ecotone, Pt. 2 (User: melons)
Tai'Aysha - One Night Ting (feat. Saweetie) (User: melons)
laura les - Haunted (User: melons)
Landon McNamara - Hang Loose (User: melons)
t+pazolite - Tempestissimo (User: melons)
Olivier Deriviere - It Begins (User: melons)
Black Gryph0n - Heaven 2 Hell (User: melons)
Sierra Nelson - C.H.E.R.U.B Jingle (User: melons)
Borrtex - Flowing (User: melons)
Sam Haft - My World Is Burning Down Around Me (by F-ck You Dad) (User: melons)
matteo manfredi - Coffee, Cigarettes & Jazz (User: melons)
Silva Hound - Vox's Interlude (User: melons)
Jason L. Smith - The Place to Be (User: melons)
Bobby Cole - Status Quo (User: melons)
Joel Hunger - Acoustic (User: melons)
Kevin Macleod - Fluffing a Duck (User: melons)
Michael Vignola - Halo (User: melons)
Adrián Berenguer - Continent (User: melons)
Francois Couture - Sabbatique (User: melons)
Henry Purcell - Suite No. 1 In G Major, Z. 660: I. Prelude (User: melons)
Jonathan Geer - Owlboy Main Title (User: melons)
Davinia Leonne - Thank You (User: melons)
Klangriket - Judarn (User: melons)
Peter Godfrey - Peaceful Piano (User: melons)
The Echo Project - Sounds Like Grunge (User: melons)
Dreamer Boy - Joy (User: melons)
DUCKWRTH - Weekend? (User: melons)
Mariah the Scientist - Hotel (Interlude) (User: melons)
Steve Lacy - atomic vomit (User: melons)
Saint Ivory - Prologue (User: melons)
Between Friends - scubadiveee (User: melons)
Victoria Monét - Open Your Eyes (Interlude) (User: melons)
Zacari - Redemption Interlude (User: melons)
Gia Ford - CHANGE INTERLUDE (User: melons)
Amaarae - DAZED AND ABUSED IN BEVERLY HILLS (User: melons)
orion sun - Waiting in the Car (Interlude) (User: melons)
lovelytheband - filling a void - interlude (User: melons)
Crvddyrell - Srt (Interlude) (User: melons)
Brent Faiyaz - Make It Out (User: melons)
Mac Ayres - Where Do We Go from Here? (User: melons)
Chloe x Halle - Overwhelmed (User: melons)
Odunsi (The Engine) - rare (User: melons)
datfootdive - stay (User: melons)
Rina Sawayama - Time Out - Interlude (User: melons)
Everlone - 90% - live-95 (User: melons)
Beth Crowley - Annoying Songs (User: melons)
Otto - Jumping Jane (User: melons)
Daorongguang - Shange diao (Mountain song) (User: melons)
Typhoon - Caesar (User: melons)
Charlie's Angels - Seinfeld (User: melons)
Michael Cera - Smoke Eyes (User: melons)
Califone - One (User: melons)
Incorporeal Visions Deluxe - MarbleArch (User: melons)
Andrew Huang - The Cave (User: melons)
Deca - The Way In (User: melons)
The Frogs - I'm Hungry for Whores (User: melons)
Aikeem Vill - Exit (User: melons)
Persian Empire - fuckyouiphonespeakers (User: melons)
Sean Hayes - When Did It Hit You? (User: melons)
Isan - Bubbles8 (User: melons)
Lone - Buried Coral Banks (User: melons)
Dan Sartain - Fuck Friday... (User: melons)
Kero Kero Bonito - Gateway (User: melons)
Jóhann Jóhannsson - Entering The City - From “Varmints” Soundtrack (User: melons)
Clown Core - Van (User: melons)
Steven Universe - Giant Woman (feat. Zach Callison) (User: melons)
The Beets - Eat No Dick (User: melons)
18 Carat Affair - Memphis Design (User: melons)
Western Motel - Chicken Bacon Guacamole (User: melons)
Mndsgn - inhale (User: melons)
kai bravewood - good morning (User: melons)
Free Cake For Every Creature - I'll Blade with You Baby (User: melons)
Arvo Pärt - Lamentate: Fragile - (User: melons)
Donato di Stefano - Le Nozze Di Figaro (The Marriage Of Figaro), K. 492: Act I Scene 2: Recitativo - Bravo, Signor Padrone! (User: melons)
draag me - Coming Home (User: melons)
knife girl - i wish you'd realize that i'm actually crying when i tell you i'm fine (User: melons)
aivi & surasshu - 38 (User: melons)
Doc Watson - Rambling Hobo (User: melons)
Clarence Clarity - Become Death (User: melons)
Les Baxter - Goliath's March (Main title) (User: melons)
MIMIDEATH - if god didnt want us to snort worms he wouldn't have made them cylindrical! (User: melons)
toe - 反逆する風景 (User: melons)
Howard Shore - Ed Wood Suite: V. — (User: melons)
Porn Sword Tobacco - My Lovely Wife Becky (User: melons)
Michael Giacchino - Free Skating (User: melons)
A Balladeer - Robin (User: melons)
Koushik - Homage (User: melons)
Mice Parade - Remember the Magic Carpet (User: melons)
Schwey - Falling Action (User: melons)
Incorporeal Visions Deluxe - Dystopian Mall (User: melons)
Nadieh - Love Letter (User: melons)
Julie Brunet - The Charterhouse (User: melons)
Fred Frees - I Will Insinuate Myself for Some Tummy Tickle Time. (User: melons)
Sound Effects - Lightning Strike Huge, Thunder & Rain (User: melons)
S. P. Balasubrahmanyam - Anjaneya Madhi (User: melons)
Ringtone Truetones - We Are Santa's Elves (Ring Tone) (User: melons)
Super Heroes - Pink Panther (User: melons)
Ringtones & Company - Ringtones: Ak 47 Ifighter (User: melons)
Sound FX - Beethoven's Fifth Fart - Comedy Ring Tone (User: melons)
Wake Up Tones Alarm Clock Sounds - Norwegian Wood - Pure Nature Wake Up Ringtone (User: melons)
Newcastle - Newcastle Local Hero (User: melons)
Manchester United - We'll Do What We Want (User: melons)
Liverpool - Fields of Anfield Road (User: melons)
Fans Forever - Arsenal Till I Die (User: melons)
Ringtones - Vivaldi Tunes 1 (User: melons)
100 High Quality Ringtones - S.w.a.t. - TV Themes (User: melons)
Platnum - Love Shy (Thinking About You) - Virgo vs. Agent X Edit (User: melons)
Dick Van Dyke and The Vantastix - Supercalifragilisticexpialidocious (User: melons)
Tinie Tempah - Wifey (User: melons)
Akon - Lonely (User: melons)
T.I. - Whatever You Like (User: melons)
Wiley - Too Many Man (User: melons)
H Two O - What's It Gonna Be (feat. Platnum) (User: melons)
N-Dubz - I Swear (User: melons)
T2 - Heartbroken - Edit (User: melons)
Future Islands - Like the Moon (User: melons)
Future Islands - King of Sweden (User: melons)
David Bowie - Fashion - 2017 Remaster (User: melons)
David Bowie - Rock 'N' Roll Suicide - Live (User: melons)
David Bowie - The Width Of A Circle - Live (User: melons)
David Bowie - Changes - 2015 Remaster (User: melons)
Meanwhile, Back in Communist Russia... - New Adventures (User: melons)
Shadowplay - Too Good To Be True (User: melons)
Ratsia - Täältä tulee yö (User: melons)
Ratsia - Lontoon skidit - Single Edit (User: melons)
Gaffers - The Surf Was Gone (User: melons)
Chain Smoker - Red Eyeliner (User: melons)
Jasper Pattison - Later (User: melons)
Mäkkelä's Trash Lounge - Stalker (User: melons)
Brandi Ifgray - Bones (User: melons)
Drekka - vocal 1 (User: melons)
Aavikko - Seikkailu villi (User: melons)
Custome Drummer - Jubilat Theme - Custome Drummer Meets Miss Impossible (User: melons)
farwerk - Gold (User: melons)
Vida - What's Going Around (User: melons)
SAP - Feel It (User: melons)
Paisley Sundae - Had Someone (User: melons)
The Rising - I Want You (User: melons)
The Gallerys - Imperfect Imperfection (User: melons)
The Liberty Ship - What Point (User: melons)
Paul Fletcher and The Dukes - 22.02 (User: melons)
Hollow Nothing - Game of Love (User: melons)
Stray Scene - The Day the Clown Cried (User: melons)
Scarlet - Heavy Exchange (User: melons)
John McCullagh - New York City (User: melons)
Veludo Planes - LUNA (User: melons)
Little Liam - Need You Tonight (User: melons)
The Velcro Teddy Bears - Somebody (User: melons)
The Slow Readers Club - I Saw A Ghost (User: melons)
Sisteray - Gentrification (User: melons)
White Room - I Think Too Much (User: melons)
Carolina Gaitán - La Gaita - We Don't Talk About Bruno (User: melons)
Todmobile - Pöddulagið (User: melons)
Köhlbrand - Tokyo Sexwhale (The Old Man and the Sea) (User: melons)
Trabant - Äta eller ätas (User: melons)
Dwayne Johnson - You're Welcome (User: melons)
Jemaine Clement - Shiny (User: melons)
Lea Salonga - Honor To Us All (User: melons)
Jón Jónsson - Ef ástin er hrein (feat. GDRN) (User: melons)
Young Karin - Hearts (User: melons)
Prins Póló - París norðursins (User: melons)
Milkywhale - Birds of Paradise (User: melons)
Zebda - Tomber La Chemise (User: melons)
Maus - The Wizard (User: melons)
Biggi Maus - Fyrirgefning (User: melons)
Trabant - The One (User: melons)
Hjaltalín - Þú komst við hjartað í mér (User: melons)
Model - Lífið er lag (User: melons)
Model - PEMBE MEZARLIK (User: melons)
Camille Saint-Saëns - Carnival of the Animals: The Swan (User: melons)
Ivor Biggun - Cucumber Number (User: melons)
Victoria Wood - Barry And Freda - Live (User: melons)
George Formby - Leaning On a Lamp Post (User: melons)
Joyce Grenfell - Olde Tyme Dancing (User: melons)
Noël Coward - London Pride (User: melons)
Spike Milligan - The Q5 Piano Tune (User: melons)
Hive Society - Coasting (User: melons)
Voodoo - The Killing Musket (User: melons)
Hate - City On Ice (User: melons)
Charlie Gearon - Alcoholic (User: melons)
Native Cell - Valtronox (User: melons)
Jean-Pierre Massiera - Bonne Année (User: melons)
Silverbacks - Dunkirk (User: melons)
Omar Perez-Then - Palmera (User: melons)
Heavy Trash - Pimento (User: melons)
Grand Mal - Lower Yer Heart (feat Ken Griffin) (User: melons)
Chris Knox - The Face of Fashion (User: melons)
Cactus Vibrance - Noodle Soup (User: melons)
Manufactured Superstars - You Got the Love (User: melons)
Oscar the Grouch - The Noodle Song (User: melons)
Wendy Ho - Poop Noodle (User: melons)
cheezus - ZEEK (User: melons)
Lunachicks - Don't Want You (User: melons)
The Dictators - California Sun (User: melons)
Cold Cold Hearts - 5 Signs: Scorpio (User: melons)
Sex Stains - Period. Period. (User: melons)
Partyline - Nuthaus (User: melons)
Bratmobile - Are You a Lady? (User: melons)
Fatty Cakes and the Puff Pastries - PANIC ATTACK (User: melons)
The Rubinoos - I Wanna Be Your Boyfriend (User: melons)
Podium - Танцуй пока молодая (User: melons)
Podium - Plan B (User: melons)
Pódium - Céntrate (User: melons)
Snõõper - Running (User: melons)
The Fevers - Give Me a Sign (User: melons)
The Fevers - Mar De Rosas (I Never Promised You A) (Rose Garden) (User: melons)
Carbonas - Phone Booth (User: melons)
Brontez Purnell - Forgive Me, Philip (User: melons)
TWOMPSAX - Eight (User: melons)
The Dirtbombs - Chains of Love (User: melons)
Shannon Shaw - Goodbye Summer (User: melons)
Hunx and His Punx - You Think You're Tough (User: melons)
Vernon Dalhart - The Runaway Train (User: melons)
Benny Hill - Ernie (The Fastest Milkman in the West) - 2003 Remaster (User: melons)
Alma Cogan - In the Middle of the House (User: melons)
Shirley Abicair - Little Boy Fishing - 2003 Remaster (User: melons)
Flanders & Swann - The Gnu Song - 2003 Remaster (User: melons)
Eve Boswell - Pickin' a Chicken - 2003 Remaster (User: melons)
Ann Stephens - Buckingham Palace - 2003 Remaster (User: melons)
St. Winifred's School Choir - There's No One Quite Like Grandma - 2003 Remaster (User: melons)
Uncle Mac - Oranges And Lemons (User: melons)
Arthur Askey - The Bee Song (User: melons)
Jon Pertwee - I Know An Old Lady (User: melons)
Alvin & The Chipmunks - Pop Goes The Weasel (User: melons)
Pinky & Perky - The Grand Old Duke Of York (User: melons)
Diana Decker - Kitty in the Basket - 2003 Remaster (User: melons)
Kenneth Williams - Green Grow My Nadgers Oh! (User: melons)
Morecambe & Wise - Boom Oo Yata-Ta-Ta - 2003 Remaster (User: melons)
The Scaffold - Lily the Pink - 2003 Remaster (User: melons)
The Billy Watson Band & Singers - Quartermaster's Store (User: melons)
Peter Sellers - Bangers and Mash - 2003 Remaster (User: melons)
Tim Hart And Friends - Nick-Nack Paddywack - 2003 Remaster (User: melons)
Mandy Miller - Nellie The Elephant (User: melons)
Clive Peterson - When I See An Elephant Fly (User: melons)
Charles Penrose - The Laughing Policeman (User: melons)
Flanagan & Allen - Run Rabbit Run - 2003 Remaster (User: melons)
Bernard Cribbins - Right Said Fred - 2003 Remaster (User: melons)
Amanaz - Khala My Friend (User: melons)
David Karsten Daniels - Reaching (User: melons)
Mumm-Ra - What Would Steve Do? (User: melons)
The Noise Next Door - Calendar girl (User: melons)
Protocol - Sorry (User: melons)
747s - Night And Day (User: melons)
