A Tribe Called Quest - Check the Rhime (User: melons)
Yvonne Elliman - If I Can't Have You - From "Saturday Night Fever" (User: melons)
The Field Mice - Missing the Moon (User: melons)
Mickey Callisto - This Is The Real world (User: melons)
Panjabi MC - Panjaban (User: melons)
Hridoy Khan - Ki Kore Bhulecho (User: melons)
Baby Dave - Washing Machine (User: melons)
Nikhita - Aphrodite (User: melons)
randombrownkid. - when im around u. (User: melons)
Eloi - Embarrassed (User: melons)
Deema - Maddie (User: melons)
Pearling - Demiurge (User: melons)
Surya Sen - Buccho Ni Ba Bhai (Grindin') (User: melons)
Mickey Callisto - Destructive Love (User: melons)
Eloi - Embarrassed (User: melons)
Nani - Darling (User: melons)
Dinosaur 94 - Love Impaired (User: melons)
Cyrano - White Wine (User: melons)
Eve Simpson - I Can See a Face (User: melons)
Quiet houses - Cold Water Swimming (User: melons)
Wiki - All I Need (User: melons)
Constant Follower - The Merry Dancers On TV (User: melons)
ME REX - Jupiter Pluvius (User: melons)
Deema - Maddie (User: melons)
Super Furry Animals - Ice Hockey Hair (User: melons)
Black Sheep - The Choice Is Yours (Revisited) (User: melons)
Mary J. Blige - Real Love (User: melons)
Jane's Addiction - Stop (User: melons)
Gang Starr - Mass Appeal (User: melons)
Pavement - Gold Soundz (User: melons)
Common - I Used to Love H.E.R. (User: melons)
Morrissey - Now My Heart Is Full - 2014 Remaster (User: melons)
Common - I Used to Love H.E.R. (User: melons)
The Notorious B.I.G. - Juicy - 2005 Remaster (User: melons)
The Jon Spencer Blues Explosion - Bellbottoms (User: melons)
Radiohead - Paranoid Android (User: melons)
Ms. Lauryn Hill - Doo Wop (That Thing) (User: melons)
The Dismemberment Plan - The City (User: melons)
Isolée - Beau mot plage (User: melons)
Julee Cruise - Falling (User: melons)
UGK - One Day (User: melons)
Björk - Hyperballad - Radio Edit (User: melons)
Air - All I Need (feat. Beth Hirsch) (User: melons)
2Pac - I Get Around (User: melons)
Kelis - Caught Out There (User: melons)
Pixies - Alec Eiffel (User: melons)
Daniel Johnston - Some Things Last a Long Time (User: melons)
The Auteurs - Unsolved Child Murder (User: melons)
Tricky - Christiansands (User: melons)
Blur - Girls & Boys - 2012 Remaster (User: melons)
Mazzy Star - Fade Into You (User: melons)
Positive K - I Got a Man (Re-Recorded / Remastered) (User: melons)
Saint Etienne - Avenue (User: melons)
The Magnetic Fields - Epitaph for My Heart (User: melons)
The Magnetic Fields - I Thought You Were My Boyfriend (User: melons)
The Magnetic Fields - Take Ecstasy With Me (User: melons)
The Magnetic Fields - The Dreaming Moon (User: melons)
The Magnetic Fields - Absolutely Cuckoo (User: melons)
Shirley Ellis - The Clapping Song (Clap Pat Clap Slap) (User: melons)
3 of a Kind - Babycakes (User: melons)
Zager & Evans - In The Year 2525 (Exordium & Terminus) (User: melons)
Steve Winwood - While You See A Chance (Remastered 2010) (User: melons)
Steve Winwood - While You See a Chance (User: melons)
The Tymes - Miss Grace (User: melons)
Soundtrack - Everybody Dance (User: melons)
The Doobie Brothers - Long Train Runnin' (User: melons)
Vendla - Don't Open Your Eyes (User: melons)
The Magnetic Fields - I Don't Really Love You Anymore (User: melons)
A-Trak - Bubble Guts - Braxe + Falcon Remix (User: melons)
Big Moochie Grape - East Haiti Baby (User: melons)
namir blade - Award Speech (User: melons)
Moor Mother - WOODY SHAW (User: melons)
070 Shake - Medicine (User: melons)
LYZZA - Lucky You (User: melons)
Brian Jackson - All Talk (User: melons)
Lou Reed - I'm Waiting for the Man - May 1965 Demo (User: melons)
Kaitlyn Aurelia Smith - Is it Me or is it You? (User: melons)
Grace Ives - Shelly (User: melons)
Part Time - I Can't Get You Out (User: melons)
Sam Gendel - Two-Tone (User: melons)
Kadhja Bonet - JGS (User: melons)
E L U C I D - Spellling (User: melons)
Westside Boogie - KILLA MODE (feat. Storm Ford) (User: melons)
Melle Brown - Feel About You - Edit (User: melons)
Two Shell - Dust (User: melons)
Steve Lacy - Mercury (User: melons)
The Holly Molly Trio - Signs in the Wind (User: melons)
Norwood Macdonald Group - Hector's Plan (User: melons)
CMC 3 - Spring Came Early (User: melons)
Kevin Waters Group - For Heavens Sake (User: melons)
Kevin Waters Group - For Heavens Sake (User: melons)
Lee Davis - Song of The Sirens (User: melons)
Carl Winther Trio - Prelude to a Kiss (User: melons)
All Our Exes Live in Texas - Boundary Road (User: melons)
Paolo Nutini - Through The Echoes (User: melons)
Andy Miller Group - I Thought About Us (User: melons)
Everything Everything - White Whale (User: melons)
Bladverk Band - Evans (User: melons)
Rainy Days Trio - A Gentle Reminder (User: melons)
Goldilocks Trio - Whitehall Gardens (User: melons)
Bernstein Square - Confidant (User: melons)
Keanan Field Group - I Loves You, Porgy (User: melons)
The Boston Four - Close Enough For Love (User: melons)
Tim Franks Trio - Autumn Serenade (User: melons)
Maurice Font - Sometimes (User: melons)
Lachlan Wright Trio - In Another Universe (User: melons)
Mayfare Trio - Spring Can Really Hang You Up The Most (User: melons)
The Sweetgreens - Ruby, My Dear (User: melons)
Joel Lyssarides - The Last Verse (User: melons)
Piper Williamson - Light Wave (User: melons)
Martin Landström - Clear as Autumn Nights (User: melons)
Tiril Brandt - Lush Life (User: melons)
Joyce Trio - Perception Through A Crystal Orb (User: melons)
South North - I've Never Been in Love Before (User: melons)
Tom Stills Quartet - For the First Time (User: melons)
The Jazz Cultivators - Try To Remember (User: melons)
Sarah Troedsson - Samantha (User: melons)
Bill Parker - Look For The Silver Lining (User: melons)
CMC 3 - Everything To Me (User: melons)
Tate Jackson Trio - Notes and Nights (User: melons)
Danny Ryan Jazz Band - Honey, You Are My Everything (User: melons)
Trio Del Norte - May Dance (User: melons)
Moonside Trio - Akaishi (User: melons)
Danny Ryan Jazz Band - Honey, You Are My Everything (User: melons)
Moonside Trio - Akaishi (User: melons)
Will Rivers Trio - Through The Years (User: melons)
Manor Blue - Sails (User: melons)
Mr. Right Time - What's Life Without You (User: melons)
Nick Osman Trio - Baubles, Bangles & Beads (User: melons)
Rainy Days Trio - Counting Stars (User: melons)
Louie Hobbs Trio - Down the Pawn Shop (User: melons)
North West Trio - A Quiet Place (User: melons)
Lydia Baskow Trio - Nuages ​​Creux (User: melons)
The Uptown Players - Solitude (User: melons)
Bridgerton Vail - A Life Remembered (User: melons)
Courtney Salas Group - Constantly Changing (User: melons)
Wildflower Trio - The Wind (User: melons)
Jean-Baptiste Rees - Crystal Blue (User: melons)
Jaden Berry - Bewitched (User: melons)
Hara Noda - The Beauty of Everyday Things (User: melons)
Bill Charlap Trio - Day Dream (User: melons)
Triathalon - Spin (User: melons)
Dreamgirl - Poolside (User: melons)
Summer Salt - Driving to Hawaii - Juniper Version (User: melons)
King Hannah - All Being Fine (User: melons)
Petite League - Pantone Karaoke (User: melons)
Vansire - Kind of a Nice Time (User: melons)
SASAMI - Call Me Home (User: melons)
Hovvdy - Everything (User: melons)
Odd Sweetheart - Structure (User: melons)
Puzzle - I Saw An Angel (User: melons)
The Garden - Thy Mission (User: melons)
M.A.G.S. - Smile (User: melons)
The Frights - Tungs (User: melons)
Vundabar - Lore (User: melons)
THE BOBBY LEES - Dig Your Hips (User: melons)
Lean - Alive on the Outside (User: melons)
Pretty Sick - Superstar (User: melons)
Hot Flash Heat Wave - Vampires (User: melons)
Breakup Shoes - Unrequited Love (& other clichés) (User: melons)
Jerry Paper - Kno Me (User: melons)
Sipper - party (User: melons)
Pinegrove - Alaska (User: melons)
Faye Webster - Cheers (User: melons)
Hana Vu - Aubade (User: melons)
The Gloomies - If We Were Older (User: melons)
girlhouse - concussion (User: melons)
Husbands - Must Be a Cop (User: melons)
Mind’s Eye - Wasted Affairs (User: melons)
Enjoy - I've Wasted So Much Time (User: melons)
The Buttertones - Orpheus Under the Influence (User: melons)
Slow Pulp - High (User: melons)
Plums - Parking Lots (User: melons)
Crumb - Ghostride (User: melons)
Sipper - fuck sex (User: melons)
Black Polish - Baby Tonight (User: melons)
The Hellp - Ssx (User: melons)
Delta Sleep - The Detail (User: melons)
Fleece - Bodies Lie (User: melons)
fanclubwallet - Car Crash in G Major (User: melons)
Haley Blais - Coolest fucking bitch in town (User: melons)
Indigo De Souza - Hold U (User: melons)
Good Morning - Country (User: melons)
Slow Pulp - In Too Deep (User: melons)
The Red Pears - Not in the Cards (User: melons)
Blvck Hippie - If You Feel Alone At Parties (User: melons)
provoker - Dark Angel (User: melons)
Cathedral Bells - Afterglow (User: melons)
Tennis System - Dizzy (User: melons)
re6ce - vampire (User: melons)
oso oso - nothing to do (User: melons)
Ruby Waters - Harder (User: melons)
Art Moore - Muscle Memory (User: melons)
Kiwi Jr. - Night Vision (User: melons)
Ghost Orchard - invisible string (User: melons)
Flipturn - Brooklyn Baby (User: melons)
Trestles - Rip Curl Sweatshirt (User: melons)
Horsegirl - Dirtbag Transformation (Still Dirty) (User: melons)
Kali - Insomnia (User: melons)
Nuclear Daisies - Heaven in Your Head (User: melons)
Car Seat Headrest - It's Only Sex (User: melons)
Jordana - Go Slow (User: melons)
Honeyglaze - Childish Things (User: melons)
Suave Punk - Petals (User: melons)
Yot Club - off the grid (User: melons)
Richie Quake - Cherry Red (User: melons)
La Luz - Endless Afternoon (User: melons)
Cape Francis - Fire Eyes (User: melons)
Living Hour - Feelings Meeting (User: melons)
late night drive home - Stress Relief (User: melons)
FredAtlast - One Day (User: melons)
Vundabar - Aphasia (User: melons)
Savannah Conley - Always Gonna Happen (User: melons)
Enumclaw - 2002 (User: melons)
Softcult - Frances Farmer Will Have Her Revenge On Seattle (User: melons)
Worry Club - DEATHBLOW (User: melons)
Cold Showers - Nighttime (User: melons)
sundiver ca - soundtrack for your backseat (User: melons)
fanclubwallet - You Have Got To Be Kidding Me (User: melons)
Tim Burgess - Typical Music (User: melons)
Hovvdy - Ruby (User: melons)
Martin Courtney - Sailboat (User: melons)
Porridge Radio - Rotten (User: melons)
Dehd - Clear (User: melons)
Runnner - Ur Name on a Grain of Rice - demo (User: melons)
The Soft Moon - Him (User: melons)
The Garden - Freight Yard (User: melons)
Anthony Green - Trading Doses (User: melons)
Pete Yorn - Never Go (User: melons)
Blondshell - Olympus (User: melons)
Horse Jumper of Love - Ding Dong Ditch (User: melons)
Her's - What Once Was (User: melons)
Hether - dirty claws (User: melons)
Boyish - Legs (User: melons)
Alex G - Runner (User: melons)
sophie meiers - untangle me (User: melons)
Bronski Beat - Smalltown Boy (User: melons)
Jimmy Somerville - Smalltown Boy (User: melons)
The Seekers - When Will the Good Apples Fall (User: melons)
Dr Feelgood - Milk and Alcohol (User: melons)
UB40 - Breakfast in Bed (User: melons)
Rock Stars - I Was Made For Lovin' You (User: melons)
Kiss - I Was Made for Loving You (User: melons)
Kiss - I Was Made for Lovin' You (User: melons)
Emile Ford & The Checkmates - What Do You Want to Make Those Eyes at Me For (User: melons)
Beyoncé - BREAK MY SOUL (User: melons)
Beyoncé - BREAK MY SOUL (User: melons)
Stars - Ageless Beauty (User: melons)
Stars - Ageless Beauty (User: melons)
Stars - Ageless Beauty (User: melons)
Metric - Black Sheep (User: melons)
The New Pornographers - Letter From an Occupant (User: melons)
Mac DeMarco - I’ve Been Waiting for Her (User: melons)
Ron Gallo - Kill the Medicine Man (User: melons)
Menswear - Stardust (User: melons)
Radiohead - There, There (User: melons)
Paul Evans - Hello, This Is Joannie (The Telephone Answering Machine Song) (User: melons)
The Easybeats - Hello, How Are You (User: melons)
Orchestral Manoeuvres in the Dark - Dream of Me (Based on Love's Theme) (User: melons)
Shed Seven - Going For Gold (User: melons)
Orchestral Manoeuvres in the Dark - Dream of Me (Based on Love's Theme) (User: melons)
Incognito - Always There (Edit) (User: melons)
Londonbeat - 9 AM (The Comfort Zone) (User: melons)
Faron Young - It's Four In The Morning (User: melons)
The KLF - 3 A.M. Eternal (Radio Freedom edit) (User: melons)
Fastbacks - Only at Night (User: melons)
Fleetwood Mac - Little Lies (User: melons)
Fleetwood Mac - Sara (Remastered LP Version) (User: melons)
Fleetwood Mac - Albatross (2018 Remaster) (User: melons)
Chicane - Don't Give Up (radio edit) (User: melons)
Miley Cyrus - Wrecking Ball (User: melons)
Slaughter Beach, Dog - Heart Attack (User: melons)
Meco - Star Wars- LP Version (User: melons)
The Rascals - People Got To Be Free (User: melons)
Madonna - Take a Bow (User: melons)
Fiddlehead - USMA (User: melons)
Thompson Twins - Hold Me Now (User: melons)
Queen - Now I'm Here (User: melons)
Meat Loaf - You Took the Words Right Out of My Mouth (Hot Summer Night) (User: melons)
The Mamas & the Papas - Words of Love (User: melons)
Fiddlehead - USMA (User: melons)
Julia Jacklin - You Were Right (User: melons)
Angel Du$t - Big Bite (User: melons)
Broncho - Keep It in Line (User: melons)
Snail Mail - Glory (User: melons)
Oceanator - Too Late (User: melons)
Antarctigo Vespucci - Kimmy (User: melons)
The Black Keys - I'll Be Your Man (User: melons)
Fastbacks - Only at Night (User: melons)
Slaughter Beach, Dog - Heart Attack (User: melons)
Charly Bliss - Gatorade (User: melons)
Machine Gun Kelly - my ex's best friend (with blackbear) (User: melons)
Fiddlehead - USMA (User: melons)
Ron Gallo - Do You Love Your Company? (User: melons)
The United States of America - Stranded in Time (User: melons)
LIIEK - Crisis (User: melons)
Luther Ingram - If It's All the Same to You Babe (User: melons)
Los Bitchos - FFS (User: melons)
Power Trip - Firing Squad (User: melons)
Martha Reeves & The Vandellas - (Love Is Like A) Heat Wave (User: melons)
Dee Dee Sharp - Mashed Potato Time (User: melons)
豊平区民TOYOHIRAKUMIN - AKAIWA 1985 (User: melons)
Uriel Barrera - Casi Algo - Versión Mariachi (User: melons)
Natalia Jiménez - Fuiste Mía (User: melons)
Lucha Villa - No Discutamos (User: melons)
José Alfredo Jiménez - En el último trago (User: melons)
Javier Solís - Media Vuelta (User: melons)
Cuco Sánchez - Cama de Piedra (User: melons)
José Alfredo Jimenez - El Rey (User: melons)
Gerardo Reyes - Libro Abierto (User: melons)
Juan Gabriel - Ases y Tercia de Reyes (User: melons)
Cornelio Reyna - Me Sacaron Del Tenampa (User: melons)
Bow Wow Wow - Go Wild in the Country (User: melons)
Amyl and the Sniffers - Got You (User: melons)
Seratones - Gotta Get To Know Ya (User: melons)
Vampire Weekend - Holiday (User: melons)
Beach Bunny - Prom Queen (User: melons)
Weezer - Dope Nose (User: melons)
Nude Beach - Radio (User: melons)
Young Knives - Weekends and Bleak Days (Hot Summer) (User: melons)
We Are Scientists - Rules Don't Stop (User: melons)
Spider Bags - japanese vacation (User: melons)
Diarrhea Planet - Separations (User: melons)
FIDLAR - No Waves (User: melons)
Remember Sports - Reality TV (User: melons)
Guided by Voices - Game of Pricks (User: melons)
Laura Jane Grace & the Devouring Mothers - Apocalypse Now (& Later) (User: melons)
Laura Jane Grace & the Devouring Mothers - Apocalypse Now (& Later) (User: melons)
Kyle Craft - 2 Ugly 4 NY (User: melons)
Oasis - Some Might Say (User: melons)
Quinton Brock - There For You (User: melons)
Bleached - Stupid Boys (User: melons)
Japanese Breakfast - Everybody Wants To Love You (User: melons)
Bleach - I'm A Boy (User: melons)
Th' Faith Healers - Pop Song (User: melons)
A. Sinclair - Suit Up (User: melons)
Locust - Shadow Play (User: melons)
Drop Nineteens - (Plus Fish Dream) (User: melons)
Lush - Outdoor Miner (User: melons)
Deerhunter - Cover Me (Slowly) (User: melons)
Deerhunter - Plains (User: melons)
Allah-Las - In the Air (User: melons)
The Diamonds - Little Darlin' (User: melons)
Bobby Rydell - Good Time Baby (User: melons)
Luke Hanavan - 16000 (User: melons)
Jerry Keller - Here Comes Summer (User: melons)
The Ivy League - Funny How Love Can Be (User: melons)
Hedgehoppers Anonymous - It's Good News Week (User: melons)
Wayne Fontana & The Mindbenders - The Game of Love (User: melons)
Herb Alpert & The Tijuana Brass - Tijuana Taxi (User: melons)
The Fourmost - A Little Loving (User: melons)
Prelude - After the Goldrush (User: melons)
Joe Loss - March of the Mods (User: melons)
Jimmy Crawford - I Love How You Love Me (User: melons)
Jimmy Jones - Good Timin' (User: melons)
Jimmy Jones - Handy Man (User: melons)
Crazy Elephant - Gimme Gimme Good Lovin' (User: melons)
The Ventures - Walk, Don't Run - Stereo (User: melons)
Tim Hardin - How Can We Hang On To A Dream (User: melons)
The Newbeats - Bread And Butter (User: melons)
The Four Knights - (Oh Baby Mine) I Get So Lonely (User: melons)
Maurice Williams & The Zodiacs - Stay - Rerecorded (User: melons)
The Monks - Nice Legs Shame About The Face (User: melons)
The Mindbenders - A Groovy Kind Of Love (User: melons)
Dee Clark - Just Keep It Up (User: melons)
Patience & Prudence - Tonight You Belong to Me (User: melons)
Johnny & The Hurricanes - Rocking Goose (User: melons)
Diet Cig - Link in Bio (User: melons)
Tramhaus - Night Shift (User: melons)
La Gloria Matancera - Escandalo (User: melons)
The Lilac Time - American Eyes (User: melons)
The Honeycombs - Can't Get Through To You (User: melons)
Felt - Sunlight Bathed the Golden Glow (User: melons)
Empath - Diamond Eyelids (User: melons)
The Clean - Anything Could Happen (User: melons)
Constant Smiles - Run To Stay (User: melons)
Ovlov - Land of Steve-O (User: melons)
Bachelor - Stay in the Car (User: melons)
Gustaf - Design (User: melons)
BNNY - Time Walk (User: melons)
English Teacher - R&B (User: melons)
The Goon Sax - Boyfriend (User: melons)
The Goon Sax - Make Time 4 Love (User: melons)
Poppy - Her (User: melons)
The Avett Brothers - Another Is Waiting (User: melons)
Martha - Please Don't Take Me Back (User: melons)
Pet Fox - It Won't Last (User: melons)
Well Wisher - i'll go (User: melons)
Wild Smiles - Fool for You (User: melons)
Archers of Loaf - Web in Front (User: melons)
Black Francis - I Sent Away (User: melons)
Culture Abuse - So Busted (User: melons)
Drowners - Long Hair (User: melons)
Animal House - Tobacco (User: melons)
Joyce Manor - Don't Try (User: melons)
Tom Jones - I'm Coming Home (User: melons)
Dollar - Give Me Back My Heart (User: melons)
Pet Shop Boys - I'm With Stupid (User: melons)
John Paul Young - Love Is in the Air (User: melons)
Air - Sexy Boy (User: melons)
Pink Blob - Moolah (User: melons)
Pink Blob - Moolah (User: melons)
Delroy Wilson - Cool Operator (User: melons)
Voyager - Halfway Hotel (User: melons)
Turnstile - LONELY DEZIRES (User: melons)
Pink Blob - Friday Rocker (User: melons)
N.W.A. - Straight Outta Compton (User: melons)
Mary Jane Girls - All Night Long (User: melons)
Bernard bonnier - Véro-la-Toto (User: melons)
Bruno Spoerri - Bicycle Ride (User: melons)
Leroy Hutson - I Think I'm Falling In Love (User: melons)
Soulé - Body (User: melons)
Pillow Queens - Try Try Try (User: melons)
Alex Gough - DUMB! (User: melons)
1000 Beasts - Glass Magic (User: melons)
JyellowL - Body Bad (User: melons)
Abbacaxi - Endless (User: melons)
Daire Patel - Blue (User: melons)
Winnie Ama - Here I Go (User: melons)
Róisín O - Better Now (User: melons)
NewDad - Banshee (User: melons)
Pastiche - Written And Directed (User: melons)
Lea Heart - Perfect Opposites (User: melons)
David Keenan - Good Friday (User: melons)
Alicia Raye - Sun (User: melons)
AC-130 - Wyd? (User: melons)
Lwny - you got me (YGM) (User: melons)
it's just Cat - Not a Vibe (User: melons)
Strabe - Magic (User: melons)
April - Pressure (User: melons)
Daniel Blume - On The Side (User: melons)
KingFisher - flowers-fire (User: melons)
AikJ - Lose Control (User: melons)
Alex Gough - GLOW (User: melons)
Kayleigh Noble - I didn't care, until (User: melons)
Flynn - Elephant (User: melons)
Nixer - Bad Rain (User: melons)
Efé - KIWI (User: melons)
Banba - Angel (User: melons)
Lily Aron - bored again (User: melons)
Cathal Francis - Filters (User: melons)
KhakiKid - Woodstock (User: melons)
SOPHIE DOYLE RYDER - Sucker (User: melons)
Lydia Ford - In My Head (User: melons)
Hudson Taylor - Over My Head (User: melons)
Fiona Harte - Owe You One (User: melons)
Kean Kavanagh - Heart Attacks (User: melons)
ELKAE - White Dress (User: melons)
Clare Sands - Sail On (User: melons)
Lucy McWilliams - Medication (demo) (User: melons)
R.L. Beats - It's Just Us (User: melons)
Daithí - Sunset (User: melons)
Aby Coulibaly - On My Ones (User: melons)
Murli - Rocks (Single Edit) (User: melons)
Abbacaxi - Move Me (User: melons)
N.O.A.H - The Wrong Side of Town (User: melons)
Strabe - Breathe Me In (User: melons)
Rosie Carney - sugar (User: melons)
Seba Safe - Spitfire (User: melons)
Amy Michelle - welcome to the sidelines (User: melons)
katie phelan - Duvet Day (User: melons)
Tim Chadwick - You're (Still) in Love (User: melons)
Roe - I Can Change (User: melons)
True Tides - Beating Heart (User: melons)
Monjola - Extrovert (User: melons)
jena keating - Nobody Can Have Me (User: melons)
Lenii - Knife (User: melons)
Cavetown - Fall In Love With A Girl (feat. Orla Gartland) (User: melons)
Glxsgxw - TLLMETHTUCARE (User: melons)
Moy - IDFR (User: melons)
Pinc Wafer - 0% (User: melons)
Theo Bleak - You're Not Even Really Here (User: melons)
Bootsy Collins - Physical Love (User: melons)
Stretch - Why Did You Do It - Remastered (User: melons)
The Hippos - Lost It (User: melons)
lil shrimps - tourr to hel (User: melons)
Glitchers - TELESCOPE - Single Edit (User: melons)
Hot Milk - Teenage Runaways (User: melons)
Death Lens - DAEMON (User: melons)
Stand Atlantic - hair out (User: melons)
Play Dead - Barbershop (User: melons)
Life - Almost Home (User: melons)
Girls in Synthesis - Enveloped (User: melons)
Public Body - Flavour of Labour (User: melons)
Sweethearts - hurt and high (User: melons)
Mom Jeans. - White Trash Millionaire (User: melons)
CURTIS WATERS - MANIC MAN (User: melons)
Knuckle Puck - Lonely Island (User: melons)
Neck Deep - STFU (User: melons)
Breakup Haircut - I'd Say Yes (User: melons)
Static Dress - such.a.shame (User: melons)
YNES - Fake What Your Mama Gave Ya (User: melons)
Masked Man - PLANT THE FANGS (User: melons)
Mouse. - Høstage. (User: melons)
Oli Frost - Eco Anxiety (Emo Animosity) (User: melons)
Witch Fever - Congregation (User: melons)
Life - The Drug (User: melons)
Bronnie - Friendzone (User: melons)
DoFlame - Major Waste (User: melons)
XL LIFE - Just Do It (User: melons)
Adulkt Life - Book Of Curses (User: melons)
Loose Articles - Kick Like a Girl (User: melons)
Lady Bird - BLUDSUCKERS (User: melons)
The Clockworks - Money (I Don't Wanna Hear It) (User: melons)
Nova Twins - Choose Your Fighter (User: melons)
Hallan - Sich Übergeben (User: melons)
Moreish Idols - Hangar (User: melons)
Prince Daddy & The Hyena - El Dorado (User: melons)
Pretty Happy - Salami (User: melons)
Witch Fever - Blessed Be Thy (User: melons)
Touts - Shane MacGowans New Teeth (User: melons)
Crows - Garden of England (User: melons)
The Queen's Head - Teach Me To Dance (User: melons)
vincent's last summer - Below The Ceiling (User: melons)
PUP - Totally Fine (User: melons)
Lauran Hibberd - Still Running (5K) (feat.DJ Lethal) (User: melons)
Psychedelic Porn Crumpets - Bubblegum Infinity (User: melons)
Chubby and The Gang - Who Loves Ya? (Coup d'état) (User: melons)
Gen and The Degenerates - Girl God Gun (User: melons)
Soul Glo - Gold Chain Punk (whogonbeatmyass?) (User: melons)
Deep Tan - rudy ya ya ya (User: melons)
Public Body - Reset My Password (User: melons)
The Beths - Silence Is Golden (User: melons)
Headshrinkers - Interrobang (User: melons)
Sprints - Little Fix (User: melons)
Warmduscher - Eight Minute Machine (User: melons)
Kid Kapichi - Rob the Supermarket (User: melons)
Holding Absence - Aching Longing (User: melons)
SLOE JACK - Renegade (User: melons)
Bad Breeding - Rebuilding (User: melons)
Dead Pony - Zero (User: melons)
Dead Pony - Zero (User: melons)
Bob Vylan - Wicked & Bad (User: melons)
Polo & Pan - Ani Kuni - Edit (User: melons)
Sylvan Esso - Your Reality (User: melons)
Polo & Pan - Ani Kuni - Edit (User: melons)
山下達郎 - キスカ (User: melons)
TWO WEEKS IN NASHVILLE - Hasta Luego (User: melons)
George Barnett - bad for you (User: melons)
modernlove. - Bop (User: melons)
High Vis - Walking Wires (User: melons)
Lanky - PRETTY (User: melons)
Mac Wetha - Ode to Mumma (User: melons)
Witch Fever - In the Resurrect (User: melons)
Swan Prince - You're Toast (User: melons)
Sportsgirl - Golf (User: melons)
AURAGRAPH - Try Enough (User: melons)
Stux.Io - Heat of the Night (User: melons)
KING QUARTZ - Vcrheadaches - Negative 32 Memphis (User: melons)
KING QUARTZ - Sit Down & Talk (User: melons)
Peluché - Sin (User: melons)
High on Fire - Rumors of War (User: melons)
Gogi 93 - Loading Screen (User: melons)
MindSpring Memories - Coffee in the Evening (User: melons)
The Stoneage Hearts - Shake yer popboomerang (User: melons)
US Golf 95 - Nature (User: melons)
Hatena - SOULLL (User: melons)
FM Skyline - Veranda (User: melons)
Vivi Vulture - Home Workout VHS (User: melons)
Infinity Frequencies - Curves (User: melons)
trushinitas - Summer Days (User: melons)
Hotel Pools - Lynx (User: melons)
KING QUARTZ - King Quartz - 4:14 in 313 (User: melons)
eccodroid - dissociating into oblivion (User: melons)
PERSONA LA AVE - Power Walk (User: melons)
Runners Club 95 - Carrie Bradshaw (User: melons)
Greeen Linez - Hibiscus Pacific (User: melons)
Donor Lens - Turn the Fridge On (User: melons)
trushinitas - By the River (User: melons)
猫 シ Corp. - Noodle Shop Cats (User: melons)
deadmalls - dillards (User: melons)
3D Blast - 3rD Best (User: melons)
VAPERROR - She's Got the Stuff (User: melons)
Cosmic Cycler - Sparkling Lights (User: melons)
Phil Gerus - Don't Kiss Me While i'm Swimming (User: melons)
Donor Lens - Uncanny Valley Girl (User: melons)
PERSONA LA AVE - Surfer Girl (User: melons)
Le Cassette - Arms Of Mine (User: melons)
death's dynamic shroud - Butterflies (User: melons)
豊平区民TOYOHIRAKUMIN - AKAIWA 1985 (User: melons)
Teams - Stunts (User: melons)
ESPRIT 空想 - Warmpop (User: melons)
</body> - Playback (User: melons)
Luxury Elite - You Can Sense It (User: melons)
Skylar Spence - Private Caller (User: melons)
Neggy Gemmy - Bad Baby (Satin Sheets Remix) (User: melons)
tiredjohannes - (アリゾナ 緑茶) arizona green tea (User: melons)
Sunnbrella - Fever Dream - slowed + reverb (User: melons)
Dreamcorp. - WATCHING THE WORLD UNFOLD (User: melons)
June Chikuma - Midas Touch (User: melons)
Lost Traveler ロスト - Fantasy (User: melons)
Dan Mason ダン·メイソン - Morning Brew (User: melons)
Satin Sheets - see/D (User: melons)
Sonavision Deluxe - Lonely Menace (User: melons)
PERSONA LA AVE - Match Point 2 (User: melons)
Cosmic Cycler - Megatower Romance (User: melons)
Versiple - null (User: melons)
Ahero - Cloud Zero (User: melons)
Vitesse X - Rash Devices (FM Skyline Remix) (User: melons)
Lost Traveler ロスト - welcome (User: melons)
surfing - Lifetime (User: melons)
bl00dwave - bodies (User: melons)
Memorex Memories - Psycho Geography (User: melons)
Queen Cult - Woman That I Know (User: melons)
Roxy Music - Re-Make/Re-Model (User: melons)
Nosoträsh - Portugal (User: melons)
La Monja Enana - Al Otro Lado (User: melons)
Kamamuri: Ana D - La Noche Inventada (User: melons)
Corazón - Martín Se Ha Ido Para Siempre (User: melons)
La Casa Azul - Viaje A Los Sueños Polares (2003) (User: melons)
Niza - Dame Estrellas O Limones (2003) (User: melons)
Nosoträsh - Nadadora (User: melons)
Los Bonsáis - El Mapa (User: melons)
Cristina Quesada - Viaje A Los Sueños Polares (User: melons)
La Bien Querida - Dame Estrellas o Limones (User: melons)
Modular - Sentimental (User: melons)
Band À Part - El Bello Verano (User: melons)
Papa Topo - Su Mal Humor (User: melons)
Peaches - Lovertits (User: melons)
Orange Juice - Blue Boy (User: melons)
The Amps - Tipp City (User: melons)
Anchorsong - Expo (User: melons)
Depth Charge - Shaolin Buddha Finger - Single Version (User: melons)
Ian Dury - What A Waste (User: melons)
John Prine - Saddle in the Rain (User: melons)
Supersempfft - I See Stars (User: melons)
Opus Kink - This Train (User: melons)
The Umlauts - Boiler Suits & Combat Boots (Edit) (User: melons)
Felix da Housecat - Watching Cars Go By (User: melons)
Cristina - What's a Girl to Do (User: melons)
Boxed In - Jist (User: melons)
Bill Callahan - Diamond Dancer (User: melons)
Planningtorock - Jam Fam - Chanel Show Version (User: melons)
Dusty Springfield - I Can't Wait Until I See My Baby's Face (User: melons)
Tamar Aphek - Crossbow (User: melons)
Inspiral Carpets - Let You Down (User: melons)
Our Girl - I Really Like It (User: melons)
World Party - Way Down Now (User: melons)
Polyrock - Your Dragging Feet (User: melons)
Flipper's Guitar - Groove Tube (User: melons)
Yard Act - Fixer Upper (User: melons)
Love and Rockets - Yin and Yang (The Flowerpot Man) (User: melons)
Blondie - Rapture (User: melons)
Golden Earring - Radar Love (User: melons)
Phil Lynott - Yellow Pearl (User: melons)
Harpo - Moviestar (User: melons)
The Chi-Lites - Homely Girl (User: melons)
Andy Bell - Cherry Cola (User: melons)
Lonnie Donegan - I Wanna Go Home (User: melons)
Peaches - Lovertits (User: melons)
Time Zone - World Destruction (User: melons)
Giggs - (Is It Gangsta?) Yes Yes Yes (User: melons)
Grove - Feed My Desire (User: melons)
The Flirtations - Nothing But A Heartache (User: melons)
Roger Miller - Whistle Stop (User: melons)
J Lloyd - If I Fall Under (User: melons)
Spread Joy - Kanst Du (User: melons)
Tobacco - Yum Yum Cult (User: melons)
Violent Femmes - Two People (User: melons)
Permagrin - Better Than Dead (User: melons)
David Bowie - Day-In Day-Out - 2018 Remaster (User: melons)
David Bowie - I Can't Explain - 2015 Remaster (User: melons)
The Flirtations - Nothing But A Heartache (User: melons)
N.W.A. - Express Yourself (User: melons)
R.E.M. - Pretty Persuasion (User: melons)
Sly & The Family Stone - Runnin' Away - Single Version (User: melons)
Chain and the Gang - Certain Kinds of Trash (User: melons)
Urusei Yatsura - Kewpies Like Watermelon (User: melons)
Wanda Jackson - Funnel of Love (User: melons)
Fun Boy Three - The Tunnel of Love (User: melons)
Clinic - The Second Line (User: melons)
The Damned - Eloise (User: melons)
Datblygu - Y Teimlad (User: melons)
Roxy Music - Angel Eyes (User: melons)
David Bowie - Sound and Vision - 2017 Remaster (User: melons)
Bobby Conn - Winners (User: melons)
Beach House - Saltwater (User: melons)
Katy J Pearson - Miracle (User: melons)
The Supremes - You Keep Me Hangin' On (User: melons)
Make Up - Born On The Floor (User: melons)
Sugababes - Overload (User: melons)
Lee Fields & The Expressions - Thinking About You (User: melons)
Lee Fields & The Expressions - Thinking About You (User: melons)
Herbie Hancock - Bring Down The Birds - Outtake (User: melons)
Radiohead - All I Need (User: melons)
Jonathan Richman & The Modern Lovers - That Summer Feeling (User: melons)
Clothilde - Fallait pas écraser la queue du chat (User: melons)
The Magnetic Fields - Desert Island (User: melons)
Aztec Camera - Still On Fire (User: melons)
Scratch Acid - She Said (User: melons)
Gang of Four - Damaged Goods (User: melons)
Diana Ross - Turn Up The Sunshine - From 'Minions: The Rise of Gru' Soundtrack (User: melons)
Diana Ross - Chain Reaction (User: melons)
L-Space - Waking Up Bathed in the Light of Things You Can't Afford (User: melons)
Last Night From Glasgow - Suneaters L-space (User: melons)
Teenage Fanclub - What You Do To Me (User: melons)
R.E.M. - (Don't Go Back to) Rockville (User: melons)
R.E.M. - Fall on Me (User: melons)
R.E.M. - It's the End of the World as We Know It (and I Feel Fine) (User: melons)
R.E.M. - Finest Worksong - Remastered (User: melons)
R.E.M. - Radio Free Europe (User: melons)
R.E.M. - Cuyahoga (User: melons)
R.E.M. - So. Central Rain (User: melons)
R.E.M. - Driver 8 (User: melons)
R.E.M. - The One I Love - Remastered 2012 (User: melons)
R.E.M. - Talk About the Passion (User: melons)
R.E.M. - Pretty Persuasion (User: melons)
R.E.M. - Can't Get There From Here (User: melons)
The Magnetic Fields - I Don't Want to Get Over You (User: melons)
My Chemical Romance - Na Na Na (Na Na Na Na Na Na Na Na Na) (User: melons)
Diana Ross & The Supremes - Reflections (User: melons)
Pixies - Allison (User: melons)
The Flat Five - Drip a Drop (User: melons)
Adam's Apples - Don't Take It Out On This World (User: melons)
Lotte Kærså & Græsrødderne - Prøv og Gør Ligesom Jeg (User: melons)
The Gizmos - The Midwest Can Be Allright (User: melons)
The Foundations - Baby Now That I've Found You (Stereo) (User: melons)
Joe Meek - I Hear a New World (User: melons)
Major Lance - It's the Beat (User: melons)
Lloyd Cole and The Commotions - Four Flights Up (User: melons)
Thrush Hermit - From the Back of the Film (User: melons)
Mahna Mahna and The Two Snowths - Mah Na Mah Na (User: melons)
Josef K - Fun 'n' Frenzy (User: melons)
Flamin' Groovies - Yes It's True (User: melons)
Richard Berry - Have Love Will Travel (User: melons)
Len Barry - 123 (User: melons)
Biff Bang Pow! - Someone Stole My Wheels (User: melons)
John Cooper Clarke - I Wanna Be Yours (User: melons)
Nick Garrie - Can I Stay With You (User: melons)
Edison Lighthouse - Love Grows (Where My Rosemary Goes) (User: melons)
Ann Robinson - Sissy Walk (User: melons)
Metá Metá - Angouleme (User: melons)
Topper - Hapus (User: melons)
The Remains - Don't Look Back (User: melons)
Air Miami - Airplane Rider (User: melons)
Nada Surf - Blizzard of '77 (User: melons)
The Gentle Waves - Solace for Pain (User: melons)
The Courettes - Want You! Like a Cigarette (User: melons)
The United States of America - Stranded in Time (User: melons)
PINS - Shoot You (User: melons)
Dexys Midnight Runners - Thankfully Not Living in Yorkshire It Doesn't Apply - 2000 Remaster (User: melons)
The Runaways - Cherry Bomb (User: melons)
Glen Campbell - Southern Nights (User: melons)
Bill Baird - I Will Be True (User: melons)
Whitney - Southern Nights (User: melons)
Drugdealer - Suddenly (User: melons)
Viagra Boys - Girls & Boys (User: melons)
Run the Jewels - Thieves! (Screamed the Ghost) [feat. Tunde Adebimpe] (User: melons)
The Sisters of Mercy - Temple of Love - 1992 (User: melons)
Young Fathers - In My View (User: melons)
Bill Baird - Gold Dissolves To Gray (User: melons)
Josef K - It's Kinda Funny (User: melons)
Sandie Shaw - Hand In Glove - Single Version (User: melons)
Loyle Carner - Stars & Shards (User: melons)
Talk Talk - Give It Up - 1997 Remaster (User: melons)
Las Odio - Lo Quiero Todo (User: melons)
Billy Childish - Bottom of the Sea (User: melons)
Jonathan Bree - Say You Love Me Too (User: melons)
Carl Carlton - Competition Ain't Nothin' - Single Version (User: melons)
Crake - Enough Salt (For All Dogs) (User: melons)
Marine Girls - Honey (User: melons)
XTC - Chain Of Command - 2001 Digital Remaster (User: melons)
Global Charming - Curveball (User: melons)
Scott Walker - 30 Century Man (User: melons)
Bad Dream Fancy Dress - Curry Crazy (User: melons)
The Groove Farm - It Always Rains On Sunday (User: melons)
chronophage - Abzurdity (User: melons)
The Wannadies - You & Me Song (User: melons)
14 Iced Bears - Come Get Me (User: melons)
The Exciters - He's Got the Power (User: melons)
The Revolving Paint Dream - Flowers in the Sky (User: melons)
Frankie Stew and Harvey Gunn - Coconuts (User: melons)
The Rolling Stones - Mother's Little Helper (User: melons)
Paul Anka - Diana (User: melons)
Roxy Music - Virginia Plain (User: melons)
Goofy Geese - Poppy Blue (User: melons)
Madvillain - Curls (User: melons)
Creedence Clearwater Revival - Bad Moon Rising (User: melons)
The Statler Brothers - Flowers on the Wall (User: melons)
The United States of America - Stranded in Time (User: melons)
Billy Nomates - No (User: melons)
Fabrizio De André - Primo Intermezzo (User: melons)
The Animals - Dimples (User: melons)
Harry Styles - As It Was (User: melons)
Kishi Bashi - Chester's Burst Over the Hamptons (User: melons)
The Simpletons - Tall Poppies (User: melons)
Hakan - Number One (User: melons)
The Visitors - Alice Aisgill (User: melons)
Four Tops - I'll Turn To Stone (User: melons)
The Jesus and Mary Chain - Sometimes Always (User: melons)
The Flat Five - Drip a Drop (User: melons)
Desmond Dekker - It Mek (User: melons)
Bob Dylan - Subterranean Homesick Blues (User: melons)
The Lemon Pipers - Rice Is Nice (User: melons)
The Cuff Links - Tracy (User: melons)
Lord Rockingham's XI - Hoots Mon! (User: melons)
Fumaça Preta - Toda Pessoa (User: melons)
Happy Mondays - Hallelujah - Remastered version (User: melons)
Sparks - I Predict (User: melons)
R.E.M. - Mystery To Me - Athens Demo (User: melons)
The Milkshakes - I'm Out Of Control (User: melons)
Al Jones - Come Join My Orchestra (User: melons)
Unschooling - Social Chameleon (User: melons)
Mild High Club - Rollercoaster Baby (User: melons)
The La's - Feelin' (User: melons)
Wild Honey - Renee (User: melons)
France Gall - Laisse Tomber Les Filles (User: melons)
The Youngbloods - Sugar Babe (User: melons)
Tak Shindo - Mombasa Love Song (User: melons)
Clouds - Village Green (User: melons)
Shabazz Palaces - Shine a Light (User: melons)
Stuck - Labor Leisure (User: melons)
Joy Division - Interzone - 2007 Remaster (User: melons)
Super Furry Animals - God! Show Me Magic (User: melons)
Air Miami - Airplane Rider (User: melons)
Tiger Trap - Super Crush (User: melons)
Billy Fury - Glad All Over (User: melons)
Alan Hawkshaw - Grange Hill (User: melons)
Cass Elliot - Make Your Own Kind of Music (User: melons)
Saint Etienne - Underneath the Apple Tree (User: melons)
The Clash - White Riot - remastered (User: melons)
Neil Young - The Needle and the Damage Done - 2009 Remaster (User: melons)
The Revolving Paint Dream - Flowers in the Sky (User: melons)
True Tides - Beating Heart (User: melons)
Monjola - Extrovert (User: melons)
jena keating - Nobody Can Have Me (User: melons)
Lenii - Knife (User: melons)
Cavetown - Fall In Love With A Girl (feat. Orla Gartland) (User: melons)
Tomike - Another Life (User: melons)
Talos - All Ours (User: melons)
Soak - swear jar (User: melons)
Wild Youth - Live Without You (User: melons)
Sorcha Richardson - Archie (User: melons)
49th & Main - Human Condition (User: melons)
The Butterflies of Love - Danny's Got A Good Shot (User: melons)
Libero - The Regal Drug (User: melons)
Ellis Island Sound - Ergo Squad Box (User: melons)
Parenthesis... - Synthesized Swimming (User: melons)
MassiveAnneFrank - Transition (User: melons)
Desmond Tutu - Stanley Could Turn On A Tiki (A Football Song Of Praise) (User: melons)
DJ Downfall - Shoot It Shoot It (Hit Me Again) (User: melons)
Band À Part - Cascabel (User: melons)
Hannah Peel - The Bully (User: melons)
Sool - Handball (User: melons)
Alexander’s Festival Hall - Judo (What We've Been Playing) (User: melons)
The Sunny Street - Steffi (User: melons)
White Town - Theme For Olympic Weightlifting (User: melons)
Hong Kong In the 60s - Let's Play Table Tennis (User: melons)
Hawaii Fried Dough - Tumblebee (User: melons)
Darren Hayman - Bundle (User: melons)
Town Bike - Tour De Force (User: melons)
Fox - Behind Enemy Lines (User: melons)
Flotation Toy Warning - The Buoys Are Back In Town (User: melons)
Linda Guilala - Morir Ahogada (User: melons)
The Leaf Library - Badminton House (User: melons)
The Vatican Cellars - A Palpable Hit (User: melons)
Hacia Dos Veranos - The Way Of The Hand And The Foot (User: melons)
One Fathom Down - Exodus (User: melons)
Jeff Mellin - Hit Me! (User: melons)
Saint Etienne - Steeplechase (User: melons)
Linda Guilala - Accidente (User: melons)
Drama - Classic Beat (User: melons)
Latitude - Dead End Fantasy (User: melons)
Kamala And The Karnivores - Tiny Steps (User: melons)
Mr. Wrong - Overstimulation / White Maile Teacher (User: melons)
Slag Queens - Waterfall (User: melons)
Patsys Rats - Looking at Your Phone (User: melons)
CHILDS POSE - Ellas Fate (User: melons)
Hélène Barbier - Where is the Dog (User: melons)
Whip - Bad Habits Die (User: melons)
table sugar - To the Test (User: melons)
Snob - Motor Bitches (User: melons)
Vital Idles - Dream Baby Dream (User: melons)
The Inserts - Chemnitz (User: melons)
Color TV - Anybody's Girl (User: melons)
Empat Lima - Moonkcake (User: melons)
Sucrette - Future Trip (User: melons)
La Bien Querida - De Momento Abril (User: melons)
Single - Llévame A Dormir (User: melons)
Mirafiori - Agujeros En La Arena (User: melons)
Single - Fotos (User: melons)
Camera Obscura - Super Trouper (User: melons)
The School - Is He Really Coming Home? (User: melons)
La Bien Querida - 9.6 (Milkyway Cute Mix) (User: melons)
Anna & The Spectors - Ups To You (User: melons)
Papa Topo - Lo Que Me Gusta Del Verano Es Poder Tomar Helado (User: melons)
La Casa Azul - Todas Tus Amigas (User: melons)
Carlos Berlanga - Lady Dilema (User: melons)
Nick Garrie - Wheel Of Fortune (User: melons)
Corazón - Vestir Santos (User: melons)
Giorgio Tuma - Gorni Koala (User: melons)
The Carrots - Doing Our Part (User: melons)
Ibon Errazkin - Pasatiempos Poéticos (Instrumental) (User: melons)
Trembling Blue Stars - Beautiful Blank (Radio Edit) (User: melons)
Sting - Brand New Day (User: melons)
Stevie Wonder - Sir Duke (User: melons)
Serpentina - El Universo (User: melons)
Astrud - Lo popular (User: melons)
Gilbert O'Sullivan - Nothing Rhymed (User: melons)
Simon & Garfunkel - Homeward Bound - Paul Simon, Art Garfunkel (User: melons)
Cola Jet Set - Suena el Teléfono (User: melons)
Sam Cooke - Another Saturday Night (User: melons)
Nick Garrie - Twilight (User: melons)
Modular - Playa Biquini (User: melons)
The School - Tell Me (User: melons)
Giorgio Tuma - ...And Three Parasol Stars (User: melons)
Fitness Forever - Bacharach (User: melons)
Les Très Bien Ensemble - À Hélène (User: melons)
Linda Guilala - Nadie Se Dará Cuenta (User: melons)
Cooper - Steph (User: melons)
Modular - Zapatófono (User: melons)
Speedmarket Avenue - Way Better Now (User: melons)
Spring - Chuck It Up! (User: melons)
Helen Love - New Boy In Town (User: melons)
Spiritualized - I Think I'm in Love (User: melons)
The Monochrome Set - Eine Symphonie Des Grauens (User: melons)
PJ Harvey - My Beautiful Leah (User: melons)
The Monochrome Set - Eine Symphonie Des Grauens (User: melons)
Harry Nilsson - Gotta Get Up (User: melons)
Belle and Sebastian - Dear Catastrophe Waitress (User: melons)
Spoon - Car Radio (User: melons)
Margo Guryan - Why Do I Cry (User: melons)
Elliott Smith - Everything Means Nothing to Me (User: melons)
Wire - Outdoor Miner - 2006 Remastered Version (User: melons)
Unit 4 + 2 - Concrete And Clay (User: melons)
The Zombies - This Will Be Our Year (User: melons)
The Amps - She's a Girl (User: melons)
Gerry & The Pacemakers - How Do You Do It? - Mono (User: melons)
Harry Styles - As It Was (User: melons)
Barry Can't Swim - Everything Is Going To Be Alright (User: melons)
The Olivia Tremor Control - Jumping Fences (User: melons)
The Olivia Tremor Control - Jumping Fences (User: melons)
Olivia's World - Cereal Boxes (User: melons)
Guided by Voices - Game of Pricks (User: melons)
The Jesus and Mary Chain - Sometimes Always (User: melons)
Screamin' Jay Hawkins - I Put a Spell on You (User: melons)
Aztec Camera - Somewhere In My Heart (User: melons)
Ben Folds Five - Where's Summer B.? (User: melons)
Clinic - Distortions (User: melons)
The Magnetic Fields - Busby Berkeley Dreams (User: melons)
The The - Uncertain Smile (User: melons)
Stereolab - French Disko (User: melons)
Beats International - Dub Be Good To Me (User: melons)
Spoon - You Got Yr. Cherry Bomb (User: melons)
Ice Cube - It Was A Good Day (User: melons)
dEUS - Suds & Soda (User: melons)
Al Green - How Can You Mend a Broken Heart (User: melons)
Scarce - All Sideways (User: melons)
Sparks - The Number One Song in Heaven (User: melons)
Chat Pile - Slaughterhouse (User: melons)
The Beautiful South - Song For Whoever (User: melons)
Cat Stevens - Moonshadow (User: melons)
Frankie Valli - You're Ready Now (User: melons)
The Black Crowes - Hard To Handle (User: melons)
Foals - 2am (User: melons)
Dummy Artist Name UK - 12 (User: melons)
The Young Idea - With a Little Help from My Friends (User: melons)
Lloyd Cole & The Commotions - Perfect Skin (User: melons)
MGMT - Electric Feel (Radio Edit) (User: melons)
MGMT - Electric Feel (User: melons)
La Casa Azul - Todas Tus Amigas (User: melons)
Kurt Nilsen - She's So High (User: melons)
Mariah - Shinzo No Tobira (User: melons)
Steven Halpern - 1st Chakra_ Keynote C (red) (User: melons)
The Free Design - Ivy on a Windy Day (User: melons)
Bartholme - Hurricane Fighter Plane (2011 Sonic Boom Stereo Remaster) (User: melons)
Yo La Tengo - Evanescent Psychic Pez Drop (User: melons)
The Byrds - I See You (User: melons)
Woo - Mobile Phone (User: melons)
Craig Leon - Region of Fleeing Civilians (User: melons)
Lonnie Liston Smith - Visions of a New World - Phase I (User: melons)
Ben Folds Five - Tom & Mary (User: melons)
Ben Folds Five - Twin Falls - live (User: melons)
Ben Folds Five - Twin Falls - live (User: melons)
Ben Folds Five - Bad Idea (User: melons)
Ben Folds Five - Best Imitation of Myself (User: melons)
Ben Folds Five - Sports & Wine (User: melons)
Ben Folds Five - Julianne (User: melons)
Ben Folds Five - Underground (User: melons)
Suede - She Still Leads Me On (User: melons)
Orange Juice - Rip It Up (User: melons)
Orchestral Manoeuvres in the Dark - Extended Souvenir - 2003 Digital Remaster (User: melons)
Adam Ant - Wonderful (User: melons)
The High Llamas - Checking In, Checking Out (User: melons)
Leif Garrett - Feel The Need (User: melons)
Vacaciones - Poppy Girl (User: melons)
Supertramp - Breakfast In America - 2010 Remastered (User: melons)
Rata Negra - Ratas (User: melons)
Futuro Terror - Urgentes (User: melons)
Futuro Terror - Se Encerró (User: melons)
Nosoträsh - Voy A Aterrizar (User: melons)
Nadadora - Deshazte de mí (User: melons)
Niza - Por Las Tardes (User: melons)
Vacaciones - Poppy Girl (User: melons)
Mercromina - En un mundo tan pequeño (User: melons)
Futuro Terror - Precipicio (User: melons)
Lagartija Nick - Agonía, Agonía (User: melons)
Moaning - Don't Go (User: melons)
Perro - La Reina de Inglaterra (User: melons)
Aventuras De Kirlian - Un día gris (User: melons)
