Bklava - Anywhere With You (User: melons)
Dusky - Endless Sky (User: melons)
Obskür - Twister (User: melons)
Biig Piig - Kerosene (User: melons)
sensu - Hypnotize Me Baby (User: melons)
Dexter - Vexed (User: melons)
piri & tommy - on & on (User: melons)
George Riley - Desire (User: melons)
Jockstrap - What’s It All About? (User: melons)
Le Tigre - Deceptacon (User: melons)
Tim Heidecker - Prelude To Feeling (User: melons)
Tim Heidecker - Fear of Death (User: melons)
Aby Ngana Diop - Dieuleul-Dieuleul (User: melons)
Makthaverskan - Josef (User: melons)
Makthaverskan - Leda (User: melons)
Timber Timbre - Grifting (User: melons)
DRENCH FRIES - Desert Song (User: melons)
Opus Kink - I Love You, Baby (User: melons)
Emeralds - Candy Shoppe (User: melons)
HighSchool - Frosting (User: melons)
Bingo Fury - Happy Snake (User: melons)
Handle - Mhmm (User: melons)
Sheer Mag - Expect The Bayonet (User: melons)
Sitcom - Question (User: melons)
fanclubwallet - That I Won't Do (User: melons)
Jens Lekman - You Are The Light (by which I travel into this and that) (User: melons)
The Concretes - You Can't Hurry Love (User: melons)
Coach Phillips - Hypoarousal (User: melons)
Dan Deacon - Hypnagogic (User: melons)
Wheat - Slow Fade (User: melons)
Part Chimp - I Feel Fantastic (User: melons)
Wheat - Slow Fade (User: melons)
Baby Dave - Gen Z Baby (User: melons)
Beak> - Oh Know (User: melons)
Bread Pilot - Eye Listening (User: melons)
The Lounge Society - Beneath The Screen (User: melons)
Parov Stelar - The mojo radio gang - radio version (User: melons)
Automotion - The Dicethrow (User: melons)
Dennis Alcapone - Teach The Children (User: melons)
Mara Balls - Oo Mun Oma (User: melons)
The Offspring - Gone Away (User: melons)
Kat Edmonson - Just Like Heaven (User: melons)
Jill Barber - Be My Man (User: melons)
Emilie-Claire Barlow - Les Yeux Ouverts (Dream a Little Dream of Me) (User: melons)
Pink Martini - Ou est ma tete? (User: melons)
Magazine - A Song From Under The Floorboards - Remastered 2007 (User: melons)
Denim - Middle of the Road (User: melons)
The Gun Club - The Breaking Hands (User: melons)
The Pastels - Comin' Through (User: melons)
Flash and the Pan - Down Among the Dead Men (User: melons)
The Pastels - Comin' Through (User: melons)
Dexys Midnight Runners - Thankfully Not Living in Yorkshire It Doesn't Apply - 2000 Remaster (User: melons)
The Dead Milkmen - Punk Rock Girl (User: melons)
Biff Bang Pow! - Lost Your Dreams (User: melons)
Kooze - Galley Oh Hoop Hoop (User: melons)
Brijean - Ooo La La (User: melons)
Cleopold - Cleveland (User: melons)
Oliver Tree - Placeholder (User: melons)
Moglii - Morning Dew (User: melons)
Alex Isley - Love Again (User: melons)
Elliott Trent - One Friend (User: melons)
He Is Legend - Sand (User: melons)
Save Face - Bad (User: melons)
Can't Swim - One Shot (User: melons)
Kayak Jones - Matter (User: melons)
Youth Fountain - Ache (User: melons)
Dikembe - Scottie Spliffin (User: melons)
Columbus - Replace Me (User: melons)
Gold Route - Happier (User: melons)
No Pressure - So You Say (User: melons)
From First to Last - Emily (User: melons)
The Story So Far - Keep This Up (User: melons)
Kid Bloom - Have U Seen Her (User: melons)
Nicky Youre - Sunroof (User: melons)
Turnstile - MYSTERY (User: melons)
Still Woozy - Window (User: melons)
FKJ - Lying Together - Interlude (User: melons)
Smino - SUMMER SALT (with Bari) (User: melons)
Robohands - Lost (User: melons)
Jazzbois - Comedown (User: melons)
Maple Syrup - Pájaro (User: melons)
Moose Blood - Honey (User: melons)
Dargz - Happiness (User: melons)
okvsho - Elyjah Slaps the Space (User: melons)
Benny Hester - No The End Is Not Near (User: melons)
Lizzo - Paris (User: melons)
The Knife - Heartbeats (User: melons)
Just Mustard - Frank (User: melons)
Aimee Mann - How Am I Different (User: melons)
The Smiths - I Don't Owe You Anything - 2011 Remaster (User: melons)
The Chiffons - He's So Fine - Remastered 2000 (User: melons)
Iain Matthews - Carefully Taught (User: melons)
Iain Matthews - Shake It (User: melons)
Eleni Mandell - Girls (User: melons)
Randy Weston - A Ballad (User: melons)
Al Caiola - 'S Nice (User: melons)
Stereo Total - Relax baby be cool (User: melons)
Stereo Total - Wir tanzen im 4-eck (User: melons)
Plastics - Top Secret Man (User: melons)
Plastics - DELICIOUS (Welcome Back ver.) (User: melons)
Charles Wright & The Watts 103rd Street Rhythm Band - What Can You Bring Me (User: melons)
BaRRy - Children (User: melons)
Stavensuniverse - Paper Planes (User: melons)
Nina Hagen - Sonntagmorgen (User: melons)
Claude François - Combien De Rivières (User: melons)
Plastics - Last Train To Clarksville (User: melons)
Vince Hill - Sunny Afternoon - 2017 Remaster (User: melons)
Bettye Swann - This Old Heart Of Mine (User: melons)
JAY-Z - Otis (User: melons)
Jay & The Americans - The Sun Ain't Gonna Shine Anymore (User: melons)
Melanie - You Can't Hurry Love / Mama Said (User: melons)
Euclid - Gimme Some Lovin' (User: melons)
Demis Roussos - Paperback Writer (User: melons)
Eileen - Ces Bottes Sont Faites Pour Marcher (User: melons)
W.A.S.P. - Paint It Black (User: melons)
Gloria Gaynor - Reach out I'll Be There (User: melons)
Elizabeth Converse - Incommunicado (User: melons)
Connie Converse - Honeybee (User: melons)
Connie Converse - Trouble (User: melons)
Utah Saints - What Can You Do For Me - Radio Edit (User: melons)
Utah Saints - What Can You Do For Me - Radio Edit (User: melons)
Utah Saints - something good '08 - radio edit (User: melons)
Dan Vapid and the Cheats - Panic in the Streets (User: melons)
Valerie June - With You - A Sweet Little Love Song Demo (User: melons)
Eydie Gormé - Piel Canela (User: melons)
Klangstof - Seasons (User: melons)
The Brothers and Sisters - The Times They Are A Changing (User: melons)
John Vanderslice - Pale Horse (User: melons)
David Bowie - Ziggy Stardust - 2012 Remaster (User: melons)
David Bowie - Hang On To Yourself - 2012 Remaster (User: melons)
David Bowie - Star - 2012 Remaster (User: melons)
David Bowie - Lady Stardust - 2012 Remaster (User: melons)
David Bowie - It Ain't Easy - 2012 Remaster (User: melons)
David Bowie - Starman - 2012 Remaster (User: melons)
David Bowie - Moonage Daydream - 2012 Remaster (User: melons)
David Bowie - Eight Line Poem - 2015 Remaster (User: melons)
The Botticellis - Up Against the Glass (User: melons)
Marnie Stern - Year of the Glad (User: melons)
Wabie - Hey Lover! (User: melons)
The Zombies - This Will Be Our Year (User: melons)
The Beautiful South - Perfect 10 (User: melons)
The Chocolate Watchband - Baby Blue (User: melons)
Gil Trythall - Wichita Lineman (User: melons)
Earl Grant - House of Bamboo (User: melons)
The Walker Brothers - Shutout (User: melons)
The Silkie - You've Got To Hide Your Love Away (User: melons)
Katfish - Caught by the Fuzz [Recorded Live at the Dead Goat Saloon in Salt Lake City] - Jean Cream Prophecy Improvement (User: melons)
Bryn Christopher - Sour Times (User: melons)
Ora the Molecule - Here Comes the Hotstepper (User: melons)
My Robot Friend - Creep (User: melons)
Hi-Gate - Pitchin' (In Every Direction) - Vocal Radio Edit (User: melons)
Shy Limbs - Reputation (User: melons)
The Seeds - Pushin' Too Hard (User: melons)
Sophie Ellis-Bextor - Do You Remember The First Time? - Live (User: melons)
Les Incompétents - How It All Went Wrong (User: melons)
Kuu! - Sabotage (User: melons)
Sharaya J - Juicy - The Four Performance (User: melons)
Pet Shop Boys - Girls & Boys - Live in Rio; 2018 Remaster (User: melons)
TinaKristina - A Girl Like You (User: melons)
Wake Me - Kiss From A Rose (User: melons)
Seether - Seether (User: melons)
The So So Glos - Connection (Elastica) (User: melons)
Skeptics - Sheen of Gold (User: melons)
Hamerkop - The Splendour That Was Rome (User: melons)
Mermaidens - I Might Disappear (User: melons)
High Dependency Unit - Activation (User: melons)
Indi - Precipice (User: melons)
The Bats - Another Door (User: melons)
The Chills - Pink Frost (User: melons)
Pete Wingfield - A Whole Pot Of Jelly (for a little slice of toast) (User: melons)
OFF! - Black Thoughts (User: melons)
Fania All Stars - Ella Fue (She Was The One) (User: melons)
Karen Mok - Sour Times (User: melons)
Explorer Tapes - Texas Time (User: melons)
The Verlaines - Death and the Maiden (User: melons)
David Kilgour - no no no (User: melons)
Purple Pilgrims - Two Worlds Apart (User: melons)
Tall Dwarfs - Nothing's Going to Happen (User: melons)
Shayne P. Carter - I Know Not Where I Stand (User: melons)
Street Chant - Pedestrian Support League (User: melons)
Straitjacket Fits - She Speeds (User: melons)
Toy Love - Swimming Pool (User: melons)
Sandro Perri - Wrong About The Rain (User: melons)
Majid Soula - Win Terram (User: melons)
Natalie Bergman - Shine Your Light on Me (User: melons)
Sonic Boom - Just Imagine (User: melons)
Chris Cohen - Physical Address (User: melons)
Chris Cohen - Yesterday’s On My Mind (User: melons)
Papa M - Krusty (User: melons)
Pet Shop Boys - Later Tonight - 2018 Remaster (User: melons)
Silver Jews - Honk If You're Lonely (User: melons)
Jeff Tweedy - Guess Again (User: melons)
Ted Hawkins - Peace & Happiness (User: melons)
Stephen Malkmus - Come Get Me (User: melons)
Parsley Sound - Stevie (User: melons)
Parsley Sound - Ease Yourself and Glide (User: melons)
Cut Worms - Don't Want To Say Good-bye (User: melons)
Steve Gunn - Dust Filled Room (User: melons)
Billy Ocean - Love Really Hurts Without You (User: melons)
Lambchop - Nothing but a Blur From a Bullet Train (User: melons)
Billy Ocean - Love Really Hurts Without You (User: melons)
Al Green - Let's Get Married (User: melons)
Calexico - Not Even Stevie Nicks... (User: melons)
Calexico - Sunken Waltz (User: melons)
Calexico - Crystal Frontier - Widescreen Version (User: melons)
Calexico - The Book and the Canal (User: melons)
Wire - Outdoor Miner (User: melons)
Dummy - Daffodils (User: melons)
Stars of the Lid - The Better Angels of Our Nation (User: melons)
Luna - Sideshow By The Seashore (User: melons)
Garland Jeffreys - Moonshine In The Cornfield (User: melons)
Dick Stusso - Well Acquainted (User: melons)
The Clientele - Joseph Cornell (User: melons)
F. J. McMahon - early blue (User: melons)
Michael Hurley - Long Journey (User: melons)
MJ Lenderman - Another Place (User: melons)
MJ Lenderman - Gentleman's Jack (User: melons)
MJ Lenderman - Someone Get The Grill Out Of The Rain (User: melons)
Mdou Moctar - MDOU'S THEME (User: melons)
Cookie Monster - "C" Is for Cookie (User: melons)
The Mystery Lights - Goin' Down (User: melons)
Buck Meek - Candle (User: melons)
Bill Callahan - Sycamore (User: melons)
Dina Ögon - Ficktjuven (User: melons)
Andy Shauf - Judy (Wilds) (User: melons)
Connie Converse - Playboy of the Western World (User: melons)
Fanny - Hey Bulldog (User: melons)
Iron Curtain - love can never die (User: melons)
Gabriel Sayer - Youngest Child (User: melons)
Rudy Norman - Back To The Streets (User: melons)
Makthaverskan - Leda (User: melons)
Lost Horizons - I Woke Up With An Open Heart (User: melons)
Chris Bell - You And Your Sister (Original Version) (User: melons)
Lael Neale - Every Star Shivers in the Dark (User: melons)
Son Parapluie - Paris n'existe pas (User: melons)
JennyLee - Tickles (User: melons)
Black Lips - Get It On Time (User: melons)
Penelope Isles - Iced Gems (User: melons)
Tara Clerkin Trio - In The Room (User: melons)
Gruff Rhys - Shark Ridden Waters (User: melons)
Chris Bell - You And Your Sister (Original Version) (User: melons)
Joyce Street - That Man of Mine (User: melons)
Labi Siffre - Crying, Laughing, Loving, Lying (User: melons)
Spike Fuck - Body By Crystal (User: melons)
The Fall - F-'oldin' Money (User: melons)
Jay Som - Devotion (User: melons)
Tiña - I Feel Fine (User: melons)
Dennis Wilson - Rainbows (User: melons)
William Doyle - And Everything Changed (But I Feel Alright) (User: melons)
Samantha Crain - Pastime (User: melons)
Young Marble Giants - Wurlitzer Jukebox (User: melons)
Mina - Città vuota (User: melons)
When In Rome - The Promise (User: melons)
Michael Farneti - Come to Europe (User: melons)
Helium - XXX (User: melons)
Stevie Wonder - Yester-Me, Yester-You, Yesterday (User: melons)
Four Tet - Mango Feedback (User: melons)
The Chemical Brothers - Star Guitar (User: melons)
Billy Nomates - No (User: melons)
The Concretes - You Can't Hurry Love (User: melons)
Rockin' Horse - Yes It Is (User: melons)
Tom Northcott - Other Times (User: melons)
Bonnie Dobson - Good Morning Rain (User: melons)
Jo Marches - You'll Be Mine (User: melons)
Tom Petty - I Won't Back Down (User: melons)
Coma Cinema - Caroline, Please Kill Me (User: melons)
Booker T. & The M.G.'s - Soul Limbo (User: melons)
Belle and Sebastian - Dear Catastrophe Waitress (User: melons)
Pavement - Box Elder (User: melons)
Aretha Franklin - Think (User: melons)
The Human Beinz - Nobody But Me (User: melons)
Aphex Twin - Avril 14th (User: melons)
The Delgados - Under Canvas Under Wraps (User: melons)
The Pastels - Comin' Through (User: melons)
Bill Withers - Ain't No Sunshine (User: melons)
Bob Lind - Elusive Butterfly (User: melons)
Wild Honey - Renee (User: melons)
Round Table - Don’t Ask Me Why (User: melons)
The Botticellis - Up Against the Glass (User: melons)
Jackie Shane - Any Other Way - Remastered (User: melons)
Half Japanese - One Million Kisses (User: melons)
One Night Suzan - Is It True (User: melons)
Haich Ber Na - So Sick Of Me (User: melons)
BC Camplight - Suffer for two (User: melons)
The Young Fresh Fellows - Picture Book (User: melons)
Vince Guaraldi - Linus and Lucy (User: melons)
Broadcast - The Book Lovers (User: melons)
Camera Obscura - A Red, Red Rose (User: melons)
Half Cousin - The Absentee (User: melons)
Black Francis - I Sent Away (User: melons)
Sneaks - True Killer (User: melons)
Otis Redding - Hard to Handle (User: melons)
Harry Nilsson - Gotta Get Up (User: melons)
Kelley Stoltz - Jewel of the Evening (User: melons)
Mood Six - What Have You Ever Done? (User: melons)
Nicolas Michaux - Inauguration (User: melons)
The Millennium - I Just Want to Be Your Friend (User: melons)
Shudder To Think - Shake Your Halo Down (User: melons)
Willie J Healey - Big Nothing (User: melons)
Diana Ross & The Supremes - Reflections (User: melons)
The Monochrome Set - Eine Symphonie Des Grauens (User: melons)
Silver Apples - Ruby (User: melons)
Evie Sands - I Can't Let Go (User: melons)
Mr. Bloe - Groovin' With Mr. Bloe (User: melons)
Lou Christie - She Sold Me Magic (User: melons)
Sleater-Kinney - I Wanna Be Your Joey Ramone (User: melons)
Cate Le Bon - Wonderful (User: melons)
The Chills - Soft Bomb II (User: melons)
Friends Again - Bird Of Paradise (User: melons)
PJ Harvey - My Beautiful Leah (User: melons)
Friends Again - Bird Of Paradise (User: melons)
PJ Harvey - My Beautiful Leah (User: melons)
Portico Quartet - Double Space (User: melons)
Blur - Sunday Sunday - 2012 Remaster (User: melons)
John Lennon - Hold On - Remastered 2010 (User: melons)
Cardinal - Tough Guy Tactics (User: melons)
Departure Lounge - Mr. Friendly (User: melons)
Pete Drake - The Spook (User: melons)
Pérez Prado - Patricia (User: melons)
Nick Lowe - So It Goes (User: melons)
Five Man Electrical Band - We Go Together Well (User: melons)
Bar Italia - rage quit (User: melons)
The Shangri-Las - Remember (Walkin' In The Sand) - The Oh No Song (User: melons)
The Mojo Men - Sit Down I Think I Love You - Single Version (User: melons)
Wussy - Yellow Cotton Dress (User: melons)
Revolver - Get Around Town (User: melons)
Herbie Mann - Day Tripper (User: melons)
Dexys Midnight Runners - Thankfully Not Living in Yorkshire It Doesn't Apply - 2000 Remaster (User: melons)
Sweeping Promises - Hunger for a Way Out (User: melons)
The Nerves - When You Find Out (User: melons)
The Jackpots - Tossing and Turning (User: melons)
Portastatic - San Andreas (User: melons)
Neutral Milk Hotel - The Fool (User: melons)
Four Tet - Everything Is Alright (User: melons)
Ross From Friends - A Brand New Start (User: melons)
Little Eva - The Locomotion (User: melons)
DANGERDOOM - Crosshairs (User: melons)
Apollo Ghosts - Land Of The Morning Calm (User: melons)
Pet Fox - It Won't Last (User: melons)
The Bananas - 4 AM (User: melons)
Maude Latour - Probabilities (User: melons)
Mauv - Manual (User: melons)
Aguinaldo Hooker - Congo Malata (Calypso) (User: melons)
Sandino Ellis - Stone Cold Dead in the Market (Calypso) (User: melons)
Rosulo Maclauth - Gloria a Dios Me Libertad - Glory to God He Has Set Me Free (User: melons)
Unspecified - Juancito Lucupi (Guaracha Instrumental) (User: melons)
Seas of Dreams - Nicaraguan Tangiers (User: melons)
Duckmaw - Nicaraguan Dream (User: melons)
Calos Mejia Godoy - Nicaragua Nicaragüita (User: melons)
Yat-Kha - Kozhamyk (User: melons)
Shu-De - Meen Khemchim (User: melons)
Yat-Kha - Karangailyg Kara Hovaa (Dyngyldai) (User: melons)
Batzorig Vaanchig - Hunnu Guren (User: melons)
Hanitra Ranaivo - Refila (User: melons)
Rakoto Frah - Voahangy (User: melons)
Heitor Pereira - Chums (User: melons)
Damily - Kalitaky (User: melons)
Ed Banger - Kinnel Tommy (User: melons)
The Out - Who Is Innocent (User: melons)
Central Detention Centre - Gyro (User: melons)
My Tapes Gone - The Freshies (User: melons)
Bet Lynch’s Legs - High Noon (User: melons)
The Mothmen - Does It Matter Irene (User: melons)
The Nosebleeds - Ain't Been To No Music School (User: melons)
48 chairs - Psycle Sluts (User: melons)
Slaughter and the Dogs - Cranked Up Really High (User: melons)
Chris Sievey - Baiser (User: melons)
Bonny Light Horseman - Sweetbread (User: melons)
The Lone Bellow - Honey (User: melons)
Noah Kahan - Northern Attitude (User: melons)
Samara Joy - Guess Who I Saw Today (User: melons)
Rhett Miller - Heart Attack Days (User: melons)
Ondara - A Blackout In Paris (User: melons)
Noah Cyrus - Ready to Go (User: melons)
Meg Mac - Is It Worth Being Sad (User: melons)
Little Big Town - All Summer (User: melons)
Lissie - Unravel (User: melons)
Julian Lage - Heart Is A Drum (User: melons)
The Harlem Gospel Travelers - Hold On (Joy Is Coming) (User: melons)
Eliza - A Tear for the Dreadful (User: melons)
Danielle Ponder - Someone Like You (User: melons)
Butcher Brown - Freeze Me (User: melons)
The Black Angels - History of the Future (User: melons)
Amy Ray - From This Room (User: melons)
The Beths - Your Side (User: melons)
pink siifu - Afro Russian (feat. Amani) (User: melons)
Quinn Christopherson - Uptown (User: melons)
Miloe - elastic (User: melons)
LYZZA - Lucky You (User: melons)
R.E.M. - I Believe (User: melons)
R.E.M. - The Flowers of Guatemala (User: melons)
R.E.M. - Underneath the Bunker (User: melons)
R.E.M. - Hyena (User: melons)
R.E.M. - Cuyahoga (User: melons)
R.E.M. - Fall on Me (User: melons)
The Jerry Hormone Ego Trip - Oxazepam (User: melons)
R.E.M. - These Days (User: melons)
R.E.M. - Begin the Begin (User: melons)
Bunny Sigler - Will You Still Love Me Tomorrow featuring Bunny Sigler (User: melons)
George Tindley - Love Light Shines featuring George Tindley (User: melons)
The Moods - Rainmaker featuring The Moods (User: melons)
Cupit - Trainman featuring Cupit (User: melons)
Johnny Caswell - IOU featuring Johnny Caswell (User: melons)
The Sherrys - No No Baby featuring The Sherrys (User: melons)
James Bounty - Auction On Love featuring James Bounty (User: melons)
Cindy Scott - In Your Spare Time featuring Cindy Scott (User: melons)
Len Barry - Lazy Susan featuring Len Barry (User: melons)
The Mellow Moods - When You Go Take Your Memories featuring The Mellow Moods (User: melons)
Grover Mitchell - Who Can I Turn To featuring Grover Mitchell (User: melons)
The Lavenders with Leon Huff - One More Time featuring The Lavenders with Leon Huff (User: melons)
The Formations - Don't Get Close featuring The Formations (User: melons)
The Sweet Three - Bluer Than Blue featuring The Sweet Three (User: melons)
Joey Heatherton - Live and Learn featuring Joey Heatherton (User: melons)
The Bobbi-Pins - Why Did You Go featuring The Bobbi-Pins (User: melons)
The Tymes - These Foolish Things featuring The Tymes (User: melons)
Joe Renzetti - Reach Out featuring Joe Renzetti (User: melons)
The Formations - Lonely Voice of Love featuring The Formations (User: melons)
The Sweet Three - Don't Leave Me Now featuring The Sweet Three (User: melons)
The Electric Indian - Keem-O-Sabe featuring The Electric Indian (User: melons)
Daryl Hall - Girl Don't Make Me Wait featuring Daryl Hall (User: melons)
The T-Bones - No Matter What Shape (Your Stomach's In) (User: melons)
The Electric Indian - Keem-O-Sabe (User: melons)
Mike Clifford - Close To Cathy (User: melons)
Danny Williams - White On White (User: melons)
Randy & The Rainbows - Denise (User: melons)
The People - I Love You (User: melons)
Jody Miller - Queen Of The House (User: melons)
Garnet Mimms & The Enchanters - For Your Precious Love (User: melons)
Music Explosion - Little Bit O' Soul - Remastered (User: melons)
Garnet Mimms & The Enchanters - For Your Precious Love (User: melons)
Patty Duke - Don't Just Stand There (User: melons)
The Majors - A Wonderful Dream (User: melons)
Oliver - Jean (User: melons)
The Jarmels - A Little Bit of Soap (User: melons)
Jeanne Black - He'll Have to Stay (User: melons)
Jack Scott - Burning Bridges (User: melons)
Dick & Dee Dee - The Mountain's High (User: melons)
Fat Fluids - East Coast - West Coast Anthem - Big Willy Style (User: melons)
Pusssssy Galore - Never Let Go - Jason's Big Hit Mix (User: melons)
Kim English - Nitelife - Armand Van Helden Retail Mix (User: melons)
Twizzler - Tripwire - Original Mix (User: melons)
Loni Clark - U - Slinky Vocal (User: melons)
Black Moon - Buck 'Em Down - Da Beatminerz Remix (User: melons)
Willie Ninja - Hot - Louie Vega's Why? Because I'm Hot Mix (User: melons)
The Flip Squad - Check Out The Style - Vocal Mix (User: melons)
Cypher - Acid Love - Trance Mix (User: melons)
Progression - Reach Further - Remix (User: melons)
Frankie Feliciano - Ordinary Folk - Original Mix (User: melons)
Mad Lion - Take It Easy - Intro Edit (User: melons)
Veda Simpson - Oohhh Baby - Armand Van Helden Remix (User: melons)
Peak hour rhythms - Milagro Del Ritmo - Mezcla De La Tierra (User: melons)
Rek Shit Rebelz - Make Ya Feel Betta - Original Mix (User: melons)
Wreck All Stars - Keep Me Dancin' - All Night (User: melons)
Brooklyn Slumlordz - Change The Groove - Zoom Mix (User: melons)
Joe T Vannelli - Play With The Voice feat. Csilla - Maw In Your Face Mix (User: melons)
2 Da Rhythm - A Special Groove - 12 inch Mix (User: melons)
Redrum - Buddah Man - Original Mix (User: melons)
DJ Pierre - War Drums - The Battle Mix (User: melons)
the Potion - The Mountain Top - Deeper Than Dope (User: melons)
Deep Creed '94 - Can U Feel It - Shell Toe Mix (User: melons)
Mad Lion - Shoot To Kill - Glock Mix (User: melons)
All In The House - Mad As Hell - BOP Till U Drop Mix (User: melons)
Classic Man - Rapid Winds - 75 MPH Mix (User: melons)
Smif-n-Wessun - Bucktown - Vocal Mix (User: melons)
Todd Edwards - Guide My Soul - Original Mix (User: melons)
Black Moon - How Many Emcee's [Must Get Dissed] - Bushwick Jeep Mix (User: melons)
Loni Clark - U - Mood II Swing Club Mix (User: melons)
Frankie the Pacemaker - Live And Die Reck Part 2 - Ruffuckinmix (User: melons)
Funk Flex - C'mon Baby - Ghetto Mix (User: melons)
Wink - Nervous Build-Up - Nervous Mix (User: melons)
West Coast Spice - Injoye - DJ EFX's Supa Pump Mix (User: melons)
Akema - No Regrets - Club Vocal (User: melons)
William Rosario, On The Down Low - Dat Tunes - Jazz Mix (User: melons)
People - These Are The Rules - Original Mix (User: melons)
M.A.D.A. - The Good Stuff - Culture Mix (User: melons)
Element - Oh You Got Me - The Rhythm Front Mix (User: melons)
Adam and Darcie - Aotearoa (User: melons)
Harry Bird - Pesadilla No.7 (User: melons)
Le Man Avec Les Lunettes - Don't Get Fooled By the Football Players' Summery Outfit (User: melons)
Spirit Spine - Field Way (Song for Cameroon) (User: melons)
Goat Boy - Japanese City Nights (User: melons)
Cleemann - Princes of Denmark (User: melons)
Burning Codes - Wooded Land (User: melons)
The Invisible Clock Factory - We Are the Black Stars (User: melons)
Hunter Gatherer - Serbia (User: melons)
Sleep Good - Australia (User: melons)
Betty & the Cavalero - Meet Me at the Red Light (User: melons)
Lightholler - Slovenia’s Dream (User: melons)
Billy Joel - Piano Man (User: melons)
Boca Chica - Wildlife of Algeria (User: melons)
Echo Orbiter - Game Without a Name (User: melons)
Mary Jane Girls - All Night Long (User: melons)
The Pipettes - Pull Shapes (User: melons)
The Supremes - Nathan Jones (User: melons)
Detox Cute - St George’s Day (User: melons)
Kate Bush - The Red Shoes (User: melons)
Chris Isaak - Blue Hotel (User: melons)
Karyn White - Superwoman (User: melons)
At Last An Atlas - The Pirate Ship (User: melons)
Harry Chapin - W*O*L*D* (User: melons)
Pearse McGloughlin - Jongmyo Shrine (User: melons)
Grand Pocket Orchestra - Nigeria (User: melons)
The Dirty 9s - Ballad of El Diego (User: melons)
The Very Most - Irlande (User: melons)
International Novelty Orchestra - Parade of the Wooden Soldiers (User: melons)
International Novelty Quartet - Down South (User: melons)
Kit-Kat Band - There's a Rickety Rackety Shack (User: melons)
The Savoy Havana Band - Felix Keeps on Walking (User: melons)
The Savoy Havana Band - Why DId I Kiss That Girl? (User: melons)
Columbia Novelty Orchestra - The Little Wooden Whistle Wouldn't Whistle (User: melons)
Lcslie Sarony - All by Yourself in the Moonlight (User: melons)
Art Hickman and His Orchestra - Come Back to Georgia (User: melons)
Broadway Dance Orchestra - Love Me (User: melons)
Arthur Osmond - Wallaperoo (User: melons)
Billy Murray - The Little Ford Rambled Right Along (User: melons)
Billy Williams - Tickle Me, Timothy (User: melons)
Billy Merson - The Spaniard That Blighted My Life (User: melons)
Walter Van Brunt - Everything's at Home Except Your Wife (User: melons)
Tennessee Happy Boys - I Miss My Swiss (User: melons)
Premier Quartet - Oh By Jingo, Oh By Gee (User: melons)
Jack Charman - The Wibbly Wobbly Walk (User: melons)
Showstar - Uruguay! (User: melons)
Standard Fare - Vaya Vaya México! (User: melons)
Cop On the Edge - Bafana Bafana (User: melons)
Goldfrapp - Slide In (DFA Remix) (User: melons)
Demis Roussos - Forever And Ever (User: melons)
Beluga Lagoon - Neverland (User: melons)
Dummy - Daffodils (User: melons)
The Legendary Bang - Love (User: melons)
Harry Styles - As It Was (User: melons)
Erasure - Drama! - 2019 - Remaster (User: melons)
Sugababes - Overload (User: melons)
Pet Shop Boys - What Have I Done to Deserve This? (with Dusty Springfield) - 2001 Remaster (User: melons)
Keyboard - The Most Important Part (User: melons)
The Monochrome Set - Eine Symphonie Des Grauens (User: melons)
Dog Power - Dark Nights, Dark Hotels (User: melons)
Superette - Saskatchewan (User: melons)
Lawrence Arabia - Malade (User: melons)
Wax Chattels - No Ties (User: melons)
Hamerkop - T I N Y (User: melons)
Double Happys - Wrapped Up In Myself Again (User: melons)
Robert Scott - Lazy Boy (User: melons)
Voom - We're So Lost (User: melons)
Purple Pilgrims - Two Worlds Apart (User: melons)
Reb Fountain - Samson (User: melons)
Mermaidens - I Might Disappear (User: melons)
Indi - Precipice (User: melons)
Kody Nielson - Ruban's Birthday (User: melons)
Wax Chattels - Stay Disappointed (User: melons)
Fazerdaze - Lucky Girl (User: melons)
The Great Unwashed - Can't Find Water (User: melons)
Zen Mantra - Second Skin (User: melons)
Kane Strang - Full Moon, Hungry Sun (User: melons)
The 3-D's - Beautiful Things (User: melons)
FU-Schnickens - Sneakin' Up On Ya (LP Version) (User: melons)
3Ds - Beautiful Things (User: melons)
Ani DiFranco - Overlap (User: melons)
Heavenly - Me and My Madness (User: melons)
Drive Like Jehu - Luau (User: melons)
Tall Dwarfs - Mr. Broccoli (User: melons)
Avoid!Avoid - Achieved Not Achieved (User: melons)
Surf Friends - Holiday (User: melons)
Princess Chelsea - Too Many People (User: melons)
Loves Ugly Children - Space Suit (User: melons)
Consolidated - Butyric Acid (User: melons)
Selena - Bidi Bidi Bom Bom (User: melons)
Gordons - Adults and Children (User: melons)
Sam Phillips - Strawberry Road (User: melons)
Cutty Ranks - Armed & Dangerous (User: melons)
Tiny Ruins - Me at the Museum, You in the Wintergardens (User: melons)
Dillinja - Sovereign Melody (User: melons)
Plastikman - Plastique (User: melons)
Ghost Wave - Here She Comes (User: melons)
Grayson Gilmour - Lichtung (User: melons)
Portishead - Wandering Star (User: melons)
Bratmobile - and i live in a townwhere the boys amputate... (User: melons)
Global Communication - 8:07 (User: melons)
T54 - Return of the Worm (User: melons)
The Subliminals - Uh-oh (User: melons)
High Dependency Unit - Schallblute (User: melons)
Bressa Creeting Cake - Palm Singing (User: melons)
Garageland - Fingerpops (User: melons)
David Kilgour - no no no (User: melons)
Able Tasmans - hold me 1 (User: melons)
Chris Knox - Not Given Lightly (User: melons)
Skeptics - And We Bake (User: melons)
3Ds - Outer Space (User: melons)
Bird Nest Roys - Alien (User: melons)
Straitjacket Fits - She Speeds (User: melons)
Sneaky Feelings - Husband House (User: melons)
Look Blue Go Purple - Cactus Cat (User: melons)
Tall Dwarfs - Nothing's Going to Happen (User: melons)
The Clean - Tally Ho! (User: melons)
Toy Love - Swimming Pool (User: melons)
Telekinesis - Sheila Take A Bow (User: melons)
White Knight Instrumental - I Want the One I Can't Have (User: melons)
Cilla Black - Work Is A Four Letter Word (User: melons)
Rockformation Diskokugel - Unhappy Birthday (User: melons)
Eurythmics - Last Night I Dreamt That Somebody Loved Me - Remastered Version (User: melons)
Silly Nelson and The Cop Cars - Death of a Disco Dancer (User: melons)
Broadway Calls - A Rush And A Push And The Land Is Ours (User: melons)
Solvents - Is It Really So Strange? (User: melons)
Twinkle - Golden Lights (User: melons)
Mark Deon - Draize Train (User: melons)
Girl in a Coma - Rubber Ring (User: melons)
Supergrass - Some Girls Are Bigger Than Others (User: melons)
Lila - the boy with the thorn in his side (User: melons)
Among The Oak & Ash - Bigmouth Strikes Again (User: melons)
Oslo Swan - Frankly Mr Shankly (User: melons)
Cyndi Harvell - Stretch Out and Wait (User: melons)
Paul Rahme - Oscillate Wildly (User: melons)
Kae - Meat Is Murder (User: melons)
Pilgrim Speakeasy - Barbarism Begins At Home (User: melons)
Sara Lov - Well I Wonder (User: melons)
The Spirits - That Joke Isn't Funny Anymore (User: melons)
Katy Goodman - What She Said (User: melons)
Craig Wedren - The Headmaster Ritual (User: melons)
Johnny Aries - Back to the Old House (User: melons)
Lovesick - Girl Afraid (User: melons)
White Knight Instrumental - Accept Yourself (User: melons)
Underwater - This Night Has Opened My Eyes (User: melons)
Act - Heaven Knows I'm Miserable Now (User: melons)
t.A.T.u. - How Soon Is Now? (User: melons)
Janice Whaley - These Things Take Time (User: melons)
Rockabye Baby! - William, It Was Really Nothing (User: melons)
The Pastels - Comin' Through (User: melons)
Parenthetical Girls - Handsome Devil (User: melons)
Soft Metals - Suffer Little Children (User: melons)
Ebony Bones! - what difference does it make (User: melons)
Male Bonding - Still Ill (User: melons)
Blackbird Blackbird - The Hand That Rocks the Cradle (User: melons)
Alan Mesia - Pretty Girls Make Graves (User: melons)
Field Mouse - Miserable Lie (User: melons)
Mother Falcon - You've Got Everything Now (User: melons)
Outrageous Cherry - Reel Around the Fountain (User: melons)
The Orb - O.O.B.E. - Andy Hughes Mix (User: melons)
The Orb - Sticky End (User: melons)
The Orb - U.F.Orb (User: melons)
European Ghost - Moderate (User: melons)
The Orb - O.O.B.E. (User: melons)
UNKLE - Nursery Rhyme / Breather (User: melons)
Corona - Rhythm Of The Night (User: melons)
Madina Lake - Here I Stand (radio mix) (User: melons)
Whitney Houston - I'm Your Baby Tonight (User: melons)
Hot Chocolate - It Started With A Kiss (User: melons)
Ne-Yo - Let Me Love You (Until You Learn To Love Yourself) Feat. Beni (User: melons)
S Club 7 - Don't Stop Movin' (User: melons)
Bernard Cribbins - Right Said Fred (User: melons)
Panic Shack - The Ick (User: melons)
King Tubby - Each One Dub (User: melons)
Franz Ewer - Früh (User: melons)
First Choice - Yes, Maybe No (User: melons)
Thousand - Le nombre de la bête (User: melons)
Sensitizer - Dub Orchestra (User: melons)
Lunachicks - I'll Be the One (User: melons)
Britton - EAGER (User: melons)
James MacMillan - St Anne’s Mass: III. Sanctus (User: melons)
Kris Kross Amsterdam - Hij Is Van Mij (feat. Bizzey) (User: melons)
Sam Feldt - The Best Days (feat. Tabitha) (User: melons)
Bonny Doon - Where Do You Go? (User: melons)
Public Body - Flavour of Labour (User: melons)
N O R M a L - spirits (User: melons)
UNKLE - Getting Ahead in the Lucrative Field of Artist Management (User: melons)
UNKLE - Lonely Soul (User: melons)
UNKLE - Unreal (User: melons)
UNKLE - Bloodstain (User: melons)
UNKLE - U.N.K.L.E. Main Title Theme (User: melons)
UNKLE - Guns Blazing (Drums Of Death Pt. 1) (User: melons)
Leftfield - 21st Century Poem - Remastered (User: melons)
Leftfield - Open Up - Remastered (User: melons)
Leftfield - Storm 3000 - Remastered (User: melons)
Leftfield - Inspection (Check One) - Remastered (User: melons)
Leftfield - Original - Remastered (User: melons)
Leftfield - Melt - Remastered (User: melons)
Leftfield - Afro Left - Remastered (User: melons)
Leftfield - Release the Pressure (User: melons)
xj5000 - brownthing (User: melons)
Donald Beck - Erythema & Tachycardia (User: melons)
Bruno Major - Regent's Park (User: melons)
C418 - Flake (User: melons)
Lea Taex - Hips Dont Lie - Remix (User: melons)
Raam - 777 (User: melons)
aespa - aenergy (User: melons)
Mousey - The Bench (User: melons)
Wage War - Manic (User: melons)
French 79 - Hometown (Intro) (User: melons)
Grip - Spatula (User: melons)
Gombeen & Doygen - D'Americana - Mixed (User: melons)
The Meteors - Ain't Taking A Chance (User: melons)
The Wolfhounds - Lost but Happy (User: melons)
The Stingrays - I Live For The Sun (User: melons)
Guana Batz - I'm On Fire (User: melons)
The Dentists - She Dazzled Me With Basil (User: melons)
Gyrating Bhtch - The Hostess with the Mostest Has Endometriosis (User: melons)
Creep Diets - Endometriosis (User: melons)
Jim Cosgrove - Stinky Feet (User: melons)
The Chats - Stinker (User: melons)
HAARPER - Bungee Gum (User: melons)
Suave Lee - Phonky Trap (User: melons)
Tom van Beers - Miffy and Friends (User: melons)
Corpse - MISA MISA! (User: melons)
Dream Nails - Text Me Back (Chirpse Degree Burns) (User: melons)
The Janitors - Good To Be King (User: melons)
Demented Are Go - Holy Hack Jack (User: melons)
The Yellow Melodies - Magnesia (User: melons)
ABBA - People Need Love (User: melons)
Damu The Fudgemunk - Rigatoni - Single Version (User: melons)
Lucas Estrada - Bloom (nowifi Remix) (User: melons)
Galwaro - Monster (User: melons)
Playboi Carti - Go2DaMoon (feat. Kanye West) (User: melons)
Damso - William (User: melons)
Mr Crush - Hello (User: melons)
セキトオ・シゲオ - ザ・ワード II (User: melons)
Oldelaf - La belle histoire (User: melons)
Suarez - Qu'est-ce que j'aime ça (User: melons)
Joe Dassin - Les Champs-Elysées (User: melons)
Therapie TAXI - Superstar (User: melons)
triciclo circus band - Excusez-moi (User: melons)
MagoYond - Le Pudding à l'Arsenic (Bonus Track) (User: melons)
YEИDRY - Mascarade (feat. Lous and The Yakuza) - Radio Edit (User: melons)
Oldelaf et Monsieur D. - Le Café (User: melons)
Dionysos - Tais-Toi Mon Coeur (User: melons)
Olivia Ruiz - Elle Panique (User: melons)
Noir Désir - Imbécile (User: melons)
Tryo - Marchand de cailloux (User: melons)
The Red Army Choir - Les Champs-Elysées (feat. Julien Dassin) (User: melons)
L'Entourloop - La main à la pâte (User: melons)
Louise Attaque - Vous Avez L'Heure (User: melons)
Colette Renard - Les nuits d'une demoiselle (User: melons)
Colette Renard - Les nuits d'une demoiselle (User: melons)
Bruno Coulais - Vois sur ton chemin (User: melons)
Déportivo - Parmi eux (User: melons)
Bruno Coulais - Caresse sur l'océan (User: melons)
Suzane - Laisse tomber les filles (User: melons)
Mademoiselle K - Reste Là (User: melons)
Mister Toony - Dansons la capucine (User: melons)
Vitamin String Quartet - South Central Rain - I'm Sorry (User: melons)
Winston K. - So. Central Rain (Acoustic Version) (User: melons)
Twinkle Twinkle Little Rock Star - So. Central Rain (I'm Sorry) (User: melons)
Eggshell Boy - So Central Rain (Acoustic Version) (User: melons)
Christopher Ames Band - So. Central Rain (User: melons)
Salton Sea - So. Central Rain (User: melons)
Hem - South Central Rain (User: melons)
Sasha Zand - So. Central Rain (User: melons)
The Yellow Melodies - So. Central Rain (User: melons)
Grant-Lee Phillips - SO. CENTRAL RAIN (I'M SORRY) (User: melons)
Figub Brazlevič - Der Beste Marder Im Parkhaus (User: melons)
Souleance - La Californie (User: melons)
El Michels Affair - C.R.E.A.M. (User: melons)
digitalluc - Ghettos Worldwide (User: melons)
Darkhouse Family - The Offering (User: melons)
Young-Holt Unlimited - Young & Holtful (User: melons)
Smokedbeat - A King's Speech Part I (User: melons)
Nightmares on Wax - Mission Venice (User: melons)
Funky Notes - Some Love (User: melons)
Figub Brazlevič - Aw Yeah (User: melons)
Funky Notes - Never Knew (User: melons)
Damu The Fudgemunk - Tea Thyme (User: melons)
Siny - ORANGE (User: melons)
Limes - Debonair (User: melons)
Testiculo Y Uno - Temptation (User: melons)
Gyvus - Venice (User: melons)
Syrup - Lo(w) (User: melons)
Suff Daddy - Chicken Pox (User: melons)
Freddie Joachim - Shoulder Kiss (User: melons)
Syl Johnson - Soul Heaven (User: melons)
Blue In Green - Rainy Streets (User: melons)
Quetzal - Fig Pulp (User: melons)
Gasoline - Introduction of a jedi (User: melons)
tajima hal - Grape Choice (User: melons)
Betty Ford Boys - Shut up (User: melons)
Mark Farina - (Never Been To) California (User: melons)
Duñe - Polterguest (User: melons)
Tabal - Crystal Land (User: melons)
DJ Mitsu the Beats - A Little Piano (User: melons)
Koralle - Cobalto (User: melons)
Brock Berrigan - Crossing Paths (User: melons)
Anthony Drawn - Early Renaissance Pt. III (User: melons)
slowy - Showdown - Instrumental (User: melons)
Butcher Brown - #KingButch (User: melons)
Hulk Hodn - Ueberego (User: melons)
Wun Two - Again (User: melons)
Emapea - Reflection (User: melons)
Ganzo - Happy Feet (User: melons)
Freddie Joachim - Autumn Rain (User: melons)
The Deli - 5:32PM (User: melons)
Hodini - Outreux (User: melons)
Statik Sound System - Revolutionary Pilot - mixed (User: melons)
Caribou - The Spiritually Immature Mansion (User: melons)
Mommy - thinking of you (User: melons)
Blazo - Distant Graphite (User: melons)
FloFilz - Bad Self (User: melons)
FloFilz - Nomind (User: melons)
Amir Bresler - Please Do (User: melons)
twit one - Seemy (User: melons)
Eric Lau - Harps in Space (User: melons)
Bluewerks - Nella Laguna (User: melons)
Souleance - J'aime Marcher (User: melons)
Hashfinger - Calm Air (User: melons)
DJ Harrison - Carnaval ‘74 (User: melons)
Brenk Sinatra - Everyday Scenario (User: melons)
Glenn Astro - Malaysian Moped (User: melons)
Testiculo Y Uno - Sandig (User: melons)
Delayde - antony passage (User: melons)
Suff Daddy - Pattern Select (User: melons)
FloFilz - Mercerie (User: melons)
Saib - Sakura Trees (User: melons)
twit one - Roy Roy (User: melons)
Jazz Liberatorz - Capture Your Mind (User: melons)
Flughand - Feblu (User: melons)
Deep Tan - camelot (User: melons)
Kruder & Dorfmeister - Holmes (User: melons)
Eevee - viola (User: melons)
J Rocc - Stay Fresh (User: melons)
Jonathan Geer - Melted Cheese (User: melons)
Kirikou And The Cosby Kids - Hawaii (User: melons)
Bikini Beach - Melted Cheese (User: melons)
The Beatles - It's Only Love - Remastered 2009 (User: melons)
Cults - You Know What I Mean (User: melons)
R.E.M. - So. Central Rain (User: melons)
lzr - Happily Depressed (User: melons)
Japanese Television - Bee Cage (User: melons)
pregoblin - COMBUSTION (User: melons)
Rolling Blackouts Coastal Fever - Time In Common (User: melons)
Young Guv - Nervous Around U (User: melons)
KIM HON - Twti Ffrwti (User: melons)
The Wedding Present - Corduroy - Single Version (User: melons)
Poco - Rose Of Cimarron (User: melons)
City Boy - 5.7.0.5. (User: melons)
The Connells - '74-'75 (User: melons)
The Tom Robinson Band - 2-4-6-8 Motorway (User: melons)
Peter Frampton - Show Me The Way (User: melons)
David Seville - Witch Doctor (User: melons)
Dr. Hook & The Medicine Show - Sylvia's Mother (User: melons)
The Beatles - In My Life - Remastered 2009 (User: melons)
Eve Goodman - Dacw 'Nghariad (User: melons)
Ani Glass - Agnes (User: melons)
Serol Serol - Arwres (User: melons)
Raffdam - Llwybrau (User: melons)
Bronwen - Edrych rôl fy hun (User: melons)
She's Got Spies - Wedi Blino (User: melons)
Super Furry Animals - She's Got Spies (User: melons)
Y Bandana - Cân y Tân (User: melons)
Lisa Pedrick - Ti yw fy Seren (User: melons)
Ramsey Lewis - Sexy Sadie (User: melons)
Non Plus Temps - Continuous Hinge (User: melons)
Ramsey Lewis - Rocky Raccoon (User: melons)
Ramsey Lewis - Dear Prudence (User: melons)
Dragons of Zynth - War Lover (User: melons)
Special Interest - Disco III (User: melons)
Propaganda - Testament Six (User: melons)
KMFDM - Mini Mini Mini (User: melons)
Pretty Sick - Black Tar (User: melons)
The Green Pajamas - My Mad Kitty (User: melons)
Wobbly - Yo Yo Yo Yoyo Yo, Hey... (User: melons)
The Wibbley Brothers - More Haddock Oh More (User: melons)
Maximum Balloon - Tiger (User: melons)
Johnny Logan - Hold Me Now (User: melons)
Tim Perkis - Studio Basilisk No. 2 (User: melons)
The Knocks - Bedroom Eyes (feat. Studio Killers) (User: melons)
Tim Ayre - Mexican Holiday - Montmartre Remix (User: melons)
Jean-Luc Ponty - Overture (User: melons)
Radio Birdman - Murder City Nights (User: melons)
Raf Marchesini - Doo Uap - Radio Edit (User: melons)
Porij - Can't Stop (User: melons)
Poppy Ajudha - HOLIDAY FROM REALITY (User: melons)
Elder Island - Absolute (User: melons)
Gabin - Into My Soul (User: melons)
Bananarama - I Heard a Rumour (User: melons)
The Daughters of Eve - Hey Lover (User: melons)
Cola - Fulton Park (User: melons)
Venice Sunlight - A Festivus Miracle (User: melons)
Jawsh 685 - Savage Love (Laxed - Siren Beat) (User: melons)
Elemeno P - Fast Times in Tahoe (User: melons)
Goodnight Nurse - Milkshake (User: melons)
Ratcat - That Ain't Bad (User: melons)
Noiseworks - Take Me Back (User: melons)
Steriogram - Walkie Talkie Man (User: melons)
Kim Appleby - Don't Worry (User: melons)
Graey - Lights Out (User: melons)
Tokimeki Records - Turn It Into Love (User: melons)
Kllo - Still Here (User: melons)
Godford - Fear (User: melons)
HÆLOS - Perfectly Broken (User: melons)
James Alexander Bright - Wild Night (User: melons)
King Emerald - 20:30 Matlock (User: melons)
Big Wild - Who Do You Believe (User: melons)
Tyzo Bloom - TV (feat. Pom Pom Squad) (User: melons)
Alex Medina - Apnea Instructions 04 - Johannes Albert Remix - Radio Edit (User: melons)
the Valla - Shut My Mouth (User: melons)
Somebody's Child - We Could Start a War (Le Boom Remix) (User: melons)
Justin Faust - Jini (User: melons)
PirrA - Limousine Lies (User: melons)
Monks - 100 Percent (User: melons)
PVA - Talks (User: melons)
Kučka - Ascension (User: melons)
Roman Flügel - D.I.S.C.O. - Edit (User: melons)
Fatima Yamaha - Day We Met - Betonkust Remix (User: melons)
Keep Dancing Inc - Start Up Nation (User: melons)
Falle Nioke - Ayekouma (Carnival Mix) (User: melons)
Golden Vessel - getforward (User: melons)
Roosevelt - Lovers (User: melons)
Nabihah Iqbal - Is This Where It Ends (User: melons)
Cagedbaby - Attention - Moscoman Remix (User: melons)
Origami Human - I Still Love You (User: melons)
Ekkah - Wendy's Yard (User: melons)
Neil Frances - Mr Blue (User: melons)
Kudu Blue - Brother (User: melons)
De Lux - On and on (Till the End of Us) (User: melons)
This & That - 1000´s (User: melons)
Slum Sociable - Questions (User: melons)
Extra Credit - It's Over - Edit (User: melons)
MILK. - 2. (User: melons)
Hard Feelings - Sister Infinity - Edit (User: melons)
Dead Naked Hippies - Curiosity (Dawn) (User: melons)
Babylamb - Mister Magic (User: melons)
Elaine Mai - No Forever (User: melons)
Aonair - Think Twice (User: melons)
NZCA LINES - Pure Luxury (Django Django’s Boogie Beat Remix) (User: melons)
RJD2 - 1976 (User: melons)
MIYNT - A bite of papaya (User: melons)
Teenage Joans - Three Leaf Clover (User: melons)
The Chocolate Watch Band - Let's Talk About Girls (Re-Recorded) (User: melons)
Nikonn - Opal (User: melons)
Real Lies - Oh Me, Oh My (Nicotine Patch) (User: melons)
The Goon Sax - Make Time 4 Love (User: melons)
Romy - Lifetime - Planningtorock 'Let It Happen' Remix (User: melons)
Boys Noize - Ride Or Die (feat. Chilly Gonzales) (User: melons)
Luke Gomm - Red Flashing Lights (User: melons)
Drama - Dark Rain (User: melons)
Porter Robinson - Unfold (User: melons)
The Kount - The Way You Make Me Feel (User: melons)
Monks - Caramel (User: melons)
Ultraísta - Ordinary Boy - Floating Points Remix - Edit (User: melons)
Patawawa - So Late (Goldteeth Remix) (User: melons)
Fred again.. - Hannah (The Sun) (User: melons)
Everyone You Know - There for You (User: melons)
Elderbrook - Broken Mirror (User: melons)
Haich Ber Na - The Last Time I Saw You (User: melons)
Acen - Play 2092 - Part 1 (User: melons)
PnB Rock - Selfish (User: melons)
Ratcat - Holiday (User: melons)
Orlando Julius - Disco Hi - Life (User: melons)
Etoile de Dakar - Mane Khouma Khol Thi Yao (User: melons)
Antibalas - Dirty Money (User: melons)
Seun Kuti - African Soldier (User: melons)
Sahara All Stars Band Jos - Enjoy Yourself (User: melons)
Lord Kitchener - Birth Of Ghana (User: melons)
The Daktaris - Musicawi Silt (User: melons)
Marijata - We Live In Peace (User: melons)
Os Tubarões - Djonsinho Cabral (User: melons)
The Actions - Kokro-Ko (Hide and Seek) (User: melons)
The Movers - Soweto Disco (User: melons)
Bonga - Ku Tando (User: melons)
Super Mama Djombo - Dissan na m'bera (User: melons)
Abafana Bama Soul - Masisizwane (User: melons)
Roberto Musci - Claudia, Wilhelm R and me (User: melons)
Yahoos - Mabala (User: melons)
Dele Sosimi - E Go Betta (User: melons)
Kiki Gyan - Disco Dancer (User: melons)
Gyedu-Blay Ambolley and His Creations - Akoko Ba (User: melons)
The Mercury Dance Band - Kai Wawa (User: melons)
Balla et ses Balladins - Assa (User: melons)
T.P. Orchestre Poly-Rythmo - Ne Te Fache Pas (User: melons)
Alpha Blondy - Sweet Fanta Diallo (User: melons)
Fred Fisher - Asa-Sa (User: melons)
Hallelujah Chicken Run Band - Kare Nanhasi (User: melons)
Janka Nabay - stop jealous (User: melons)
Africa Express - City In Lights (User: melons)
Orlando Julius - Alo Mi Alo (Parts 1 & 2) (User: melons)
Gasper Lawal - Kita Kita (User: melons)
Pat Thomas - Gyae Su (User: melons)
Bibi Tanga & The Selenites - Be Africa (User: melons)
Tabu Ley Rochereau - Pitié (User: melons)
Quindon Tarver - Everybody's Free (To Wear Sunscreen) (User: melons)
Simply Red - Holding Back The Years (User: melons)
Seal - Crazy - 7" Mix (User: melons)
Ellie Goulding - Starry Eyed (User: melons)
Thompson Twins - Love On Your Side (User: melons)
The Human League - Human (Extended Version) (User: melons)
Steps - Better Best Forgotten (User: melons)
David Sneddon - Stop Living The Lie (User: melons)
Electric Light Orchestra - Don't Bring Me Down (User: melons)
Pianoforte Meditation - Sunday Sunset (User: melons)
S-와이 - 시작이란 끝 (User: melons)
François de Roubaix - Jeanne et Marceau - Bande originale du film "Dernier domicile connu" (User: melons)
Takatsugu Muramatsu - Mary’s Theme - (Piano Version) (User: melons)
Yorimichi Mifune - Commitment (User: melons)
Ludovic Bource - Around the Pool (Dolores Theme) (User: melons)
Pianoforte Meditation - Snowfall Symphony (User: melons)
Michela Sarcina - Fast Words (User: melons)
Hara Noda - The Beauty of Everyday Things (User: melons)
Masakatsu Takagi - Circulation (User: melons)
Bridget Hillson - Green Flag (User: melons)
Eric Demarsan - La Blessure - Bof Le Samouraï (User: melons)
Eric Demarsan - Quand les hommes ont rendez-vous - BOF "Le cercle rouge" (User: melons)
Saori Mouri - 風になる(Instrumental) (User: melons)
environments - The Psychologically Ultimate Seashore (16 rpm) (User: melons)
Joanne Robertson - peacecraft (User: melons)
Elysia Crampton - Grove (feat. Embaci) (User: melons)
