Andrew Jackman - Planes, Boats And Trains (User: melons)
Bow Wow Wow - Go Wild in the Country (User: melons)
NRBQ - Ridin' in My Car (User: melons)
dEUS - Opening Night (User: melons)
Joe Meek - I Hear a New World (User: melons)
Stevie Jackson - Richie Now (User: melons)
Sleater-Kinney - I Wanna Be Your Joey Ramone (User: melons)
Amy Winehouse - Love Is a Losing Game (User: melons)
The Ventures - Walk, Don't Run - Stereo (User: melons)
The Move - Beautiful Daughter (User: melons)
Metá Metá - Angouleme (User: melons)
Os Mutantes - Hey Boy (User: melons)
Alessi Brothers - Joanna (User: melons)
Karen Dalton - Little Bit of Rain (User: melons)
The Rising Storm - Bright Lit Blue Skies (User: melons)
The Waltones - downhill (User: melons)
Bee Gees - Massachusetts (User: melons)
Tchotchke - Ronnie (User: melons)
Elf Power - Step Through the Portal (User: melons)
Handle - Mhmm (User: melons)
Young Guv - Too Far Gone (User: melons)
Les 5-4-3-2-1 - パリ・クルーズ (User: melons)
The Only Ones - Baby's Got A Gun - 2008 re-mastered version (User: melons)
Sultans Of Ping F.C. - You Talk Too Much (User: melons)
Wet Leg - Wet Dream (User: melons)
Spiderbait - Calypso (User: melons)
Buzzcocks - Love You More - 2001 Remastered Version (User: melons)
never young beach - Amari Ikanai Kissatende (User: melons)
Those Fadin' Colours - Try Me On For Size (User: melons)
Eels - I Like Birds (User: melons)
Petula Clark - Je Roule (User: melons)
Yeah Yeah Yeahs - Date With the Night (User: melons)
Alain Goraguer - Générique (I) (User: melons)
Frog Eyes - I Was an Oligarch (User: melons)
Kate Pierson - Bottoms Up (User: melons)
Dummy - Daffodils (User: melons)
P.E. - Shimmy (User: melons)
Risto - Rakkauden Rock (User: melons)
Superdrag - Sucked Out (User: melons)
カヒミ・カリィ - Dis-Moi Quelque Chose Avant de Dormir (User: melons)
Donnie & Joe Emerson - Big Money (User: melons)
The Sandpipers - Back In The Street Again (User: melons)
Haich Ber Na - So Sick Of Me (User: melons)
The Phantom - Love Me (User: melons)
Bad Dream Fancy Dress - Curry Crazy (User: melons)
Pom Poko - Like A Lady (User: melons)
The Monochrome Set - Eine Symphonie Des Grauens (User: melons)
Aventuras De Kirlian - Casa del queso (User: melons)
Drowners - Long Hair (User: melons)
Alan Price - Simon Smith and the Amazing Dancing Bear (Bonus Track) (User: melons)
The Unicorns - I Was Born (A Unicorn) (User: melons)
a-ha - Maybe, Maybe (User: melons)
Beach House - Saltwater (User: melons)
Queens of the Stone Age - Everybody's Gonna Be Happy - Non-LP Version (User: melons)
Modest Mouse - Float On (User: melons)
The Chicks - Gaslighter (User: melons)
Jessy Lanza - Lick in Heaven (User: melons)
The Rapture - House Of Jealous Lovers (User: melons)
Weezer - Hash Pipe (User: melons)
Tony Tetuila - My Car (User: melons)
Queens of the Stone Age - The Lost Art of Keeping a Secret (User: melons)
Queens of the Stone Age - The Lost Art of Keeping a Secret (User: melons)
Seeed - Dancehall Caballeros (User: melons)
The Coral - Bill McCai (User: melons)
Fahmi Shahab - Kopi Dangdut (User: melons)
Pucho - Got Myself a Good Man (User: melons)
Pucho & His Latin Soul Brothers - Got Myself A Good Man (User: melons)
Furacão 2000 - Cerol Na Mão (User: melons)
Pucho - Got Myself a Good Man (User: melons)
lorenzo_bitw - Basta (User: melons)
Bebel Gilberto - Na Cara (User: melons)
Daft Punk - Da Funk (User: melons)
The Remix Cartell - Give It To Me ((Digital Funk Remix)) (User: melons)
Daft Punk - Da Funk (User: melons)
Sway - F Ur Ex (User: melons)
5ive Style - apple pie (User: melons)
Trick Daddy - Nann Nigga (User: melons)
Loretta Lynn - You're The Reason Our Kids Are Ugly (User: melons)
Master KG - Jerusalema (feat. Nomcebo Zikode) - Edit (User: melons)
Jasmine Sandlas - Panjeba (User: melons)
Poni Hoax - Tropical Suite: São Paulo (User: melons)
Linton Kwesi Johnson - Reality - Dub (User: melons)
Asha Bhosle - Ruperi Valut Madanchya Banaat (User: melons)
Elis Regina - Águas De Março (User: melons)
Graham Central Station - Happ-E-2-C-U-A-Ginn (User: melons)
La Prohibida - Flash (User: melons)
Fernanda Abreu - Raio X (Vinheta de Abertura) (User: melons)
Kolinda - Szerelem (L'amour) (User: melons)
Tim Blake - Crystal Presence (User: melons)
Rail Band - Silanidé (User: melons)
Hikaru Utada - Face My Fears (English Version) (User: melons)
M'Du - Bless Africa (User: melons)
Fanfare Ciocarlia - Moliendo Café (User: melons)
Mani Bella - Qui Cherche Trouve (User: melons)
Jürgen Paape - Ausklang (User: melons)
Carsten Jost - Make Pigs Pay (Remixed By Cross Fade Entertainment) (User: melons)
The Bug - Fall (User: melons)
Brymo - Market Square (User: melons)
Ice Prince - Kolo (feat. Oxlade) (User: melons)
La Chat - Slob on My Cat (User: melons)
Tear da Club Up Thugs - Slob On My Nob (feat. Project Pat) (User: melons)
Bill Evans - Days of Wine and Roses (User: melons)
R.E.M. - I Believe - 2011 Remaster (User: melons)
Friends Again - Honey at the Core (User: melons)
Mbilia Bel - Sentimental night (User: melons)
Kid Abelha - Pintura íntima - Compacto (User: melons)
Nick Lowe - So It Goes (User: melons)
Gloria Estefan - Coming Out of the Dark (User: melons)
Amon Düül II - Archangels Thunderbird (User: melons)
Tkay Maidza - Brontosaurus (feat. Bad Cop) (User: melons)
Beverley Knight - Made It Back (Good Times 7" Mix) (User: melons)
Beverley Knight Featuring Redman - Made It Back (Good Times 12" Mix) [feat. Redman] (User: melons)
PUFFY - 愛のしるし (User: melons)
LA Synthesis - Agraphobia - Original Remastered (User: melons)
T.S. Monk - Bon bon vie - Gimme the Good Life (User: melons)
The Records - Starry Eyes (User: melons)
Novas - The Crusher (User: melons)
The Ragga Twins - Spliffhead (User: melons)
Pam Tillis - Don't Tell Me What to Do (User: melons)
Ninjaman - Zig It Up - The Main Attraction Radio Cut (User: melons)
George Lamond - Bad of the Heart (User: melons)
The Bats - Law of Things (User: melons)
Hurşid Yenigün - Şeker Oğlan (User: melons)
Hot 8 Brass Band - Sexual Healing (User: melons)
Poppy - Metal (User: melons)
Carola - Hunajainen - A Taste Of Honey - 1965 versio (User: melons)
Meridian Brothers - ¿Dónde Estás María? (User: melons)
Dinosaur - Kiss Me Again - Mix Edit (User: melons)
Mother Sky - Myth of the West (User: melons)
Denise Lopez - Don't You Wanna Be Mine - Bimbo Jones Radio Edit (User: melons)
The Tinkles - Magic Lover (User: melons)
Merry Clayton - Gimme Shelter (User: melons)
Pet Shop Boys - I Wouldn't Normally Do This Kind of Thing - Beatmasters Mix; 2001 Remaster (User: melons)
John Grant - GMF (User: melons)
Aztec Camera - Somewhere In My Heart (User: melons)
Takako Minekawa - Fantastic Cat (User: melons)
Babe Ruth - The Mexican - 2007 Remaster (User: melons)
The Velvet Underground - Who Loves the Sun - 2015 Remaster (User: melons)
Erasure - Drama! - 2019 - Remaster (User: melons)
Nina Simone - Baltimore (User: melons)
Modest Mouse - Dramamine (User: melons)
Driven To Collision - Lizzie (User: melons)
Curve - Ten Little Girls (User: melons)
China Drum - Can't Stop These Things (User: melons)
Pat Kelly - A Whiter Shade Of Pale (User: melons)
Miriam Makeba - Pata Pata - Stereo Version (User: melons)
Johnnie Allan - Promised Land (User: melons)
Gold - Capitaine abandonné (User: melons)
Angel Witch - Angel Witch (User: melons)
Arthur Kay's Originals - Play My Record (User: melons)
Breakwater - Release the Beast (User: melons)
Cameo - Shake Your Pants (User: melons)
Change - The Glow of Love (User: melons)
Comsat Angels - Independence Day (User: melons)
Diamond Head - Am I Evil? (User: melons)
Eddie Rabbitt - Drivin' My Life Away - 2009 Remaster (User: melons)
Grauzone - Eisbär (User: melons)
Lakeside - Fantastic Voyage (User: melons)
Les Vampyrettes - Biomutanten (User: melons)
Lio - Amoureux Solitaires (User: melons)
Nazia Hassan - Aap Jaisa Koi - Qurbani / Soundtrack Version (User: melons)
Rheingold - Dreiklangsdimensionen - Single / Remastered 2005 (User: melons)
Hopeton Lewis - Express Yourself (User: melons)
Rita Lee - Lança Perfume (User: melons)
Sandii - Zoot Kook (User: melons)
Telex - Dear Prudence (User: melons)
The Dugites - In Your Car (User: melons)
The Units - High Pressure Days (User: melons)
Young Disciples - apparently nothin' - soul river (User: melons)
Céline Dion - It's All Coming Back to Me Now (User: melons)
Mariah Carey - Hero (Live) (User: melons)
Mariah Carey - Emotions (Live) (User: melons)
Def Leppard - When Love & Hate Collide (User: melons)
Def Leppard - When Love & Hate Collide (User: melons)
Sixpence None the Richer - Kiss Me (There She Goes Version) (User: melons)
Chris Isaak - Wicked Game (User: melons)
The Valentines - Wicked Game (User: melons)
Chaka Demus & Pliers - She Don't Let Nobody (User: melons)
Bobby Ellis - Mr. Ellis Burn Out (User: melons)
Kate Pierson - Bottoms Up (User: melons)
Tina Arena - Sorrento Moon (User: melons)
Nass El Ghiwane - Hammouda (User: melons)
The Uniques - Crimson And Clover (User: melons)
Kate Pierson - Let’s Spend Half a Day (User: melons)
Lloyd Price - Lawdy Miss Clawdy (User: melons)
Jo Marches - You'll Be Mine (User: melons)
Creative Source - Keep On Movin' (User: melons)
The B-52's - Love Shack (Single Version) (User: melons)
Urge Overkill - Girl, You'll Be a Woman Soon (User: melons)
Louis Armstrong - We Have all The Time in the World (User: melons)
Nalin & Kane - Beachball (User: melons)
The Brand New Heavies - Dream On Dreamer (User: melons)
Bad Boys Inc - More To This World (User: melons)
Sandie Shaw - Hand In Glove (User: melons)
The March Violets - Walk Into the Sun - Extended (User: melons)
Nick Cave & the Bad Seeds - In the Ghetto - 2009 Remastered Version (User: melons)
The Smiths - What Difference Does It Make? - 2011 Remaster (User: melons)
Joe Bataan - Gypsy Woman (User: melons)
New Order - Confusion - UK 7" Promo Edit; 2015 Remaster (User: melons)
Juju - Freedom Fighter (User: melons)
Malkit Singh - Baah Fadke (User: melons)
wildes - Woman in Love (User: melons)
Croatian Amor - Olimpia (User: melons)
ESG - Dance To The Beat Of Moody (User: melons)
Rachel's - The Sirens (User: melons)
A Tribe Called Quest - Solid Wall of Sound (User: melons)
R.E.M. - Carnival of Sorts (Box Cars) (User: melons)
Erasure - Drama! - 2019 - Remaster (User: melons)
Erasure - Drama! - 2019 - Remaster (User: melons)
Cocteau Twins - Pink Orange Red (User: melons)
Double Trouble - Street Tuff (User: melons)
Yazoo - Nobody's Diary - 2008 Remaster (User: melons)
The Damned - Thanks for the Night (User: melons)
Jake Xerxes Fussell - Have You Ever Seen Peaches Growing on a Sweet Potato Vine? (User: melons)
Yasmin Williams - Juvenescence (User: melons)
Ryley Walker - The Roundabout (User: melons)
NewDad - I Don't Recognise You (User: melons)
Dehd - Lucky (User: melons)
Anaïs Mitchell - Bright Star (User: melons)
Hurray For The Riff Raff - RHODODENDRON (User: melons)
Cassandra Jenkins - Hard Drive (User: melons)
Alabaster Deplume - Visit Croatia (User: melons)
Kevin Morby - Harlem River (User: melons)
Ahmed Fakroun - Nisyan (User: melons)
Nilüfer Yanya - Keep On Calling (User: melons)
Priya Ragu - Good Love 2.0 (User: melons)
Grove - Skin2Skin (User: melons)
I. Jordan - And Groove (User: melons)
Richard Lamb - Passion Programme (User: melons)
Emma-Jean Thackray - Movementt (User: melons)
Durand Jones & The Indications - Witchoo (User: melons)
Steam Down - Free My Skin (User: melons)
Porridge Radio - Give/Take (User: melons)
TV Priest - Press Gang (User: melons)
Wu-Lu - Times (User: melons)
TV Priest - Press Gang (User: melons)
The Lounge Society - BURN THE HEATHER (User: melons)
Scalping - Monolithium (User: melons)
The Lounge Society - BURN THE HEATHER (User: melons)
Moor Mother - Temporal Control of Light Echoes (User: melons)
black midi - John L (User: melons)
KEG - NPC (User: melons)
Modern Woman - Ford (User: melons)
Sudan Archives - Come Meh Way (User: melons)
Les Filles De Illighadad - Imigradan (User: melons)
Sudan Archives - Come Meh Way (User: melons)
Tinariwen - Cler Achel (User: melons)
Soccer Mommy - circle the drain (User: melons)
Perfume Genius - Slip Away (User: melons)
The Weather Station - Tried To Tell You (User: melons)
Lucy Dacus - Hot & Heavy (User: melons)
The Magnetic Fields - Strange Powers (User: melons)
Yard Act - The Overload (User: melons)
Pixies - Monkey Gone to Heaven (User: melons)
wildes - Woman in Love (User: melons)
Pixies - Monkey Gone to Heaven (User: melons)
Khruangbin - Pelota (User: melons)
Khruangbin - Pelota (User: melons)
Aldous Harding - The Barrel (User: melons)
Sylvan Esso - What If (User: melons)
Sylvan Esso - Alarm (User: melons)
Sylvan Esso - Sunburn (User: melons)
Sylvan Esso - Cloud Walker (User: melons)
Sylvan Esso - Cloud Walker (User: melons)
Sylvan Esso - Your Reality (User: melons)
Soccer Mommy - Feel It All the Time (User: melons)
Sylvan Esso - Didn’t Care (User: melons)
Sylvan Esso - How Did You Know (User: melons)
Sylvan Esso - Echo Party (User: melons)
Sylvan Esso - Look At Me (User: melons)
Sylvan Esso - Moving (User: melons)
East Village - Shipwrecked (User: melons)
The Boo Radleys - Towards The Light (User: melons)
Scorpio Rising - Peace Frog (User: melons)
Stan - My Delight (7" edit) (User: melons)
Bleach - Bethesda (User: melons)
Moose - Slip And Slide (User: melons)
Fuel - Honey Comes Softly (User: melons)
Mexico 70 - Wonderful Lie (User: melons)
Headtime - Have You Heard (User: melons)
Horse Latitudes - Northern Country Lie (User: melons)
Spitfire - Sunflow (User: melons)
Drop - Drone 1 (User: melons)
Sweet Jesus - Honey Loving Honey (User: melons)
R.E.M. - Bang And Blame - Remastered (User: melons)
Bang Bang Machine - Flower Horse (User: melons)
Levitation - Nadine (User: melons)
Smashing Orange - Only Complete in You (User: melons)
Medalark Eleven - Snake (User: melons)
Def Leppard - Fire It Up (User: melons)
The Cure - The Walk (User: melons)
Horst Jankowski - A Walk In The Black Forest (User: melons)
Essential Christmas - Walking in the Air (Duet) (User: melons)
9 Diuz - Eminem ft Clean Bandit Rather Be Without Me Full Version (User: melons)
Kirsty MacColl - There's A Guy Works Down The Chip Shop Swears He's Elvis (User: melons)
George Michael - John And Elvis Are Dead (Remastered 2006) (User: melons)
Dire Straits - Calling Elvis (User: melons)
Heather Small - Excited (User: melons)
Nebula II - Flatliners (Original Mix) (User: melons)
Origin Unknown - Valley of the Shadows (User: melons)
Bizarre Inc. - Playing With Knives [Quadrant Mix} (User: melons)
The Boo Radleys - The Finest Kiss (User: melons)
Glen Campbell - Guess I'm Dumb - Remastered 2003 (User: melons)
The Winstons - Amen Brother (User: melons)
Flash and the Pan - Down Among the Dead Men (User: melons)
Sonic Youth - Into The Groovey (User: melons)
Adrian Crowley - Walk On Part (User: melons)
U.S.U.R.A. - Open Your Mind (User: melons)
Log Dog DJ - 18000 (User: melons)
Compay Quinto - El Diablo (User: melons)
Alexey Kaleynikov - The Music Box (User: melons)
Bettie Jackhammer - Funny (User: melons)
Mickey Rooney - Life's A Happy Song (User: melons)
David Charles Hewitt - The Last Exorcism (User: melons)
Carles Piles - Tchaikovsky – Dance of the Sugar Plum Fairy (User: melons)
Praestone - Klink (User: melons)
Monét X Change - There for You (User: melons)
Alicia Lindberg - För liten för att vara stor (User: melons)
Masakatsu Takagi - Circulation (User: melons)
Evan Ziporyn - ShadowBang: Head 1 (User: melons)
Blank & Jones - The Lovers (User: melons)
Boychik - Bombed Out Building (User: melons)
Scarlett Randle - HER - BOBBIE Remix (User: melons)
Matt Sassari - Give It to Me - Full Vocal Mix (User: melons)
Josh Winiberg - The Dancer (User: melons)
Sam Gendel - YOU'LL NEVER GET TO HEAVEN (User: melons)
Bing & Ruth - Blood Harmony (User: melons)
Retrospecter - Satisfracture (User: melons)
Kawai Sprite - Ugh (User: melons)
Tobe Nwigwe - ROUND HERE (PART ONE) (User: melons)
Doechii - Bitch I'm Nice (User: melons)
Charles Roland Berry - Galliard No. 42, "Non Dite Mai" (User: melons)
Zen Nadir - Asian Spa Music Meditation (User: melons)
Oasis de Luxe - Relaxation (User: melons)
Buddha Tribe - My Idea of Zen (Soothing Reiki Healing Music) (User: melons)
Deep Sleep Music Delta Binaural 432 Hz - Sleeping at Last (User: melons)
Asian Meditation Music Collective - Meditation Space (User: melons)
Buddha Virtue - Buddhist Music from the Tibetan Temple of Sera (User: melons)
Dzen Guru - Looking for Zen (Zen Meditation Music) (User: melons)
Liquid Spirit Out - Mind Relaxation Music (User: melons)
Amelia System - Sleep Cycles (User: melons)
Alma' - Relax & Relax (User: melons)
Relaxation Meditation Yoga Music Masters - Instrumental Meditation Music Relax (User: melons)
Child Synesthesia - A Song to Remember (User: melons)
Alette Ocean - Ocean Sounds Collection (User: melons)
piano 01 - Piano Notes (User: melons)
Lucid Dreaming World - Pan Flute Music for Lucid Dreaming (User: melons)
Anna Einaudi - My Memory (Piano Music) (User: melons)
Relaxing Sounds of Nature White Noise Waheguru - Under the Surface (Water Sounds) (User: melons)
John Spa Williams - Your Own World (Ambient Sounds) (User: melons)
Mediterranea - Relaxing Meditation Music for Zen (User: melons)
Celtic Dreams - Celtic Land (User: melons)
Some Music to Sleep - Hypnosis (User: melons)
Buddha Zen Spa - Celebrate Peace - Peaceful Music (User: melons)
Shakuhachi Sakano - Mandala - Calming Music (User: melons)
Relaxation Guru - The Secret of Healing (User: melons)
Equilibre Study Mind - Liquid Meditation (User: melons)
Zen - Meditations (User: melons)
The Relaxation Masters - Meditation Lullaby for Mindfulness and Inner Peace (User: melons)
Yoga Music Guru - Sleeping Meditation (User: melons)
Namasté Waheguru - Atmospheres - Deep Relaxation Background Music (User: melons)
Shamanism Healing Music Academy - Meditation and Yoga (User: melons)
Briane No - Meditation Music (User: melons)
Liquid Relaxation - Body Mind Connection (User: melons)
Liquid Relaxation - Body Mind Connection (User: melons)
Shakti Deva Kaur - Collection of Moments (User: melons)
Shakti Deva Kaur - Collection of Moments (User: melons)
Natural Sounds of Nature Star - Servant of Peace (User: melons)
Oasis de Yoga - Himalaya - Asian Zen (User: melons)
Natural Sounds of Nature Star - Servant of Peace (User: melons)
Madame Tuina Zen - Contemplation (User: melons)
Swami Drishti Tratakauram - Gift of Love - Deep Meditation Song (User: melons)
The spirit of yoga - Chakra Balancing (User: melons)
Ayurveda - Deep Zen - Stay in the Present Moment (User: melons)
Shanti - Zen Buddhist Meditation (User: melons)
Serenity Spa Music Relaxation - Mystic Mountain (User: melons)
Ahanu Om Chant - Asian Shakuhachi Flute (User: melons)
Janelle Hogan - Yoga Grooves - Vinyasa (User: melons)
Yoga Waheguru - Like in a Dream - Hypnonsis (User: melons)
Asian Zen Spa Music Meditation - Tibet under the Rain - Nirvana (User: melons)
Chakra Meditation Specialists - Zen Garden Music (User: melons)
Oasis de Détente et Relaxation - Oriental Flute Music for Meditation (User: melons)
Meditation Relax Club - Breath of the Heart (User: melons)
Jane Winther - Healing Bowls and Voices II (User: melons)
Dean Lewis - Waves (User: melons)
Lany - Walk Away (User: melons)
Calum Scott - Dancing on My Own (User: melons)
Hailee Steinfeld - Flashlight (Sweet Life Mix) - From "Pitch Perfect 2" Soundtrack (User: melons)
The Cab - Numbers (User: melons)
Nicole Millar - Wait (User: melons)
Vera Blue - Settle (User: melons)
Whitley - More Than Life (User: melons)
Alessia Cara - Stars (User: melons)
James TW - When You Love Someone (User: melons)
Skylar Grey - Coming Home - Part II (User: melons)
Mindfulness Meditation Music Spa Maestro - Meditation Music (User: melons)
Ancient Asian Oasis - Japanese Zen (User: melons)
Tao Lounge - Inner Island (User: melons)
Kenio Fuke - Akatsuki (User: melons)
Japanese Sweet Dreams Zone - Ancient Japanese Wisdom (User: melons)
Matsu Take Ensemble - Esashi Oiwake (User: melons)
Earth Essence - Fountain of Youth (User: melons)
Matsu Take Ensemble - Esashi Oiwake (User: melons)
Paco - Zen (User: melons)
AG Sintonia Project - H2O Water (User: melons)
Shuta Yasukochi - Wishful Thinking (User: melons)
FloatSpace - Plum Blossom - Spa (User: melons)
Japanese Zen Shakuhachi - Find Your Balance (User: melons)
Satomi Saeki - Saika “Accented Flower” (User: melons)
Satomi Saeki And Alcvin Takegawa Ramos - Fuyu Momiji (User: melons)
Dreamy Music - 時を眺める (User: melons)
kita kouhei - Water Door (Dawn) (User: melons)
Dreamy Music - 時を眺める (User: melons)
Ancient Asian Oasis - Japanese Bonsai Tree (User: melons)
Asian Traditional Music - Relaxing Koto Music (User: melons)
The Calm Within - open fields (User: melons)
Kitaro - Wood Fairy (User: melons)
Riley Lee - Adrift on the Sea of Tranquility (User: melons)
Riley Lee - Adrift on the Sea of Tranquility (User: melons)
Chris Other - Tree Blossoms (User: melons)
Chris Other - Tree Blossoms (User: melons)
Leo - Ryu (User: melons)
Gavinco - Forgive the Moth (User: melons)
Masayoshi Fujita - Led by a Blue Bird Into the Mountain (User: melons)
Japanese Meditation Music - Magnificent Zen Meditation (User: melons)
Slow World - Let The Wind Take You Higher (User: melons)
Slow World - Let The Wind Take You Higher (User: melons)
Helios Relaxing Space - The Garden (User: melons)
Jiang Xiao-Qing - Leaves of Autumn (User: melons)
Niwashi 庭作 - Egyoku (User: melons)
Pol To Sol - The Break of Dawn (User: melons)
Outside The Sky - Ancient Garden (174 Hz Meditation) (User: melons)
The High Llamas - Checking In, Checking Out (User: melons)
S.Q.I.D. - Heart of the Forest - Remastered Edition (User: melons)
Eliott Tordo Erhu - Lovers (Flower Garden) - House of Flying Daggers (User: melons)
Jean-Marc Staehle - Zen Garden (User: melons)
Feras Charestan - Tasamuh (User: melons)
Steps - Hard 2 Forget (7th Heaven Radio Edit) (User: melons)
Thomas Dolby - She Blinded Me With Science (User: melons)
ABBA - I Have a Dream (User: melons)
Lionel Richie - Truly (User: melons)
The Supremes - Come See About Me (User: melons)
The Four Tops - Reach Out, I'll Be There (User: melons)
The Elgins - Heaven Must Have Sent You (User: melons)
Roots Manuva - Witness (1 Hope) (User: melons)
Roots Manuva - Movements (User: melons)
Funki Porcini - Purrfect (User: melons)
The Herbaliser - The Sensual Woman (User: melons)
Deadcuts - Single (User: melons)
B.T. Express - Express (User: melons)
Hoagy Carmichael - Stardust (User: melons)
Lead Belly - rock Island Line (User: melons)
Dooley Wilson - As Time Goes By (User: melons)
Benny Goodman - Why Don't You Do Right (feat. Peggy Lee) (User: melons)
Voodoo Queens - Supermodel Superficial (User: melons)
Mambo Taxi - Mr. Spaceman (User: melons)
Juno - Soul Thunder (User: melons)
Key Tronics Ensemble - Calypso Of House (User: melons)
Act - Snobbery & Decay - Remastered 2004 (User: melons)
The Valentine Brothers - Money's Too Tight to Mention - Original Mix (User: melons)
Nicki French - Is There Anybody Out There? - Mike Stock & Matt Aitken Radio Edit (User: melons)
R. Dean Taylor - Gotta See Jane - Single Version / Mono (User: melons)
Salad - On A Leash (User: melons)
Starpoint - Object Of My Desire (User: melons)
The Beatmasters - Boulevard Of Broken Dreams - 12" version (User: melons)
Danny Tenaglia - Look ahead (User: melons)
Life - The Drug (User: melons)
Yeah Yeah Yeahs - Burning (User: melons)
David Peaston - Two Wrongs (Don't Make It Right) (User: melons)
Bivouac - Thinking (User: melons)
Taylor Dayne - Don't Rush Me (User: melons)
Tin Machine - Prisoner Of Love - Edit (User: melons)
Taylor Dayne - Don't Rush Me (User: melons)
Stephen Duffy - Unkiss That Kiss (User: melons)
Chris Norman - Stumblin' In - 2017 Remaster (User: melons)
The Beaches - Let's Go (User: melons)
Destroy Boys - I Threw Glass At My Friend's Eyes And Now I'm On Probation (User: melons)
The Regrettes - Monday (User: melons)
The Loud Family - Sword Swallower (User: melons)
R.E.M. - Maps and Legends (User: melons)
Clint Mansell - Can't Get There from Here (User: melons)
Robinson - Ayo Girl (Fayahh Beat) [feat. Rema] (User: melons)
Add N To (X) - Gentle Germans (User: melons)
Omar Dafencii - كنق الحلبة (User: melons)
Summer Camp - House Party (User: melons)
Pixies - Hang Wire (User: melons)
Pixies - Mr. Grieves (User: melons)
Pixies - I Bleed (User: melons)
Pixies - Brick Is Red (User: melons)
Pixies - Manta Ray (User: melons)
Pixies - Rock Music (User: melons)
Pixies - In the Arms of Mrs. Mark of Cain (User: melons)
Pixies - U-Mass (User: melons)
Pixies - Cactus (User: melons)
Pixies - Letter to Memphis (User: melons)
Pixies - The Holiday Song (User: melons)
Pixies - Velvety Instrumental Version (User: melons)
Pixies - Blue Eyed Hexe (User: melons)
Pixies - Los Surfers Muertos (User: melons)
Pixies - Levitate Me (User: melons)
Pixies - Is She Weird (User: melons)
Pixies - Greens and Blues (User: melons)
Pixies - Havalina (User: melons)
Pixies - Distance Equals Rate Times Time (User: melons)
Pixies - Motorway to Roswell (User: melons)
Pixies - Bailey's Walk (User: melons)
Pixies - Something Against You (User: melons)
Pixies - Silver Bullet (User: melons)
Pixies - Into the White (User: melons)
Pixies - Gigantic (User: melons)
Lamont Dozier - Fish Ain't Bitin' (User: melons)
Pixies - "You Fuckin' Die...!" (User: melons)
Pixies - The Thing (User: melons)
The Motors - Forget About You (User: melons)
Pixies - This Is My Fate (User: melons)
Pixies - Oh My Golly! (User: melons)
Pixies - Ana (User: melons)
Pixies - I've Been Tired (User: melons)
Pixies - Wave of Mutilation (UK Surf) (User: melons)
Pixies - I'm Amazed (User: melons)
Pixies - Death Horizon (User: melons)
Pixies - Catfish Kate (User: melons)
Pixies - Santo (User: melons)
Pixies - Velouria (User: melons)
Pixies - All Over the World (User: melons)
Pixies - What Goes Boom (User: melons)
Pixies - Lovely Day (User: melons)
Pixies - The Sad Punk (User: melons)
Pixies - Palace of the Brine (User: melons)
Pixies - St. Nazaire (User: melons)
Pixies - Bone Machine (User: melons)
Pixies - Planet of Sound (User: melons)
Pixies - Blown Away (User: melons)
Pixies - Dead (User: melons)
Pixies - Letter to Memphis [Instrumental] (User: melons)
Pixies - Winterlong (Neil Young cover) (User: melons)
Pixies - Graveyard Hill (User: melons)
Pixies - Allison (User: melons)
The Motors - Airport (User: melons)
The Foundations - Build Me Up Buttercup - Mono (User: melons)
James Brown & The Famous Flames - Night Train - Live At The Apollo Theater/1962 (User: melons)
Irma Thomas - Time Is On My Side (User: melons)
Charles Mingus - Track A- Solo Dancer (User: melons)
Alan Price - Simon Smith and the Amazing Dancing Bear (Bonus Track) (User: melons)
of Montreal - Gronlandic Edit (User: melons)
Jake Thackray - Bantam Cock (User: melons)
Jake Thackray - The Castleford Ladies Magic Circle (User: melons)
3T - Anything (User: melons)
Amanda Waring - The Earth and Other Minor Things (User: melons)
Noodweer - In De Disco - 12" Mix (User: melons)
Gwenno - Hunros (User: melons)
Róisín Murphy - Ruby Blue (User: melons)
Gwenno - Men an Toll (User: melons)
Dionne Warwick - Walk On By (User: melons)
Alison Moyet - Invisible (Album Version) (User: melons)
Paul Hardcastle - Don't Waste My Time (New Extended Version) (User: melons)
Neil Sedaka - Oh! Carol (Original Recordings of the Vinyl Era) (User: melons)
Carole Bayer Sager - You're Moving Out Today (User: melons)
Del Amitri - Always The Last To Know (User: melons)
Robert Palmer - Looking For Clues (User: melons)
Shakatak - Night Birds (User: melons)
Pet Shop Boys - West End Girls (User: melons)
P!nk - Irrelevant (User: melons)
Bradford Cox - Pastel Ruins (User: melons)
The Flamingos - Ko Ko Ko (User: melons)
Tommy Roe - Sheila (User: melons)
The Triffids - Raining Pleasure - Taken From 'Raining Pleasure' Mini-Album (User: melons)
Cate Le Bon - Wonderful (User: melons)
Harry Nilsson - Jump into the Fire (User: melons)
DJ Bravo - Champion (Chennai Super Cubs) (User: melons)
Howard Jones - Like to Get to Know You Well (User: melons)
Time Bandits - I'm Specialized In You (User: melons)
Le Le - Neen (User: melons)
Fresku - Laatste Van Mijn Soort (User: melons)
Pixies - Vamos (another version) (User: melons)
Pixies - Motorway to Roswell (User: melons)
Pixies - Hang Wire (User: melons)
Pixies - Death Horizon (User: melons)
Pixies - Stormy Weather (User: melons)
Pixies - Debaser (User: melons)
Pixies - River Euphrates (User: melons)
Pixies - Space (I Believe In) (User: melons)
Pixies - Snakes (User: melons)
Pixies - I've Been Waiting for You (User: melons)
Pixies - Bagboy (User: melons)
Pixies - I Bleed (User: melons)
Pixies - Dancing the Manta Ray (User: melons)
Pixies - I've Been Tired (User: melons)
Pixies - The Sad Punk (User: melons)
Pixies - Silver Snail (User: melons)
Pixies - Lovely Day (User: melons)
Pixies - Where Is My Mind? (User: melons)
Pixies - Manta Ray (User: melons)
Pixies - Tame (User: melons)
Pixies - Daniel Boone (User: melons)
Pixies - Ed Is Dead (User: melons)
Pixies - Winterlong (Neil Young cover) (User: melons)
Pixies - Wave of Mutilation (UK Surf) (User: melons)
Pixies - La La Love You (User: melons)
Pixies - Nimrod's Son (User: melons)
Pixies - There Goes My Gun (User: melons)
Pixies - Planet of Sound (User: melons)
Pixies - Down to the Well (User: melons)
Pixies - Greens and Blues (User: melons)
Pixies - Jaime Bravo (User: melons)
Pixies - Build High (User: melons)
Pixies - Magdalena 318 (User: melons)
Pixies - Monkey Gone to Heaven (User: melons)
Pixies - I'm Amazed (User: melons)
Pixies - Cecilia Ann (User: melons)
Pixies - Levitate Me (User: melons)
Pixies - Weird at My School (User: melons)
Pixies - Long Rider (User: melons)
Pixies - Trompe le Monde (User: melons)
Pixies - Mr. Grieves (User: melons)
Pixies - Theme From Narc (User: melons)
Pixies - Bailey's Walk (User: melons)
Pixies - Los Surfers Muertos (User: melons)
Pixies - Evil Hearted You (User: melons)
Pixies - Here Comes Your Man (User: melons)
Pixies - Something Against You (User: melons)
Pixies - Graveyard Hill (User: melons)
Pixies - Santo (User: melons)
Pixies - Dig for Fire (User: melons)
Pixies - Broken Face (User: melons)
Pixies - Brick Is Red (User: melons)
Pixies - Letter to Memphis [Instrumental] (User: melons)
Pixies - Crackity Jones (User: melons)
Pixies - Make Believe (User: melons)
Pixies - Tony's Theme (User: melons)
Pixies - Is She Weird (User: melons)
Pixies - All Over the World (User: melons)
Pixies - Dead (User: melons)
Pixies - Gigantic (User: melons)
Pixies - "You Fuckin' Die...!" (User: melons)
Pixies - This Is My Fate (User: melons)
Pixies - Break My Body (User: melons)
Pixies - Hey (User: melons)
Pixies - Allison (User: melons)
The Paris Sisters - I Love How You Love Me - Re-Recorded In Stereo (User: melons)
David Bowie - Friday on My Mind - 2015 Remaster (User: melons)
David Bowie - It Ain't Easy - 2012 Remaster (User: melons)
David Bowie - Changes - 2015 Remaster (User: melons)
David Bowie - Rock 'n' Roll Suicide - 2012 Remaster (User: melons)
David Bowie - An Occasional Dream - 2019 Mix (User: melons)
David Bowie - Friday on My Mind - 2015 Remaster (User: melons)
David Bowie - Be My Wife - 2017 Remaster (User: melons)
David Bowie - Cactus (User: melons)
David Bowie - African Night Flight - 2017 Remaster (User: melons)
David Bowie - Cactus (User: melons)
David Bowie - Kooks - 2015 Remaster (User: melons)
David Bowie - Queen of All the Tarts (Overture) (User: melons)
David Bowie - Sorrow - 2015 Remaster (User: melons)
David Bowie - Hang on To Yourself - Live (User: melons)
David Bowie - Get Real (User: melons)
David Bowie - Be My Wife - Live; 2017 Remaster (User: melons)
David Bowie - A Small Plot Of Land - Basquiat OST version (User: melons)
David Bowie - Star - 2012 Remaster (User: melons)
David Bowie - I Wish You Would - 2015 Remaster (User: melons)
David Bowie - Speed of Life - 2017 Remaster (User: melons)
David Bowie - John, I'm Only Dancing - Original Single Version, 2012 Remaster (User: melons)
David Bowie - Hang on To Yourself - Live (User: melons)
David Bowie - Can't Help Thinking About Me (User: melons)
David Bowie - I Dig Everything (User: melons)
David Bowie - Rebel Rebel - Live; 2005 Mix; 2016 Remaster (User: melons)
David Bowie - Speed of Life - Live; 2017 Remaster (User: melons)
Jay Ferguson - Aftershocks (User: melons)
The McCoys - Hang On Sloopy (User: melons)
Momma - Speeding 72 (User: melons)
Patsy Gallant - From New York to L.A. (User: melons)
David Bowie - Always Crashing in the Same Car - 2017 Remaster (User: melons)
Roxy Music - In Every Dream Home a Heartache (User: melons)
Sade - Why Can't We Live Together (User: melons)
Pages - If I Saw You Again (User: melons)
Tom Demac - White Flowers - Edit (User: melons)
Pet Shop Boys - Left to My Own Devices - 2018 Remaster (User: melons)
David Bowie - Rubber Band (User: melons)
David Bowie - Nothing to Be Desired (User: melons)
David Bowie - I Can't Explain - 2015 Remaster (User: melons)
David Bowie - Uncle Arthur (User: melons)
David Bowie - Come and Buy My Toys (User: melons)
David Bowie - Chant of the Ever Circling Skeletal Family - 2016 Remaster (User: melons)
David Bowie - Segue - Algeria Touchshriek (User: melons)
David Bowie - Breaking Glass - 2017 Remaster (User: melons)
David Bowie - Maid of Bond Street (User: melons)
David Bowie - Segue - Baby Grace (A Horrid Cassette) (User: melons)
David Bowie - Leon Take Us Outside (User: melons)
David Bowie - Segue - Nathan Adler - Version #1 (User: melons)
David Bowie - Future Legend - 2016 Remaster (User: melons)
Silver Convention - Get Up and Boogie (That's Right) - Radio Mix (User: melons)
David Bowie - Kooks - 2015 Remaster (User: melons)
David Bowie - A New Career in a New Town - 1999 Remaster (User: melons)
David Bowie - Black Country Rock - 2015 Remaster (User: melons)
Sergei Prokofiev - Peter And The Wolf, Op. 67: The Story Begins (User: melons)
Wigwam - Nuclear Nightclub (User: melons)
Scott Walker - 30 Century Man (User: melons)
David Bowie - Soul Love - 2012 Remaster (User: melons)
David Bowie - Sorrow - 2015 Remaster (User: melons)
David Bowie - Modern Love - 2018 Remaster (User: melons)
Nina Simone - Black Is the Color of My True Love's Hair (User: melons)
The Kinks - Sunny Afternoon - Mono Mix (User: melons)
Roberto Conrado - Omnifarius (User: melons)
Sandro Brugnolini - Megattera (User: melons)
Alessandro Alessandroni - Work Cycle (User: melons)
Alessandro Alessandroni - Manufacture (User: melons)
Alessandro Alessandroni - Construction (User: melons)
Alessandro Alessandroni - Fermentation (User: melons)
Alessandro Alessandroni - Colour Industry (User: melons)
Alessandro Alessandroni - Electronic Assembly-Line (User: melons)
Alessandro Alessandroni - Fusion (User: melons)
Alessandro Alessandroni - Steam Engine (User: melons)
Alessandro Alessandroni - Deformation (User: melons)
Alessandro Alessandroni - Production Line (User: melons)
Alessandro Alessandroni - Transfer (User: melons)
Alessandro Alessandroni - Communication (User: melons)
Real Lies - Thameslink Tryst (User: melons)
Tom Demac - White Flowers - Edit (User: melons)
Alessandro Alessandroni - Fields of Flowers (User: melons)
Alessandro Alessandroni - Microbiology (User: melons)
Alessandro Alessandroni - Boiling Matter (User: melons)
Orbital - Where Is It Going? (feat. Stephen Hawking) (User: melons)
Giuseppe Ielasi - 7 (User: melons)
R.E.M. - Drive (User: melons)
Giuliano Sorgini - Elettrospeed (User: melons)
Piero Montanari - Save Up (User: melons)
Alessandro Alessandroni - Fields of Flowers (User: melons)
Mura Masa - bbycakes (with Lil Uzi Vert, PinkPantheress & Shygirl) (User: melons)
Marlon Williams - River Rival (User: melons)
International Music System - The B. Generation - 120 BPM (User: melons)
Healing Force Project - Constellation Interlude pt1 (User: melons)
Augusto Mancinelli - Improvvisazioni Per Chitarra, Basso E Percussioni 13 (User: melons)
Arrington De Dionyso Quartet - Untitled No. 2 (User: melons)
Silvia Kastel - Air Glow (User: melons)
I Marc 4 - Dirottamento (User: melons)
Piero Milesi - Modi 2 (extract) (User: melons)
Andy Warhol Banana Technicolor - We Aren't Devo Revo (Bonus Track Originally Published On a 45 rpm Enclosed to Number 0 of the Magazine 115/220 Onda 400 June ‘80) (User: melons)
Giovanni Venosta - Rosa y Clavel Avec la Mandoline (User: melons)
Fhedolts - Monster in the Disco (Bonus Track Originally Published On a 45 rpm Enclosed to Number 0 of the Magazine 115/220 Onda 400 June ‘80) (User: melons)
N.E.E.M. - Nel Bosco c'è un Funghetto/Ho perduto il mio Galletto/Invernizzi Invernizzina (User: melons)
Honey Cone - Want Ads (User: melons)
Antonio Infantino e i Tarantolati di Tricarico - Colpo di sole (User: melons)
Roberto Mazza - mahoraga (User: melons)
L.A.S.'S. Crime - Statuary E-Motion (User: melons)
Bz Bz Ueu - Tempo Sinistro (User: melons)
Maria Teresa Luciani - The Port (User: melons)
Odeon - Fauna (User: melons)
Odeon - Fauna (User: melons)
Jolly Mare - Zatania (User: melons)
Bz Bz Ueu - Uhozmerigotz (User: melons)
Bz Bz Ueu - lo flopper (User: melons)
Nicolas Gaunin - Upa-Upa (User: melons)
The Beach Boys - Lady Lynda - Remastered 2000 (User: melons)
In Zaire - Mercury (User: melons)
Roberto Cacciapaglia - Quite Still (User: melons)
Lorenzo Feliciati - 223 Teeth (User: melons)
Gaznevada - Nevadagaz (User: melons)
Tony Rusconi - Electric Cube (User: melons)
Agua Re - Holy Dance - Large Sound Mix (User: melons)
Stump Valley - Sunshine Hotel (User: melons)
Sensations' Fix - Dark Side of Religion (User: melons)
Roberto Colombo - Entreneuse (User: melons)
Tony Esposito - Tango di una notte senza luna (User: melons)
MAMUTHONES - Show Me (User: melons)
Confusional Quartet - Paranoia (User: melons)
Kay Hoffman - Iste Mundus (User: melons)
Gigi Masin - Tears Of Clown (User: melons)
Walter Maioli - The Sirens (User: melons)
Influenza Prods. - Confucius (User: melons)
Estasy - Wonder (User: melons)
Roberto Musci - Claudia, Wilhelm R and me (User: melons)
Piero Umiliani - Ultimo stregone (User: melons)
Arawak - Hardware (User: melons)
Teatro Satanico - 0(shun) K(teis) (User: melons)
Valentina Magaletti - Apples from Peru (User: melons)
Demetrio Stratos - Flautofonie ed altro (User: melons)
DsorDNE - In The Mouth My Heart (User: melons)
Furtherset - This Eternal Vanishing (User: melons)
T.e.s.o. - -P\e elp (User: melons)
The Greenberry Woods - Love Songs (User: melons)
Olivia Newton-John - Hopelessly Devoted To You - From “Grease” (User: melons)
Ouzo Bazooka - I Dream Of Naomi (User: melons)
Carly Simon - Coming Around Again (User: melons)
Patti Page - Old Cape Cod - 1957 Single Version (User: melons)
Jackie Shane - Any Other Way (User: melons)
Carlos Vives - Canción Bonita (User: melons)
Lynn Taitt - To Sir With Love (User: melons)
Kev Hopper - Theme For Young Lovers (User: melons)
Ether - Best Friend (User: melons)
Lo Fidelity Allstars - Somebody Needs You (feat. Greg Dulli) (User: melons)
Ceremony - Send Me Your Dreams (User: melons)
Blankenberge - Summer Morning (User: melons)
увула - сёрф (User: melons)
Buckwheat Zydeco - On A Night Like This (User: melons)
The Trudy - Dirt Cheap Melody (User: melons)
Don't Mean Maybe - Domesticated (User: melons)
Dirty White Boy - Let's Spend Momma's Money (User: melons)
Lies Damned Lies - Same Road (User: melons)
The Heart Throbs - White Laughter (User: melons)
The Hummingbirds - If A Vow (User: melons)
The Chimes - I Still Haven't Found What I'm Looking For (User: melons)
Ruthless Rap Assassins - and it wasn't a dream (User: melons)
Fluffy - I Wanna Be Your Lush (User: melons)
Fluffy - I Wanna Be Your Lush (User: melons)
Fluffy - I Wanna Be Your Lush (User: melons)
Dogstar - Halo (User: melons)
Googolplex - Blow your mind (User: melons)
Rainbow99 - Bird (User: melons)
Apartamentos Acapulco - Y Tú en Barcelona (User: melons)
Apartamentos Acapulco - Y Tú en Barcelona (User: melons)
Camera Shy - New Something (User: melons)
Pia Fraus - Moon Like a Pearl (User: melons)
Tut - Ингредиенты-колёса (User: melons)
Molly - Sun Sun Sun - Acoustic (User: melons)
Oyama - Don't be sad because of people, they will all die (User: melons)
Tip Top Tellix - It's a Joke (User: melons)
Mean Red Spiders - Compromise (User: melons)
Goldbug - Shadow Memory (User: melons)
Noumeno - Sensorial Surrogate (User: melons)
La Casa al Mare - At All (User: melons)
Mai Mai Mai - Secondo Coro Delle Lavandaie (User: melons)
Shiner - Christ Size Shoes (User: melons)
KinokoTeikoku - Make L (User: melons)
Dracula Lewis - Sparkle Flesh (feat. JAWS) (User: melons)
Grace Jones - Slave to the Rhythm (User: melons)
Joe Henry - Stop (User: melons)
Kylie Minogue - Give Me Just a Little More Time (User: melons)
Crowded House - Weather with You (User: melons)
Cher - The Music's No Good Without You (Full radio version) (User: melons)
Louise - 2 Faced (User: melons)
KinokoTeikoku - Make L (User: melons)
Robbie Williams - Lost (XXV) (User: melons)
Old Fire - Don't You Go (User: melons)
Dracula Lewis - Sparkle Flesh (feat. JAWS) (User: melons)
The Mighty Diamonds - Them Never Love Poor Marcus - 2001 Digital Remaster (User: melons)
Ummagma - Human Factor (User: melons)
Glenn Phillips - Ive Got A Bullet With Your Name On It (User: melons)
Tal Bachman - She's So High (User: melons)
Mike Lindup - Desire (User: melons)
The Death of Pop - Go Back (User: melons)
Rainbow99 - CALENDAR (Live at Club BBANG, Seoul, 2016) (Band Set) (User: melons)
Dead White Tulips - Is It Real (User: melons)
She Bit Her Lip - Uni (User: melons)
The Fauns - Understand (User: melons)
His Clancyness - What Fury Can't Say (User: melons)
Dayflower - Big Blue (User: melons)
Swiimers - Woodstock (User: melons)
Shoreline Is - Interlude (User: melons)
Satellite Jockey - Your Black Cloud (User: melons)
Silvania - Solineide (Miel Nube Hiel) (User: melons)
queridas - 8.304,42 (User: melons)
The City Gates - Maddening Ride (User: melons)
The Away Days - Your Colour (User: melons)
Colour of Spring - Snow (User: melons)
Flyying Colours - Big Mess (User: melons)
Céus de Abril - Falso Amor (User: melons)
Ghost Transmission - Keep Dreaming (User: melons)
Balladur - Moe (User: melons)
Stella Diana - Shoet (User: melons)
Foxes in Fiction - Amanda (User: melons)
Vaya Futuro - Sombras (User: melons)
Menswear - Sleeping In (User: melons)
The Cherry Wave - Blissbomb (User: melons)
Azure Blue - Dreamy Eyes (User: melons)
Olivier Debard - To Pretend (User: melons)
Spool - sway, fadeaway (angel version) (User: melons)
Frabin - Kids From Outer Space (User: melons)
Vaadat Charigim - Ein Nehama Ladoachim (User: melons)
velódromo - Gémini (User: melons)
Marble Arch - In My Heart (User: melons)
Pia Fraus - Chromatic Nights (User: melons)
Malory - Wasted (User: melons)
Forsaken Autumn - Soft Wing (User: melons)
La Casa al Mare - Sunflowers (User: melons)
FPRF - Summer Somewhere (User: melons)
J. Francis - all the petty hours (User: melons)
Manon Meurt - In These Eyes (User: melons)
KinokoTeikoku - ロンググッドバイ (User: melons)
Tears Run Rings - Divided (User: melons)
Lilies On Mars - So Far Dear America (User: melons)
Maribel - Soothe (User: melons)
The Majestic High - See Her Fall (User: melons)
broken little sister - blue (User: melons)
Duelectrum - She Doesn't Feel The Sun (User: melons)
Echo Lake - Waves (User: melons)
Star Horse - Wherever You (User: melons)
my violainé morning - Colors of Condensed Vapour in The Sky (User: melons)
Blouse - Fountain in Rewind (User: melons)
DEAFCULT - SAFETY MATCHES (User: melons)
Lorenzo Senni - PointillisticT (User: melons)
The Nightblooms - Crystal Eyes (User: melons)
White Poppy - Confusion (User: melons)
Alpine Decline - Frontier Religion (User: melons)
Dråpe - Hike (User: melons)
Snoww Crystal - Nothing Is Real (User: melons)
Resplandor - Solar (User: melons)
Monoland - Motel Fumatore (User: melons)
la suma de todos los tiempos - El Sueño de Otro Lugar (User: melons)
Pure Morning - Space dive (User: melons)
Tribes of the City - I Want You (User: melons)
Emily A. Sprague - Silken Pt. 2.1 (User: melons)
Imaginary Softwoods - The Geranium Room (User: melons)
The Sweet Enoughs - Marshmallow (User: melons)
Green-House - Royal Fern (User: melons)
Nala Sinephro - Space 1 (User: melons)
Bokoya - Swampland (User: melons)
yes/and - Ugly Orange (User: melons)
Mary Lattimore - Sometimes He's In My Dreams (User: melons)
Green-House - Sunflower Dance (User: melons)
Ana Roxanne - Suite Pour L'invisible (User: melons)
Rust - Please Return (User: melons)
The Summer Set - 'Cos It's Over (User: melons)
Those Fadin' Colours - Try Me On For Size (User: melons)
THE ALAN BOWN - All Along the Watchtower - Mono (User: melons)
The Slender Plenty - Silver Tree Top School For Boys (User: melons)
Grapefruit - Elevator (User: melons)
One in a Million - Double Sight (User: melons)
Mike Stuart Span - World In My Head (User: melons)
The Dukes Of Stratosphear - Vanishing Girl - 2001 Mix (User: melons)
Linda Smith - i so liked spring (User: melons)
Mindy Kaling - Mindy Kaling (User: melons)
The Lemon Twigs - The One (User: melons)
Moondog - I'm This, I'm That (User: melons)
Shocking Blue - Hot Sand (User: melons)
Thee Oh Sees - Minotaur (User: melons)
Matthew Sweet - Divine Intervention (User: melons)
Gil Trythall - Wichita Lineman (User: melons)
Kelley Stoltz - Are You My Love? (User: melons)
Thinking Fellers Union Local 282 - Noble Experiment (User: melons)
A. Savage - Eyeballs (User: melons)
Death Valley Girls - Hold My Hand (User: melons)
The Smashing Pumpkins - Set the Ray to Jerry (User: melons)
Ela Orleans - The Season (2019 Remaster) (User: melons)
The Dears - Lost in the Plot (User: melons)
Berntholer - My Suitor (User: melons)
Nico - I'll Keep It with Mine (User: melons)
Elvis Costello & The Attractions - New Amsterdam (User: melons)
Ultimate Painting - Central Park Blues (User: melons)
Elvis Costello & The Attractions - New Amsterdam (User: melons)
Wendy & Bonnie - You Keep Hanging Up On My Mind (User: melons)
Elyse Weinberg - Houses (User: melons)
Jeremy Enigk - Abegail Anne (User: melons)
Sagittarius - Song To The Magic Frog (User: melons)
Mindy Keahey - In the Waiting (User: melons)
Spencer Cullum - Imminent Shadow (User: melons)
Basil Kirchin - Primitive London 1 (User: melons)
Courtney Barnett - Avant Gardener (User: melons)
Basil Kirchin - Primitive London 1 (User: melons)
Karen Dalton - In a Station (User: melons)
Jenny and Johnny - Big Wave (User: melons)
Primal Scream - Slip Inside This House (User: melons)
The Bats - North By North (User: melons)
The Millennium - It's You (User: melons)
Ennio Morricone - My Name is Nobody (Main Title) - Original Version (User: melons)
Terris - Fabricated Lunacy (User: melons)
Six By Seven - Candlelight (User: melons)
Ambulances - Three (User: melons)
Steely Dan - Reelin' In The Years (User: melons)
Yusuf / Cat Stevens - Father And Son (User: melons)
Genesis - Mama (User: melons)
Tears for Fears - Mothers Talk - Video Version (User: melons)
Huggy Bear - Herjazz (User: melons)
Adele - Set Fire to the Rain (User: melons)
David Essex - Hold Me Close (User: melons)
Liverpool Express - Every Man Must Have a Dream (User: melons)
Casper Brötzmann - Schere (User: melons)
Casper Brötzmann - Schere (User: melons)
Menswear - Sunday Driver (User: melons)
George Faith - Have I Told You Lately (User: melons)
Lowgold - Counterfeit (User: melons)
Fluff - Grinner (User: melons)
Uh Huh Her - Explode (User: melons)
I Love You But I've Chosen Darkness - The Owl (User: melons)
The Organ - Steven Smith (User: melons)
Paul McCartney - Birthday - Recorded At Abbey Road Studios, London (User: melons)
Mello-T - Christian (User: melons)
The Liverbirds - Why Do You Hang Around Me (User: melons)
Eaves Wilder - In and out (and out Again) (User: melons)
Tears for Fears - Shout (User: melons)
Zeca Pagodinho - camarão que dorme a onda leva (User: melons)
The Pointer Sisters - Dirty Work (User: melons)
Arlo Parks - Hope (User: melons)
Andy Bell - Something Like Love (User: melons)
Panda Bear - Edge of the Edge (User: melons)
Ysgol Sul - Aberystwyth yn y Glaw (User: melons)
R.E.M. - Stumble (User: melons)
Juniore - Ouh là là (User: melons)
Hamish Hawk - Calls To Tiree (User: melons)
Patrick Cowley - Do You Wanna Funk? (User: melons)
Mick Ronson - Only After Dark (User: melons)
Sonny & Cher - I Walk On Guilded Splinters (User: melons)
Manic Street Preachers - Tsunami (User: melons)
George McGregor & The Bronzettes - Temptation Is Hard to Fight (User: melons)
Roxy Music - Mother of Pearl (User: melons)
The Staple Singers - Respect Yourself (User: melons)
The Everly Brothers - Cathy's Clown (User: melons)
Echo & the Bunnymen - Bring On The Dancing Horses (User: melons)
Menswear - I'll Manage Somehow (User: melons)
Bahamas - Lost In The Light (User: melons)
The Main Ingredient - Everybody Plays the Fool (User: melons)
The Vaselines - Son of a Gun (User: melons)
