The Isley Brothers - This Old Heart Of Mine (Is Weak For You) (User: melons)
Romero - Nie Mein Shawty (User: melons)
Hirsch - Miracle (User: melons)
Arin Demain - Silent Treatment (User: melons)
R.E.M. - Radio Free Europe (User: melons)
The Beatles - There's A Place - Remastered 2009 (User: melons)
Cort Melor - Love You (User: melons)
The Lords - Manchester England (User: melons)
The Lords - Don't Put Me Down (User: melons)
The Zip-Codes - Dear Henry Ford (User: melons)
Mary Saxton - Is It Better to Live Or to Die (User: melons)
Kenny & The Ho-Daddies - Goofy Guitar (User: melons)
Gary Paxton - Two Hump Dual Bump Camel Named Robert E Lee (User: melons)
Gaupa - The Drunk Autopussy Wants to Fight You (User: melons)
The Rockets Band - Warrior (User: melons)
The Captivations - Wild Wild Mustang (User: melons)
Lonnie Mclaughlin - War Path (User: melons)
The Captivations - Speedshift (User: melons)
The Fashions - Surfin' Back To School (User: melons)
Bucky & The Dales - Firewater (User: melons)
Gary Paxton - The Scavenger (User: melons)
Lord Douglas Byron - Big Bad Ho Dad (User: melons)
The Rockets Band - Countdown (User: melons)
Judy Russell - Surfin' With Jimmy (User: melons)
Kenny & The Ho-Daddies - Surf Dance (User: melons)
The Captivations - Little Bitty King Of The Road (User: melons)
Gene Moles - Kaha Huna (Goddess Of Surfing) (User: melons)
Sandford - Let's Go to the Beach (User: melons)
The Torquays - Escondido (User: melons)
Surf Bunnies - Summertime Is Surfin' Time (User: melons)
Vince & the Waikiki Rumblers - Waikiki Rumble (User: melons)
The Captivations - Red Hot Scrambler-Go! (User: melons)
Kenny & the Sultans - The Wipe Out (User: melons)
Dave Kinzie - Beach Party (All Summer Long) (User: melons)
Carl Walden - I'll Never Let You Go (User: melons)
Don Hinson - Peddlers Of Hate (User: melons)
Mental Institution - In The Heat Of The Night (User: melons)
Ken & the 4th Dimension - See If I Care (User: melons)
The New Wing - I Need Love (User: melons)
The Fog - Grey Zone (User: melons)
The Buddhas - Lost Innocence (User: melons)
Limey & the yanks - Guaranteed love (User: melons)
The Avengers - Be A Cave Man (User: melons)
Janice Paxton - I've Had Enough Heartaches (User: melons)
Darlene McKinney - Plain Simple Ordinary Guy (User: melons)
The Rev-Lons - Whirlwind (User: melons)
Doris Webb - He's The Most (User: melons)
Beatrice Lee - Boy You Better Watch It Girl (User: melons)
The Fashionettes - Losin' Control (User: melons)
Diana Dawn - Back Street Girl (User: melons)
Sandie Shaw - I'll Know Better (Next Time) (User: melons)
Beverly Williams - They Say Big Girls Don't Cry (User: melons)
Mary Saenz - Would She Do That For You (User: melons)
The Rev-Lons - Boy Trouble (User: melons)
The Privilege - The Highly Successful Young Rupert White (User: melons)
Dave Antrell - You Take Things Lightly Babe (User: melons)
The Lords - Savin' (Everything for You Girl) (User: melons)
Willie & the Walkers - Is It Love (User: melons)
The Four Freshmen - Nowhere To Go (User: melons)
The Bakersfield Poppy Pickers - Clean Up Your Own Backyard (User: melons)
Johnny Apollo - Am I Wastin' My Time (User: melons)
The Jaybees - Bad Sign (User: melons)
The Bogart Cult - Games (User: melons)
Jim Gordon - How Many Times (User: melons)
Chocolate Tunnel - Ostrich People (User: melons)
Black Box - Happy Lovin' Time (User: melons)
The Whatt Four - Dandelion Wine (User: melons)
The New Wing - The Thinking Animal (User: melons)
Angie Moreno - Make Up Your Mind (User: melons)
Beach House - Sunset (User: melons)
Beach House - Over and Over (User: melons)
Beach House - New Romance (User: melons)
Beach House - Runaway (User: melons)
Beach House - Through Me (User: melons)
Beach House - Pink Funeral (User: melons)
Beach House - Superstar (User: melons)
Beach House - Once Twice Melody (User: melons)
Chic - Le Freak (User: melons)
Robert Wright - Stranger in paradise (User: melons)
Tony Bennett - Stranger in Paradise (User: melons)
Madonna - Beautiful Stranger (User: melons)
Falco - Rock Me Amadeus (User: melons)
Sugar Minott - Good Thing Going (User: melons)
Desmond Dekker - Israelites (User: melons)
Lord Creator - Kingston Town (User: melons)
El Siervo - Esto Es Cultura (User: melons)
Superorganism - Everybody Wants to Be Famous (User: melons)
Courtney Barnett - Continental Breakfast (User: melons)
Sylvan Esso - Coffee (User: melons)
The Buggles - Video Killed the Radio Star (User: melons)
Belbury Poly - Goat Foot (User: melons)
ABBA - Dancing Queen (User: melons)
The Advisory Circle - Here! In The Wychwoods (User: melons)
Kirsty MacColl - They Don't Know (User: melons)
Fosca - My Diogenes Heart (User: melons)
Mark Badinson - One More Time (User: melons)
gentle jupiter - poor girl (User: melons)
Zero Views - Red Flag (User: melons)
King Boa - Acid Bong (User: melons)
Polychrome - The Impulse (User: melons)
Tri-State - Toasts and Boasts (User: melons)
Keith Dominique - Let Myself Out (User: melons)
Of House - Pre-Coffee Contemplation (User: melons)
Meaning to Crack - Intro (Instrumental) (User: melons)
Nine Blade - Sober (User: melons)
Rock Halls - Glitter in the Gutter (User: melons)
Giles Likes Tea - Gypsy Pt 1 (User: melons)
Milk & Fruit Juice - The Basement of My Brain (User: melons)
Homelette - Monroe (User: melons)
Postcode - It's Amazing It's Fantastic (User: melons)
John Boy - Susonia (Intro) (User: melons)
Jonathan Hape - Taste Like Thunder (User: melons)
The Beau Peepshow - Love Makes My Head Hurt (User: melons)
Houseguest - Fashionable Living Room (User: melons)
The Bracelets - Waddle Waddle (User: melons)
The Biltmores - Static (User: melons)
Returning Envelope - Mini 2 (User: melons)
AM Magic - Blue Timbre (User: melons)
Unbelievable Luck - Unreasonable (User: melons)
The Hourglass Cats - Jeffrey's Pink Surprise (User: melons)
Marathon 85 - Differences - Drummer's Remix (User: melons)
Puppy Feet - Fall Apart (User: melons)
SomoNauk - Putrid (User: melons)
Jay Luis - Hunni (User: melons)
Zach Medeiros - Hard to Stay (User: melons)
James Barrett - Thinking Of A Place (User: melons)
Karly D - The Argumental Afterword (User: melons)
WINKLER - Mona (User: melons)
WINKLER - Here Comes Henry (User: melons)
Dead Rabbits - Free (User: melons)
Jesse Gimbel - Move or Move On (User: melons)
Unknown Pilots - Dark Skies (User: melons)
Danax - Play With Fire (User: melons)
Number Station - Way Down Low (User: melons)
Ertam - High Atmosphere - Alternate Version (User: melons)
Jam City - Cartwheel (User: melons)
Maple - Fold (User: melons)
( LSO ) Lil Reno™ - Money To Make (User: melons)
Space Plants - LSD Chimpanzee (User: melons)
Cosmo's Demos - STM (User: melons)
Cosmo's Demos - STM (User: melons)
Amateur Hockey Club - Bones (User: melons)
Jackie - HDD (User: melons)
Red Theme - Meme (User: melons)
Jackie - HDD (User: melons)
System Overload - Oh Wow (User: melons)
cult.disco - june (User: melons)
Megawave - Slow Motion (User: melons)
Anchor Thieves - Denim Balloons (User: melons)
Hetzand View - Night Like Day (User: melons)
Floral Tops - Midnight Talks (User: melons)
David Dear - Friendly Fire (User: melons)
Carrier - You, Underwater (User: melons)
Keaper - Red (User: melons)
Slightest Clue - Baby Jade (User: melons)
Paris Street - Patio Song (User: melons)
Paris Street - Screen Prints (User: melons)
The Association - Wantin' Ain't Gettin' - Remastered Version (User: melons)
Shanf - Company Card (User: melons)
Seagoth - Find the Time (User: melons)
Glamper - Lose My Cool (User: melons)
Alice Greaves - A Place (User: melons)
Junon - Sleep Deprived (User: melons)
Soft Leather - Vegas Nerve (User: melons)
Jake LeMond - Peeled (User: melons)
Dominic Lavoie - Skeletons At The Feast (User: melons)
Springworks - Electrocutioner's Tale (User: melons)
Hobbies - Bigger (User: melons)
Eyes Half Shut - The Bends (No You Don't) (User: melons)
Eric Linden - 3,000 Pieces of Me (User: melons)
Aurelio Valle - Bruised and Diffused (User: melons)
Eleanor Collides - Fragments and Shadows (User: melons)
Pisgah - (It Always Feels Like) December (User: melons)
Sunset Jet - Happiness Is a Work of Art (User: melons)
Chic Chameleon - Dreaming of Heaven (User: melons)
Admiral Fox - Baby Owl (User: melons)
Sweet Bike - Soup Can Stevens (User: melons)
Aj Capuano - Imposter (User: melons)
Wild Combo - Everybody Gestures (User: melons)
Phanerons - Space For Rent (User: melons)
Talk - Cold Valentine (User: melons)
Jean Jackets - I'll Be the One (User: melons)
Gestalt - Out Singing (User: melons)
Therapy Dawg - Blue (User: melons)
Project Diem - Milky (User: melons)
Evil Twin - Devil You Know (User: melons)
Shore Fires - Someday (User: melons)
Sons of Kuma - Love (User: melons)
Nicholas Baldwin - ICFYIIT (User: melons)
Get Well, Kid - I'm Still Terrified (User: melons)
Native world - Celeste (User: melons)
Micah Sunset - I Can Hear You Breathing on the Other End (User: melons)
Parker Longbough - Off Front Street (User: melons)
The Origin - Everything That Could Went Wrong (User: melons)
Disgraced Angels - New World (User: melons)
Charity Bliss - Comfy Cozy Chill Time (User: melons)
In A Daydream - The Romantic Egotist (User: melons)
Antigen - Black Graffiti (User: melons)
Kayaks - Forest Fire (User: melons)
TedLK - Cavey (User: melons)
Tom Hymn - Dancehall on the 3rd Floor (For Tyler) (User: melons)
Knowledge Tha Prophet - Smile (User: melons)
Rare Fiction - Reboot (User: melons)
Nate and Levi Project - Empty Nails (User: melons)
Higher Law - Bury Me Underground (User: melons)
Come Back K! - Rabbit Hole (User: melons)
Muslimgauze - I Shall Sing Until My Land Is Free (User: melons)
Kilink - evet öyleyim (User: melons)
Cemiyette Pişiyorum - Beynim Yok (User: melons)
Fearless Iranians From Hell - Ultraviolence (User: melons)
Kumar Shome - Nymphatic (feat. The Punkawallahs) (User: melons)
Mona Haydar - Hijabi (User: melons)
Dua Saleh - Warm Pants (User: melons)
Maafa Hardcore - Welfare (User: melons)
Hoba Hoba Spirit - Gnawa Blues (User: melons)
The Tuts - 1982 (User: melons)
The Tuts - Let Go Of The Past (User: melons)
Ghost Funk Orchestra - Bloodmoon (User: melons)
Dusu Mali - Mande Kono (User: melons)
Souad Massi - Raoui (User: melons)
Das Racist - Chicken and Meat (User: melons)
Heems - Blades (User: melons)
Steady Holiday - Love Me When I Go To Sleep (User: melons)
Steady Holiday - Terror (User: melons)
Drop Electric - Aisha and the Knife (User: melons)
The 1865 - Buckshot (User: melons)
Abdou El Omari - Afrah El Maghreb / أفراح المغرب (User: melons)
Haoussa - Al Wada3, al Wada3 (User: melons)
Sarmust - Don't Torture Me (Bhangra End) (User: melons)
Omar Fadel - Caught In the Act (User: melons)
Lowkey - Terrorist? (User: melons)
Propagandhi - The Only Good Fascist Is A Very Dead Fascist (User: melons)
Moor Mother - Maroons (User: melons)
Billy Woods - Poor Company (Feat. Elucid & Henry Canyons) (User: melons)
Be Like Muhammad - Mercy Mercy (User: melons)
Swet Shop Boys - Sufi La (User: melons)
Humeysha - Nusrat on the Beach (User: melons)
Mashrou' Leila - Djin (User: melons)
Swet Shop Boys - Din-E-iLahi (User: melons)
Fearless Iranians From Hell - Die for Allah (User: melons)
Haram - Where Were You on 9/11? (User: melons)
The Muslims - Sura Sura (User: melons)
Voice Of Baceprot - [NOT] PUBLIC PROPERTY (User: melons)
Billy Joel - We Didn't Start The Fire (Remastered) (User: melons)
Emeli Sandé - Clown (User: melons)
Emerson, Lake & Palmer - Fanfare For The Common Man (User: melons)
Embrace - World At Your Feet (User: melons)
Liverpool Football Team - We Can Do It (User: melons)
Stevie Wonder - Never Had A Dream Come True (User: melons)
Frantique - Strut Your Funky Stuff (Single Version) (User: melons)
The Beatles - There's A Place - Remastered 2009 (User: melons)
Soak - Sea Creatures (User: melons)
R.E.M. - Nightswimming (User: melons)
Smoke City - Underwater Love (User: melons)
The Delgados - Coming in From the Cold (User: melons)
The Five Blobs - The Blob (User: melons)
The Human Beinz - Dance On Through (User: melons)
Low Girl - Knees (User: melons)
Grave Goods - Source (User: melons)
Carmen Villain - Liminal Space (User: melons)
boshi - liminal spaces (User: melons)
Tricky - The Only Way (User: melons)
Young Fathers - In My View (User: melons)
The Beatles - Sun King - Remastered 2009 (User: melons)
Princess Nokia - ABCs of New York (User: melons)
The Cramps - Human Fly (User: melons)
Nero - Into the Past (Reboot) (User: melons)
Ann Robinson - Sissy Walk (User: melons)
The Ides Of March - The Sky Is Falling (User: melons)
Les Rita Mitsouko - Un soir un chien (User: melons)
Tigermonkey - Zooby Doo - Majestic, Fatman Scoop & General Levy Remix (User: melons)
Bill Withers - Use Me (User: melons)
Le Tigre - Deceptacon (User: melons)
The Cateran - Traffic Drone (User: melons)
Bill Callahan - Eid Ma Clack Shaw (User: melons)
Yuck - Suicide Policeman (User: melons)
Andrew Pekler - Theme From Tristes Tropiques / Avian Modulations / Life In The Canopy (User: melons)
Weed - Puncture (User: melons)
Jane Godfrey - Daggett Lake Revisited (User: melons)
Skywave - Fire (User: melons)
Foxing - Draw Down the Moon (User: melons)
Iron Monkey - Shrimp Fist (User: melons)
Royal & the Serpent - Overwhelmed (User: melons)
Arctic Monkeys - There’d Better Be a Mirrorball (User: melons)
Pattycake - I Put a Spell on You (In the Style of Hocus Pocus) (User: melons)
Mexican Institute of Sound - Duermete Mi Niña (User: melons)
Krrum - Moon (User: melons)
Nanami Ozone - Something To You (User: melons)
Saâda Bonaire - To Know You Is To Love You (User: melons)
Andrew Pekler - Theme From Tristes Tropiques / Avian Modulations / Life In The Canopy (User: melons)
Weed - Depending On (User: melons)
Robin Guthrie - Monument (User: melons)
Interpol - Everything Is Wrong (User: melons)
Better Bidness Bureau - This One's the Heat (User: melons)
Silversun Pickups - Scared Together (User: melons)
Depeche Mode - Enjoy the Silence (User: melons)
Collumpton - 4 (User: melons)
& Rock Mafia - My Family (from "The Addams Family") (User: melons)
Donald Byrd - Slow Drag (User: melons)
The Alternate Routes - Nothing More (feat. Lily Costner) (User: melons)
Stratis - Mystery Trip (User: melons)
Pixies - In the Arms of Mrs. Mark of Cain (User: melons)
Depeche Mode - I Feel You (User: melons)
Dry Cleaning - Gary Ashby (User: melons)
Supergrass - Grace (User: melons)
Robin Gibb - Saved by the Bell (User: melons)
Elvis Presley - Clean Up Your Own Back Yard (User: melons)
Foster & Allen - Walk Tall (User: melons)
Belouis Some - Imagination (User: melons)
Gwen Guthrie - Ain't Nothin' Goin' On But The Rent (User: melons)
Al Martino - Spanish Eyes (User: melons)
Belouis Some - Imagination (User: melons)
Dorris Henderson - Watch the Stars (feat. John Renbourn) (User: melons)
Young Fathers - I Saw (User: melons)
Beats International - Dub Be Good To Me (User: melons)
Guillemots - The Basket (User: melons)
Nino Ferrer - Le Sud (User: melons)
The United States of America - Stranded in Time (User: melons)
Momus - The Hairstyle of the Devil (User: melons)
Love - Always See Your Face (User: melons)
Sparks - This Town Ain't Big Enough for Both of Us (User: melons)
The Go-Go's - We Got the Beat (User: melons)
Timmy Thomas - Why Can't We Live Together (User: melons)
Carly Simon - Why (User: melons)
The Cuff Links - Tracy (User: melons)
Fiction Factory - (Feels Like) Heaven (User: melons)
The Verlaines - The Funniest Thing (User: melons)
Sugababes - Overload (User: melons)
Nolan Porter - If I Could Only Be Sure (User: melons)
Depeche Mode - I Sometimes Wish I Was Dead (User: melons)
Depeche Mode - Nothing (User: melons)
Tomorrow - Strawberry Fields Forever - 1999 Remaster (User: melons)
Kenny Rankin - Blackbird (User: melons)
Us The Duo - Oh! Darling (User: melons)
Lenny Breau - Hard Day's Night (User: melons)
Zoot - Eleanor Rigby (User: melons)
Bill Withers - Let It Be (User: melons)
Booker T. & the MG's - Day Tripper (User: melons)
Wes Montgomery - A Day In The Life (User: melons)
Gregg Allman - Rain - Demo (User: melons)
Marvin Gaye - Yesterday (User: melons)
The Beach Boys - You've Got To Hide Your Love Away - Mono / Remastered 2001 (User: melons)
Kurt Cobain - And I Love Her (User: melons)
Marianne Faithfull - I'm A Loser (User: melons)
Rita Lee - All My Loving (User: melons)
Regina Spektor - Real Love (User: melons)
Earth, Wind & Fire - Got to Get You into My Life (User: melons)
Petula Clark - Blackbird (User: melons)
Nick Heyward - Nowhere Man (User: melons)
Constant Bop - Mother Nature's Son (User: melons)
Herbie Hancock - Norwegian Wood (User: melons)
Bryan Ferry - You Won't See Me (User: melons)
BossaCucaNova - You Know My Name (Look Up The Number) (User: melons)
Strangulated Beatoffs - I'm So Tired (User: melons)
Arif Mardin - Glass Onion (User: melons)
Bud Shank - Your Mother Should Know (User: melons)
The Turtles - WILD HONEY PIE (User: melons)
The Langley Schools Music Project - The Long And Winding Road (User: melons)
Flamin' Groovies - There's A Place (User: melons)
Five Man Electrical Band - You're Going To Lose That Girl (User: melons)
Elliott Smith - Because (User: melons)
Tiny Tim - Nowhere Man - Live at Royal Albert Hall (User: melons)
Kevin Rowland - The Long And Winding Road (User: melons)
Daniel Johnston - I Will (User: melons)
The Meters - Come Together (User: melons)
Al Green - I Want To Hold Your Hand (User: melons)
Elvis Presley - Hey Jude (User: melons)
Judy Collins - In My Life (User: melons)
King Curtis - And I Love Her (User: melons)
The Smithereens - Yer Blues (User: melons)
Prince Buster - ALL MY LOVING (User: melons)
Wade Marcus - Something (User: melons)
Joe Cocker - With A Little Help From My Friends (User: melons)
Richie Havens - Here Comes The Sun (User: melons)
The Breeders - Happiness Is a Warm Gun (User: melons)
The Highwomen - Loose Change (User: melons)
Black Belt Eagle Scout - Scorpio Moon (User: melons)
Sleater-Kinney - The Drama You've Been Craving (User: melons)
Margo Price - Best Friends Make The Best Lovers (User: melons)
The Beach Boys - Girl Don't Tell Me (User: melons)
Twice as Much - The Coldest Night Of The Year (User: melons)
Grant Lee Buffalo - Fuzzy (User: melons)
R.E.M. - Radio Free Europe (User: melons)
Unit 4 + 2 - Concrete And Clay (User: melons)
Pixies - Monkey Gone to Heaven (User: melons)
John Wasson - Caravan - Bad Drumming (User: melons)
Shirley - Sugar Sugar (User: melons)
The Invincibles - Nobody (User: melons)
The Doo-Rights - You're My Girl (User: melons)
The Anxiety - Meet Me At Our Spot (User: melons)
Juicy Lucy - Nadine (User: melons)
The Real Thing - The International Love Song (User: melons)
Louise Whitney - Gotta Keep On (User: melons)
Chants - Shimmer and Glimmer (User: melons)
Anxious - Your One Way Street (User: melons)
Quasi - Queen of Ears (User: melons)
Fern Brady - People Think I'm a Man (User: melons)
Rose Matafeo - New Zealand Girls (Jfl 2018) (User: melons)
Steve Martin - Playing With the Big Boys (User: melons)
Maurice Rodgers - Coming In Out Of The Rain (User: melons)
Maurice Rodgers - Coming In Out Of The Rain (User: melons)
The Georgia Prophets - Loving You Is Killing Me (User: melons)
Foxy - Trouble (User: melons)
Kent & The Candidates - Trouble (User: melons)
The Bagdads - Bring Back Those Doo-Wopps - Mono (User: melons)
Samson - The End Song (User: melons)
Nicky Scott - Big City (User: melons)
Golden Apples Of The Sun - The Monkey Time (User: melons)
Australian Playboys - Sad (User: melons)
Billy Nicholls - Would You Believe (User: melons)
Soulwax - Much Against Everyone's Advice (User: melons)
Pixies - Hey (User: melons)
The Monochrome Set - Eine Symphonie Des Grauens (User: melons)
Warm Sounds - Angeline (User: melons)
Mike D'Abo - (See The Little People) Gulliver's Travels (User: melons)
Duncan Browne - On The Bombsite (User: melons)
The Nice - The Thoughts Of Emerlist Davjack (User: melons)
The Castaways - Girl Don't Tell Me (User: melons)
Apostolic Intervention - (Tell Me) Have You Ever Seen Me (User: melons)
Chris Farlowe - My Way of Giving (User: melons)
The Mockingbirds - You Stole My Love (User: melons)
Twice as Much - Step Out of Line (User: melons)
Billy Nicholls - London Social Degree (User: melons)
John Mayall - I'm Your Witchdoctor (User: melons)
Les Fleur De Lys - Circles (User: melons)
The Poets - Baby Don't You Do It (User: melons)
Les Fleur De Lys - Circles (User: melons)
Goldie - Going Back (User: melons)
Chris Farlowe - Handbags And Gladrags - Original 1967 Recording (User: melons)
Pleasure - I'm confused (User: melons)
Lamp - For Lovers (User: melons)
Laundromat - Combo (User: melons)
Pixies - Something Against You - Remastered (User: melons)
Mick Softley - I'm So Confused (User: melons)
The Muffs - I'm Confused (User: melons)
Handsome Furs - I'm Confused (User: melons)
Autoheart - Lent (User: melons)
Tchotchke - Dizzy (User: melons)
The Buttertones - Nite Time Is My Time (User: melons)
MASS OF THE FERMENTING DREGS - delusionalism (User: melons)
Me and That Man - Under the Spell (feat. Mary Goore) (User: melons)
sonhos tomam conta - maladaptive daydreaming (User: melons)
Rosegarden Funeral Party - Once in a While (User: melons)
Joey Valence & Brae - Watch Yo Step (User: melons)
Goblin Cock - Something Haunted (User: melons)
Mook - She Sings (User: melons)
Worthikids - Friends In Low Places (User: melons)
SEKAI NO OWARI - Habit (User: melons)
Dwellings - Color of the Cat Tree (User: melons)
White Reaper - Only a Shadow (User: melons)
Lamp - A都市の秋 (User: melons)
SAKURAN-ZENSEN - TAXIMAN (User: melons)
FM Skyline - Harlequin (User: melons)
Feed Me Jack - Da Da Da Da (User: melons)
Teddy Hyde - Ugly (User: melons)
Shadow Academy - White Whale (User: melons)
The Living Tombstone - This Comes From Inside (User: melons)
The Bank Holidays - Tread Easy (User: melons)
The Heavy Eyes - These Men Are Wolves (User: melons)
Wire - Outdoor Miner (User: melons)
Apartmanlar - Son Rüya (User: melons)
Paichit Aksornnarong - Very True, But Will Give - Disco Mix (User: melons)
Droodle - ur doing just fine (User: melons)
Mattyeux - Sometimes (User: melons)
ZAZEN BOYS - ポテトサラダ (User: melons)
Daikaiju - Daikaiju Die! (User: melons)
Gus Dotby - The Job Will Never Get Done (User: melons)
the GazettE - 枯詩 (User: melons)
Diego Lorenzini - Soy Un Corpóreo Y Dentro de Mí Hay Una Actriz Recién Titulada Llorando (User: melons)
Pleasantries - Drink To Me (User: melons)
Louie Zong - YOUR HEAD'S ON FIRE (User: melons)
Sohodolls - Bang Bang Bang Bang (User: melons)
R.I.P. - Caged / Escape (User: melons)
Flagman - Bumblebee (User: melons)
Barry Uhl - Devouring the Devoted (User: melons)
The Minute Hour - The Shoebody Bop (User: melons)
Kyotaro&Rikuo - Attention! (User: melons)
Ooti Skulf - I Should Stop Eating Stones (User: melons)
kikuo - 幽体離脱 (feat. 初音ミク) (User: melons)
The Velveteers - Charmer And The Snake (User: melons)
Fallen Pine - Victim (User: melons)
Gardens & Villa - Disco Kitchen (User: melons)
Sam Mehran - LOUNGY (User: melons)
Pipe-Eye - Chakra (User: melons)
Nick Lutsko - Sideshow (User: melons)
Cobra Man - Light Me Up (User: melons)
RAZORBUMPS - FREAK BABY (User: melons)
Faux Real - Kindred Spirit (User: melons)
Stolen Nova - Vortex (User: melons)
WOOZE - I'll Have What She's Having (User: melons)
Thumpasaurus - Talkin' Bout (User: melons)
Hot Flash Heat Wave - Vampires (User: melons)
Ghost - Hunter’s Moon (User: melons)
Djo - Figure You Out (User: melons)
Mashrou' Leila - Djin (User: melons)
Haram - Eye for an Eye (User: melons)
The Kominas - Blow Shit Up (User: melons)
Sweet Sensation - Sad Sweet Dreamer (User: melons)
Belinda Carlisle - In Too Deep (User: melons)
Florence + the Machine - Spectrum (Say My Name) (Calvin Harris Remix Radio Edit) (User: melons)
The Rolling Stones - It's All Over Now (User: melons)
Alvin Stardust - Red Dress (User: melons)
Orange Juice - The Witch Queen Of New Orleans (Long Version) (User: melons)
John Grant - Pale Green Ghosts (User: melons)
Dummy - Daffodils (User: melons)
Super Furry Animals - Guacamole (User: melons)
Mike Watt - Piss-Bottle Man (User: melons)
Wild Pink - Hell Is Cold (User: melons)
Madonna - Like a Prayer (User: melons)
Guillemots - Trains to Brazil (User: melons)
The Apartments - Mr. Somewhere (User: melons)
Apartment - The Car (User: melons)
Apartment - June July (User: melons)
Apartment - Fall Into Place (User: melons)
Scarce - All Sideways (User: melons)
Grant Lee Buffalo - Fuzzy (User: melons)
Al Green - How Can You Mend a Broken Heart (User: melons)
Sleater-Kinney - I Wanna Be Your Joey Ramone (User: melons)
The The - This Is The Day (User: melons)
Royal Trux - Stevie (For Steven S.) (User: melons)
R.E.M. - Talk About the Passion (User: melons)
The Magnetic Fields - Busby Berkeley Dreams (User: melons)
The Damned - Eloise (User: melons)
Sonic Youth - 100% (User: melons)
Bronski Beat - Smalltown Boy (User: melons)
The Lemonheads - Different Drum (User: melons)
Yo La Tengo - Autumn Sweater (User: melons)
Pixies - Debaser (User: melons)
FEWS - Over (User: melons)
Pixies - Monkey Gone to Heaven (User: melons)
Foxygen - Follow The Leader (User: melons)
Foxygen - San Francisco (User: melons)
wetter - Hello Sunshine (User: melons)
The Monochrome Set - Eine Symphonie Des Grauens (User: melons)
The Bank Holidays - Cheating, Cheating (User: melons)
Pixies - Hey (User: melons)
R.E.M. - Radio Free Europe (User: melons)
3D Pop - Saknar Dig (User: melons)
Soulwax - Much Against Everyone's Advice (User: melons)
Green Velvet - Wurk (User: melons)
R.E.M. - Can't Get There From Here (User: melons)
Jane Wiedlin - Rush Hour (User: melons)
Electric Light Orchestra - Livin' Thing (User: melons)
The Afghan Whigs - Debonair (User: melons)
Mogwaa - Despedida (User: melons)
Jarren - Whittier Blvd. (User: melons)
Blue Hawaii - Where is the Sun??? (User: melons)
Apiento - Things You Do For Love - Heartbeat Version (User: melons)
Lexx - 1994 (User: melons)
Ponzu Island - Feijoa Sellowiana (Guavasteen) (User: melons)
Lucy - All Alone (User: melons)
Fantastic Man - False Consciousness - Mixed (User: melons)
Angeline Morrison - Hide Yourself (User: melons)
Angeline Morrison - Hide Yourself (User: melons)
Alex Ho - Idle Eighty (User: melons)
Jay Daniel - Muse (User: melons)
ANZ - Decisions (AM Intro) (User: melons)
Jay Daniel - Muse (User: melons)
Kent Paul - Bobby'sdance (User: melons)
Johnny Osbourne - No Lollipop No Sweet So (User: melons)
Johnny Osbourne - Ready or Not (User: melons)
The Litter - Codine (User: melons)
Real de Catorce - Azul (User: melons)
Tera Melos - Melody 1 (User: melons)
TSURUDA - yacht haven grande (User: melons)
Cannibal Ox - Believe - Live (User: melons)
DJ co.kr - JONNA Go (Feat. MC JONNA, VENKO) (User: melons)
Michigan & Smiley - Diseases (User: melons)
Claire Rousay - Sad Gondola (User: melons)
Jasper Wilderness - WFMT (User: melons)
Deep Tan - Constant Inconsistencies (User: melons)
Lizzie Reid - Tribute (User: melons)
Laureen Conrad - The Cutest Puppy (User: melons)
The Brevet - Safe (User: melons)
The Pyramids - Ankle Bracelet (User: melons)
HAWKE THE BAND - Miracles (User: melons)
Algernon Cadwallader - Casual Discussion In A Dome Between Two Temples (User: melons)
Poloboy Nunu - Come Outside (User: melons)
Night Cap - Eileen (User: melons)
Kahone Concept - No but Kinda (User: melons)
Maurice Ravel - Ravel: Pavane pour une infante défunte, M. 19 (User: melons)
Vandal - Balah Ih Fogoh (User: melons)
TWO WEEKS IN NASHVILLE - Overdose (User: melons)
Salt Of The Sound - Sanctuary (User: melons)
More&More - Outside (User: melons)
Jean-Baptiste Lully - Les Folies d'Espagne (User: melons)
Lisa, Amy & Shelley - Fout Ventje - Original Mix (User: melons)
Creature Canyon - Heartbeat (User: melons)
Klapa Maslina - Da Te Mogu Pismom Zvati (User: melons)
Sfven - Don't Jump The Gun (User: melons)
Uncle Tupelo - Sandusky (User: melons)
GG Chevy - 2018 (User: melons)
Sam Allen - I Used To Be Loved (User: melons)
Kinnijin - Йоу, собаки, я - Наруто Узумаки! (User: melons)
Old Sea Brigade - Monochrome (User: melons)
Joe Hicks - Sail Away (User: melons)
João Pedro Oliveira - Intersections (User: melons)
Elephant Motel - Feeling Alright (User: melons)
Nickelus F - Trill Burr (User: melons)
BLOWSOM - 306 (User: melons)
Cocooma - The lights (User: melons)
U.S.N.B. - Great Britain United Kingdom England God Save the Queen Himno Nacionales Nationale Hymne National Anthem (User: melons)
The East Pointers - Save Your Lonely (User: melons)
Big Bllakk - Sirenes (User: melons)
Jonny Morgan - Time (User: melons)
Motez - The Future - Purple Disco Machine Remix (User: melons)
Emory Duncan - If It Has To Be Once (User: melons)
Marlene Dietrich - Lili marleen (User: melons)
DJ Licious - Hope (User: melons)
Austin Mackay - Breathe Again (User: melons)
Dead Fish - Queda Livre (User: melons)
Deathcruiser - Night On Fire (User: melons)
Amos Milburn - One Scotch, One Bourbon, One Beer (User: melons)
Phillip LaRue - Desert Rose (User: melons)
Collin Hill - Hallelujah (User: melons)
Cloud House - Wild Eyes (User: melons)
TC Matic - O La La La (User: melons)
Eighty Ninety - The Night Sky (User: melons)
Lovie - Harshmellow (User: melons)
Gully Days - Ay-Oh (User: melons)
El Cabrero - Luz de Luna - Bulerías (User: melons)
Dutch Criminal Record - Light Up (User: melons)
The Covasettes - Plastic Gold (User: melons)
Hiperson - Strawberries (User: melons)
D.L. Hughley - Too Cold (User: melons)
Audio Book Club - She's Too Cool For You (User: melons)
Dominick Maita - Rolling thunders (User: melons)
Mike Edel - love me the same (User: melons)
Reuben - Freddy Kreuger (User: melons)
The Break Plans - Fashionably Late (User: melons)
The Demos - Streetlight Glow (User: melons)
Ambiworld - Earthy Rain With Rolling Thunder (User: melons)
Heaps - Didn't Matter Anyway (User: melons)
Ubuntu Brothers - Summer Daze (User: melons)
modernlove. - Oh My Mind (User: melons)
Breakbot - Baby I'm Yours (User: melons)
Township - Heaven (User: melons)
A.R.D.I. - Lost In The Dark (User: melons)
Astrid Sonne - Withdrawal (User: melons)
Windser - Friends I Barely Know (User: melons)
Joel Lyssarides - As Night Let Down Its Curtain (User: melons)
Creature Canyon - Sleepwalking (User: melons)
Katia Krow - I See Your Picture, It's in the Same Old Frame (User: melons)
Young Decades - She Needs the Pain (User: melons)
･ ･－･ ･－ ･･･ ･ －･･ - ・--・ --- ・ - - ・-・ ・ ・ (User: melons)
Tom Dissevelt - Sonik Re-Entry (User: melons)
Yaporigami - (Respite) (User: melons)
Elephant Motel - Summertime (User: melons)
Nowt - sorrow in the forest (User: melons)
J Colleran - Joye 1:12 (User: melons)
The Brevet - Feels Like (User: melons)
X.Y.R. - Labyrinth Of Reflections (User: melons)
Gamers In Exile - Can We Talk About Girls Now? (User: melons)
Sibling - Animal'a'crossin (User: melons)
Michigander - Stay Out Of It (User: melons)
Phoenix Parker - Stonewall Elementary (User: melons)
No Love in the House of Gold - permafrost (User: melons)
Pisstank - A Small Good Thing (User: melons)
Night Cap - Sentimental (User: melons)
Kyler - Pocherasy Limaf (User: melons)
Dan Powell - Iras (User: melons)
Space Camp - We're Gonna Live Forever (User: melons)
horatio pollard - Elton (User: melons)
No Love in the House of Gold - julia train slow down (User: melons)
MotherFolk - all I need (User: melons)
Kosmischer Läufer - Unterwasser (User: melons)
Gazelle Twin - Fight-or-Flight (User: melons)
Rose Avenue - An Ocean, A River (User: melons)
Line 47 - Ammorex (User: melons)
Aster - Untold (User: melons)
Lost In Japan - Before The Blink (User: melons)
1991 - Reborn Ice Horn (User: melons)
Jagguar - Guessing in a Row (User: melons)
Byelti - forever passing (User: melons)
Document1 - in search of the golden horse (User: melons)
Above Water - After Midnight (User: melons)
Monosleep - world of possibility II (User: melons)
Layer Cake - Hurting (User: melons)
Galen Tipton - Water Fairy Moon (User: melons)
webdriver胴体 - 疑問 (User: melons)
Foreign Air - Hello Sunshine (User: melons)
Jim O'Rourke - Kola Superdeep Borehole (User: melons)
Azusa Plane - Me and Wayne Rogers (User: melons)
Infinity Frequencies - Awaiting the future (User: melons)
Kye Kepler - Weights (User: melons)
Mokira - Flak Bib (User: melons)
7 Miles - Hold On (User: melons)
Glass Rivers - frankie the fish (User: melons)
The Glitch Mob - Bad Wings - Ambient Version (User: melons)
local opener - Love Is in the Way (User: melons)
aeroxone - extraterrestrial orbit (User: melons)
Lone Pines - Boys in LA (User: melons)
The Camera System - Rest (User: melons)
Creature Canyon - Faded Fire (User: melons)
No Love in the House of Gold - wires (User: melons)
Big Sleep - In My Head (User: melons)
Meitei - Sankai (User: melons)
Rum Jungle - Crimson Sunset (User: melons)
1991 - Tangerine Lidl (User: melons)
Skinny Dippers - Home (User: melons)
rees111 - Untitled Nine (User: melons)
the Valla - Strawberry (User: melons)
DISC - where my brap at? (User: melons)
Edgey - Before The Storm (User: melons)
DISC - where my brap at? (User: melons)
Retro City - Just Run (User: melons)
Kid Baltan - Song of the Second Moon - Remastered (User: melons)
Lostboycrow - Libra Moon (User: melons)
Foam and Sand - Circle 2 (User: melons)
Cousin Simple - You Want It You Got It (User: melons)
Julien Neto - Musicbox (User: melons)
Alexis Kings - Sundaze (User: melons)
Mokira - album 3 (User: melons)
Ten Minute Detour - What Can I Do? (User: melons)
Der Zyklus - Optical Fingerprint Correlation (User: melons)
Fat Tulips - Albie (User: melons)
Jacob Ray - never gonna be just friends (User: melons)
Sundress - Gone (User: melons)
Maylove - Russian Fingers, Roman Hand (User: melons)
Fetch Tiger - Time Alone (User: melons)
The Pristines - Touch (User: melons)
Benjamin Carter - Black Boys On The Radio (User: melons)
Slumber - I'll Never Know Another Christmas Day (User: melons)
Coma Culture - In Love (User: melons)
The Proctors - Snow (User: melons)
The Brevet - Wherever We Go (User: melons)
Sugar Plant - Windows Pane (User: melons)
Young Rising Sons - Easy Dreamer (User: melons)
Watercolor Sunset - International Pop Star (User: melons)
String Lights - persephone (User: melons)
Lean - Alive on the Outside (User: melons)
Confetti - Here Again / River Island (User: melons)
Mrs Kipling - Rainy Afternoon (User: melons)
Frantic Memories - Las Vegas (User: melons)
The Sweetest Ache - A New Beginnig (User: melons)
on the farm - On The Farm (User: melons)
Mylo - Sunworshipper (User: melons)
Good Jester - Dial Tones (User: melons)
Massive Attack - Karmacoma (User: melons)
Social Creatures - Seven Years (User: melons)
Morcheeba - Big Calm (User: melons)
Artemas - Waiting For It All To Go Wrong (User: melons)
Colour Tongues - Midnight Island (User: melons)
Thank - Dread (User: melons)
Mike Edel - illusions by the sea (User: melons)
Bonobo - Flutter (User: melons)
tommy p - Afk (User: melons)
Layo & Bushwacka! - Sleepy Language (User: melons)
The Last Morrell - Let Me Down (User: melons)
DAMEFRISØR - 2-HEH-V (User: melons)
Denio - Manpride (User: melons)
FC/Kahuna - Hayling - Radio edit (User: melons)
Lostboycrow - Angelina (User: melons)
Röyksopp - Eple (User: melons)
Caleb Kopta - Forgiveness (User: melons)
Amon Tobin - Nightlife (User: melons)
Talk Time - The Last Time (Heavy) (User: melons)
Squarepusher - My Red Hot Car (User: melons)
Lemony Rug - Out Of Here (User: melons)
Faithless - Spiders, Crocodiles & Kryptonite (User: melons)
Thirty Pills - Turn around (User: melons)
Badmarsh & Shri - Signs (User: melons)
David Nevory - Losing My Mind (User: melons)
Jane's Party - Live Again (User: melons)
Apollo 440 - Electro Glide in Blue (User: melons)
Chavín - Already There (User: melons)
Hang Ten - Hey Laura (User: melons)
Photek - The Hidden Camera (User: melons)
Castells - Low (User: melons)
Mirwais - Disco Science (User: melons)
Pretty. - Gotchu (User: melons)
Nathan Fake - The Sky Was Pink (User: melons)
San Gabriel - Circles (User: melons)
GusGus - Believe (User: melons)
Jonny Morgan - Wired (User: melons)
Lamb - Angelica (User: melons)
POP ETC - Slips Away (User: melons)
Renegade Soundwave - Renegade Soundwave - Leftfield Remix (User: melons)
The Carlines - Saturday Sugar (User: melons)
Peace Orchestra - Who Am I (User: melons)
the light and the dark - Somebody (User: melons)
Talvin Singh - Butterfly (User: melons)
Tyler Brown Williams - Let Forever Begin (User: melons)
Howie B - Take Your Partner by the Hand (User: melons)
Shag Rock - Wild Thing (User: melons)
LTJ Bukem - Watercolours (User: melons)
Mathew Rodriguez - Only Friend (User: melons)
DriveAway - Honest (User: melons)
Propellerheads - Take California - short one (User: melons)
Looper - Mondo '77 (User: melons)
the Valla - Misfits (User: melons)
William Orbit - Water From a Vine Leaf (User: melons)
The Rolling Stones - Wild Horses (User: melons)
Voice of the Beehive - I Say Nothing (User: melons)
The Impressions - I'm So Proud - Single Version (User: melons)
Beats International - Dub Be Good To Me (User: melons)
Joy Division - Disorder - 2007 Remaster (User: melons)
Roxy Music - If There Is Something (User: melons)
Talking Heads - Paper - 2005 Remaster (User: melons)
The Undertones - My Perfect Cousin (User: melons)
Prefab Sprout - W***** (Unreleased by SME - Sony Music UK) (User: melons)
The B-52's - Roam [Edit] (User: melons)
Ryan Pollie - The Shore House (User: melons)
Susanne Sundfør - Darlings (User: melons)
Susanne Sundfør - Accelerate (User: melons)
Mission of Burma - Academy Fight Song (User: melons)
Gil Scott-Heron & Brian Jackson - Angel Dust (User: melons)
Linda Guilala - Mucho Mejor (User: melons)
Depeche Mode - Policy of Truth (User: melons)
Yo La Tengo - Moby Octopad (User: melons)
Wild Beasts - Punk Drunk & Trembling (User: melons)
Snapped Ankles - The Evidence (User: melons)
Girl Ray - Stupid Things (User: melons)
The Phil Jones Experience - Have a Nice Day (User: melons)
Etta James - I'd Rather Go Blind (User: melons)
Supergrass - Za (User: melons)
R.E.M. - Horse to Water (User: melons)
DJ Shadow - Horror Show (User: melons)
Sawtooth - Wildwood (User: melons)
Harry Styles - As It Was (User: melons)
Eden Ahbez - The Wanderer (User: melons)
King Creosote - Leslie (User: melons)
Michael Head - Something Like You (User: melons)
Saint Etienne - Only Love Can Break Your Heart (User: melons)
Paul Williams - You Give A Little Love - From "Bugsy Malone" Original Motion Picture Soundtrack (User: melons)
Elliott Smith - Everything Means Nothing to Me (User: melons)
Elliott Smith - Pictures of Me (User: melons)
Elliott Smith - Between the Bars (User: melons)
Elliott Smith - Sweet Adeline (User: melons)
Butcher Boy - You're Only Crying for Yourself (User: melons)
Françoise Hardy - Comment te dire adieu - remasterisé en 2016 (User: melons)
Darrow Fletcher - What Good Am I Without You (User: melons)
Electric Light Orchestra - Livin' Thing (User: melons)
Devendra Banhart - Will I See You Tonight? (feat. Vashti Bunyan) (User: melons)
Beth Gibbons - Tom The Model (User: melons)
Carole King - You've Got a Friend (User: melons)
Sparklehorse - Heart Of Darkness (User: melons)
Sparklehorse - It's a Wonderful Life (User: melons)
R.E.M. - Gardening at Night (User: melons)
Benjy Ferree - Fear (User: melons)
R.E.M. - Gardening at Night (User: melons)
Aimee Mann - Save Me (User: melons)
Lambchop - Grumpus (User: melons)
Dexys Midnight Runners - Breaking Down the Walls of Heartache - 2010 Remaster (User: melons)
Josef K - Sorry for Laughing - Crepuscule Single Version (User: melons)
The Human Beinz - Nobody But Me (User: melons)
Spoon - The Way We Get By (User: melons)
Sylvan Esso - Could I Be (User: melons)
Wire - I Am The Fly - 2006 Remastered Version (User: melons)
Wings - Nineteen Hundred and Eighty Five - Remastered 2010 (User: melons)
Daedelus - Fair Weather Friends (User: melons)
Ben Folds Five - Underground (User: melons)
Beat Happening - Indian Summer (User: melons)
The Aloof - One Night Stand (7" Version) (User: melons)
Kendrick Lamar - DNA. (User: melons)
The Beatles - There's A Place - Remastered 2009 (User: melons)
Captain Beefheart & His Magic Band - Tropical Hot Dog Night (User: melons)
The Concretes - You Can't Hurry Love (User: melons)
Takako Minekawa - Fantastic Cat (User: melons)
Smokey Robinson & The Miracles - The Tears Of A Clown (User: melons)
The Linda Lindas - Nino (User: melons)
Toots Thielemans - Theme from "Midnight Cowboy" (User: melons)
Sebadoh - Skull - Remastered (User: melons)
The Beatles - Got To Get You Into My Life - Remastered 2009 (User: melons)
Dan Deacon - True Thrush (User: melons)
Manic Street Preachers - Out Of Time (User: melons)
Biz Markie - Just A Friend (User: melons)
Eric B. & Rakim - Microphone Fiend (User: melons)
Tricky - The Only Way (User: melons)
Fat White Family - Tastes Good With The Money (User: melons)
King Curtis - Memphis Soul Stew (User: melons)
Peggy Lee - Is That All There Is? (User: melons)
Mott the Hoople - All the Way from Memphis (User: melons)
Funky 4 + 1 - That's the Joint - Remix (User: melons)
Kavinsky - Nightcall (User: melons)
INXS - Mystify (User: melons)
The Jerichos - Coffee (User: melons)
Jimmy Campbell - Half Baked (User: melons)
This Is the Kit - Hotter Colder (User: melons)
Stephen Chang - Always together (User: melons)
Brian Eno - On Some Faraway Beach (User: melons)
The Millennium - I Just Want to Be Your Friend (User: melons)
Lila Iké - Dinero (User: melons)
Kutiman - Line 4 (User: melons)
Laurent Garnier - Forgotten Thoughts (User: melons)
Rino de Filippi - Insiemistica (User: melons)
Papa M - Plastic Energy Man (User: melons)
Broken Social Scene - Pitter Patter Goes My Heart (User: melons)
The Big Eyes Family Players - Die Nacht (User: melons)
Dan Deacon - True Thrush (User: melons)
The Beach Boys - Let's Go Away For Awhile - Stereo / Remastered (User: melons)
The Rah Band - The Crunch (User: melons)
Air - Modular Mix (User: melons)
Aphex Twin - Avril 14th (User: melons)
Sigur Rós - untitled #3 - Samskeyti (User: melons)
The Movers - Soweto Disco (User: melons)
Mr. Bloe - Groovin' With Mr. Bloe (User: melons)
Calexico - Close Behind (User: melons)
Bobby Ellis - Mr. Ellis Burn Out (User: melons)
Prefuse 73 - Pagina Cinco (User: melons)
Elephant Stone - Sally Go Round the Sun (User: melons)
Super Furry Animals - If You Don't Want Me To Destroy You (User: melons)
Super Furry Animals - Juxtapozed With U (User: melons)
The Lemonheads - Rudderless - Remastered (User: melons)
Teenage Fanclub - Sparky's Dream (User: melons)
The Feelies - Let's Go (User: melons)
McCarthy - An Mp Speaks (User: melons)
The Go-Betweens - Bachelor Kisses (User: melons)
The Lemonheads - Different Drum (User: melons)
The Lemonheads - If I Could Talk I'd Tell You (User: melons)
Broadcast - Colour Me In (User: melons)
The 6ths - As You Turn To Go (User: melons)
Roxy Music - In Every Dream Home a Heartache (User: melons)
Gorky's Zygotic Mynci - Stood on Gold (User: melons)
Belle and Sebastian - The Fox in the Snow (User: melons)
Burt Bacharach - Something Big (User: melons)
Elliott Smith - Between the Bars (User: melons)
Silver Jews - Random Rules (User: melons)
Carly Rae Jepsen - The Loneliest Time (feat. Rufus Wainwright) (User: melons)
Yo La Tengo - My Little Corner of the World (User: melons)
Siouxsie and the Banshees - Happy House (User: melons)
Grant Lee Buffalo - The Hook (User: melons)
Grant Lee Buffalo - Wish You Well (User: melons)
Grant Lee Buffalo - Fuzzy (User: melons)
Grant Lee Buffalo - Jupiter and Teardrop (User: melons)
Grant Lee Buffalo - The Shining Hour (User: melons)
Savage Republic - Andelusia (User: melons)
Shiva Burlesque - At Last Our Flag Has Fallen (User: melons)
Shiva Burlesque - Who Is the Mona Lisa? (User: melons)
The Cure - Never Enough (User: melons)
Carly Rae Jepsen - Run Away with Me (User: melons)
Pet Shop Boys - I Wouldn't Normally Do This Kind of Thing - Beatmasters Mix; 2001 Remaster (User: melons)
Dagny - Backbeat (User: melons)
R.E.M. - Horse to Water (User: melons)
Gang Green - Lie Lie (User: melons)
MisterWives - Best I Can Do (User: melons)
The Beatles - And Your Bird Can Sing - Remastered 2009 (User: melons)
Party Nails - No Pressure (User: melons)
Harry Nilsson - Gotta Get Up (User: melons)
HOLYCHILD - Running Behind (User: melons)
The Concretes - You Can't Hurry Love (User: melons)
Blondfire - Life of the Party (User: melons)
Pat Benatar - Love Is a Battlefield (User: melons)
R.E.M. - Fall On Me - 2011 Remaster (User: melons)
Depeche Mode - Never Let Me Down Again (User: melons)
Pat Benatar - Love Is a Battlefield (User: melons)
Depeche Mode - Never Let Me Down Again (User: melons)
Blondie - Call Me (User: melons)
Billy Ocean - Red Light Spells Danger (User: melons)
Aztec Camera - Somewhere In My Heart (User: melons)
Billy Ocean - Red Light Spells Danger (User: melons)
The Zombies - This Will Be Our Year (User: melons)
Bleachers - Rollercoaster (User: melons)
Scrawl - Your Mother Wants To Know (User: melons)
Bleachers - Rollercoaster (User: melons)
Scrawl - Your Mother Wants To Know (User: melons)
Fickle Friends - Swim (User: melons)
The Goon Sax - Make Time 4 Love (User: melons)
The Goon Sax - Make Time 4 Love (User: melons)
Alex Winston - The Day I Died (User: melons)
Exitmusic - Iowa (User: melons)
Elohim - She Talks Too Much (User: melons)
Buke & Gase - Medulla Oblongata (User: melons)
Stars - From The Night (User: melons)
The Magnetic Fields - Andrew In Drag (User: melons)
Betty Who - Glory Days (User: melons)
CHVRCHES - Bury It (User: melons)
Erasure - Drama! - 2019 - Remaster (User: melons)
Paula Abdul - Straight Up (User: melons)
Pet Shop Boys - What Have I Done to Deserve This? (with Dusty Springfield) - 2018 Remaster (User: melons)
Eurythmics - Sisters Are Doin' It For Themselves - Remastered Version (User: melons)
Martha Reeves & The Vandellas - (Love Is Like A) Heat Wave (User: melons)
La Roux - Sexotheque (User: melons)
Foxygen - San Francisco (User: melons)
Cathedrals - Harlem (User: melons)
Beach House - Take Care (User: melons)
RAC - Can't Forget You (User: melons)
Grimes - Flesh without Blood (User: melons)
Yeah Yeah Yeahs - Spitting Off the Edge of the World (User: melons)
Daisy the Great - Glitter (User: melons)
Dummy - Daffodils (User: melons)
Michael Rother - Katzenmusik 8 (User: melons)
NEU! - Crazy - Single Edit (User: melons)
Brian Eno - Light Arms (User: melons)
Roedelius - Goldregen (User: melons)
PlANK - Landebahn (User: melons)
The Psychotik Tanks - Let's Have a Party (User: melons)
Saint Etienne - You're In A Bad Way (User: melons)
Haircut 100 - Fantastic Day (User: melons)
Nik Kershaw - I Won't Let the Sun Go Down on Me (User: melons)
The Jam - Beat Surrender (User: melons)
Eurythmics - Le Sinestre - Remastered Version (User: melons)
Bananarama - Robert De Niro's Waiting (User: melons)
ABC - The Look Of Love, Pt.1 (User: melons)
Nik Kershaw - Wouldn't It Be Good (User: melons)
Kirsty MacColl - There's A Guy Works Down The Chip Shop Swears He's Elvis (User: melons)
Dexys Midnight Runners - Come On Eileen - Single Edit (User: melons)
Tears for Fears - Shout - 7" Edit (User: melons)
Thompson Twins - Doctor! Doctor! (User: melons)
Jimmy McGriff - Cash Box (User: melons)
