Tom Tom Club - Genius of Love (User: jbwharris)
Lucy Dacus - Hot And Heavy (User: jbwharris)
Dan Wriggins - The Diner (User: jbwharris)
Bon Iver - Beth/Rest (Live at Rock the Garden) (User: jbwharris)
Bloodslide - Pica (User: jbwharris)
beabadoobee - Last Day on Earth (User: jbwharris)
Enumclaw - Cents (User: jbwharris)
Enumclaw - Cinderella (User: jbwharris)
New Order - True Faith (User: jbwharris)
Enumclaw - Fruit Flies (User: jbwharris)
The Strokes - The Adults Are Talking (User: jbwharris)
Enumclaw - Free Drop Billy (User: jbwharris)
Valerie June - Stay (User: jbwharris)
The O'Jays - For the Love of Money (User: jbwharris)
The Avett Brothers - Ain't No Man (User: jbwharris)
Miloe - Change Your Mind (User: jbwharris)
Japanese Breakfast - Be Sweet (User: jbwharris)
Devo - Whip It (User: jbwharris)
Run the Jewels - No Save Point (User: jbwharris)
Noga Erez - Story feat. Rousso (User: jbwharris)
Bully - Milkman (User: jbwharris)
The Raconteurs - Sunday Driver (User: jbwharris)
Billy Bragg & Wilco - California Stars (User: jbwharris)
Middle Kids - Questions (User: jbwharris)
Genesis Owusu - Gold Chains (User: jbwharris)
Future Islands - Seasons (Waiting on You) (User: jbwharris)
CHVRCHES - He Said She Said (User: jbwharris)
This Is the Kit - This is What You Did (User: jbwharris)
The New Basement Tapes - When I Get My Hands On You (User: jbwharris)
Rachel Mazer - Sparrows Wings (User: jbwharris)
Kevin Morby - Don't Underestimate Midwest American Sun (User: jbwharris)
Stone Temple Pilots - Plush (User: jbwharris)
Chris Cornell - Nothing Compares 2 U (User: jbwharris)
Lissie - Nothing Compares 2 U (User: jbwharris)
King Princess - Cheap Queen (User: jbwharris)
k.d. lang - Hallelujah (User: jbwharris)
grandson - Maria (User: jbwharris)
Destroyer - Chinatown (User: jbwharris)
The Charlatans - Sproston Green (User: jbwharris)
Emma Charles - Connecticut (User: jbwharris)
orion sun - Lightning (User: jbwharris)
boy pablo - Hey Girl (User: jbwharris)
Supergrass - Caught by the Fuzz (User: jbwharris)
MAYE - Tú (User: jbwharris)
U2 - The Fly (User: jbwharris)
Phil Good - Float On (User: jbwharris)
Cracker - Minotaur (User: jbwharris)
Dave Matthews & Tim Reynolds - Crash Into Me (User: jbwharris)
Ruby Waters - Difficult (User: jbwharris)
Björk - Human Behaviour (User: jbwharris)
X Ambassadors, K.Flay & grandson - Zen (User: jbwharris)
Jamaican Reggae Cuts - Wicked Game (User: jbwharris)
Unusual Demont - Amber (User: jbwharris)
The Louvin Brothers - Cash On The Barrelhead (User: jbwharris)
The Soup Dragons - I'm Free (12" Extended Mix / Remastered) (User: jbwharris)
The Pogues - Yeah, Yeah, Yeah, Yeah, Yeah (Long Version) (User: jbwharris)
The Clash - This is Radio Clash (User: jbwharris)
Amber Mark - My People (User: jbwharris)
The Postal Service - A Tattered Line of String (User: jbwharris)
Jamie Lidell - What A Shame (RL Grime & Salva Remix) (User: jbwharris)
Prince - Welcome 2 America (User: jbwharris)
Noel Gallagher's High Flying Birds - We're On Our Way Now (User: jbwharris)
Men Without Hats - I Like (User: jbwharris)
U2 - Until the End of the World (User: jbwharris)
Pixies - Where Is My Mind? (User: jbwharris)
The Police - Message in a Bottle (User: jbwharris)
The Killers - All These Things That I've Done (User: jbwharris)
Sloan - Coax Me (User: jbwharris)
The Style Council - Long Hot Summer (User: jbwharris)
Handsome Furs - All we Want, Baby, is Everything (User: jbwharris)
Lucero - Outrun the Moon (User: jbwharris)
Squeeze - Satisfied (User: jbwharris)
Black Country, New Road - Instrumental (User: jbwharris)
Joni Mitchell - That Song About The Midway (User: jbwharris)
Neon Dreams - Sick of Feeling Useless (User: jbwharris)
Beyoncé - Lift Ev’ry Voice and Sing (Homecoming Live) (User: jbwharris)
Ya Tseen - Knives (feat. Portugal. The Man) (User: jbwharris)
Brooks Williams - Lizard Logic (User: jbwharris)
The Pigeon Detectives - I Found Out (User: jbwharris)
Garbage - Empty (User: jbwharris)
Kings of Leon - Claire & Eddie (User: jbwharris)
Tamar Aphek - Crossbow (User: jbwharris)
Django Django - Right The Wrongs (User: jbwharris)
Ted Leo and the Pharmacists - Me and Mia (User: jbwharris)
The Lemonheads - If I Could Talk I'd Tell You (User: jbwharris)
Linkin Park - Numb (User: jbwharris)
The Police - It's Alright For You (User: jbwharris)
Patti Smith - Dancing Barefoot (User: jbwharris)
Los Lobos - One Time One Night (User: jbwharris)
Blood Orange - Charcoal Baby (User: jbwharris)
Tom Waits - Hang on St. Christopher (User: jbwharris)
Steve Forbert - It Isn't Gonna Be That Way (User: jbwharris)
Rhiannon Giddens - Calling Me Home (with Francesco Turrisi) (User: jbwharris)
U2 - Mysterious Ways (User: jbwharris)
The Shins - Phantom Limb (User: jbwharris)
Elliott Smith - Waltz #2 (XO) (User: jbwharris)
Floetry - Floetic (User: jbwharris)
Meat Loaf - I'd Do Anything for Love (But I Won't Do That) ["Single Edit"] (User: jbwharris)
The Go! Team - The Power Is On (User: jbwharris)
Soundgarden - Hunted Down (User: jbwharris)
EOB - Shangri-La (User: jbwharris)
Counting Crows - Mr. Jones (User: jbwharris)
Deee-Lite - Groove Is in the Heart (User: jbwharris)
Sugar - Your Favorite Thing (User: jbwharris)
Trampled by Turtles - Separate (User: jbwharris)
Marvin Gaye - Got to Give It Up, Pt. 1 (User: jbwharris)
Ryan Hemsworth - Hurt Me (User: jbwharris)
Sleater-Kinney - One Beat (User: jbwharris)
Oasis - Rock 'N' Roll Star (User: jbwharris)
Spin Doctors - Two Princes (User: jbwharris)
Living Colour - Leave It Alone (User: jbwharris)
Foo Fighters - Learn to Fly (User: jbwharris)
Waxahatchee - Can’t Do Much (User: jbwharris)
Spoon - Got Nuffin (User: jbwharris)
Billy Bragg - A New England (User: jbwharris)
SBTRKT - 2020 (User: jbwharris)
Chet Faker - Low (User: jbwharris)
Janet Jackson - Rhythm Nation (User: jbwharris)
Dead or Alive - You Spin Me Round (Like a Record) [Re-Recorded] (User: jbwharris)
Broadcast - Lunch Hour Pops (User: jbwharris)
Bobby Lewis - Nothing but the Blues (User: jbwharris)
Ron Gallo - Young Lady, You're Scaring Me (User: jbwharris)
Thomas Azier - Metropolitan Tribe (User: jbwharris)
Suzanne Vega - Left of Center (feat. Joe Jackson) [From "Pretty In Pink" Soundtrack] (User: jbwharris)
Sonny & Cher - It's Gonna Rain (User: jbwharris)
Nathaniel Rateliff & the Night Sweats - Howling At Nothing (User: jbwharris)
Low Cut Connie - Revolution Rock n Roll (User: jbwharris)
Brian Eno & David Byrne - The Jezebel Spirit (User: jbwharris)
Recess Monkey - Messy Nessie (User: jbwharris)
Radiohead - Creep (User: jbwharris)
Dire Straits - Industrial Disease (User: jbwharris)
Turn Turn Turn - Papercut (User: jbwharris)
Guana Batz - The Cave (User: jbwharris)
Sharon Jones & The Dap-Kings - How Long Do I Have To Wait For You? (User: jbwharris)
Madcon - Don't Worry (feat. Ray Dalton) (User: jbwharris)
Toro y Moi - Ordinary Pleasure (User: jbwharris)
The Dead Milkmen - Punk Rock Girl (User: jbwharris)
The Cars - You're All I've Got Tonight (User: jbwharris)
Rilo Kiley - Does He Love You? (User: jbwharris)
Joe Tex - Hold What You've Got (User: jbwharris)
Father John Misty - Hollywood Forever Cemetery Sings (User: jbwharris)
Mirabelle - Phénomène (User: jbwharris)
Bruno Mars, Anderson .Paak & Silk Sonic - Leave The Door Open (User: jbwharris)
Israel Nash - Canyonheart (User: jbwharris)
Jamiroquai - Canned Heat (User: jbwharris)
Shawn James - The Curse of the Fold (User: jbwharris)
Loretta Lynn - The Pill (User: jbwharris)
Bakar - Hell N Back (User: jbwharris)
Emma Donovan & The PutBacks - Yarian Mitji (User: jbwharris)
Me First and the Gimme Gimmes - Rainbow Connection (User: jbwharris)
Shlohmo - The Way U Do (User: jbwharris)
Tom Chapin - The Picnic of the World (User: jbwharris)
Zwicker - Who You Are (feat. Heidi Happy) (User: jbwharris)
pg.lost - Weaver (User: jbwharris)
my bloody valentine - When You Sleep (User: jbwharris)
Loretta Lynn - One's on the Way (feat. Margo Price) (User: jbwharris)
The Staves - Satisfied (User: jbwharris)
The Joy Formidable - Into The Blue (User: jbwharris)
Black Pumas - Strangers feat. Lucius (User: jbwharris)
Jon Batiste - I NEED YOU (User: jbwharris)
Wolf Alice - The Last Man on Earth (User: jbwharris)
Manchester Orchestra - Bed Head (User: jbwharris)
Cherry Glazerr - Rabbit Hole (User: jbwharris)
Lord Huron - Not Dead Yet (User: jbwharris)
Jose Gonzalez - El Invento (User: jbwharris)
Django Django - Glowing in the Dark (User: jbwharris)
Flock of Dimes - Two (User: jbwharris)
Kings of Leon - The Bandit (User: jbwharris)
Lucero - Back in Ohio (User: jbwharris)
Yuna - Dance Like Nobody's Watching (User: jbwharris)
TV Priest - This Island (User: jbwharris)
Tune-Yards - hold yourself (User: jbwharris)
Jazmine Sullivan - Pick Up Your Feelings (User: jbwharris)
Tamar Aphek - Crossbow (User: jbwharris)
Phoenix - Identical (User: jbwharris)
The Jam - Strange Town (User: jbwharris)
Noga Erez - Story feat. Rousso (User: jbwharris)
Lake Street Dive - Hypotheticals (User: jbwharris)
Gorillaz - Strange Timez feat. Robert Smith (User: jbwharris)
The Rentals - Friends of P. (User: jbwharris)
The Hold Steady - Heavy Covenant (User: jbwharris)
Bob Dylan - All I Really Want to Do (User: jbwharris)
Valerie June - Stay (User: jbwharris)
Sylvan Esso - Kick Jump Twist (User: jbwharris)
Two Door Cinema Club - What You Know (User: jbwharris)
Tamia - Into You (User: jbwharris)
Jungle - Keep Moving (User: jbwharris)
Sunflower Bean - Crisis Fest (User: jbwharris)
Sault - I Just Want to Dance (User: jbwharris)
Mariah Carey - Honey (User: jbwharris)
The Coral - Sandhills (Lockdown Sessions) (User: jbwharris)
Tom Grennan - Little Bit of Love (Welshy Remix) (User: jbwharris)
Bill Evans - Soiree (User: jbwharris)
The Little Willies - Roll On (User: jbwharris)
LCD Soundsystem - Get Innocuous! (User: jbwharris)
Ty Segall - Orange Color Queen (User: jbwharris)
Jealous of the Birds - Pendulum (User: jbwharris)
Rhett Miller - Wreck Of The Old 97 (User: jbwharris)
LVNDSCAPE - In My Mind (feat. Mi Manchi) (User: jbwharris)
Queen - Somebody to Love (User: jbwharris)
Tirzah - Holding On (User: jbwharris)
Donnie Trumpet & The Social Experiment - Sunday Candy (User: jbwharris)
The Waterboys - The Whole of the Moon (2004 Remaster) (User: jbwharris)
Adam Ant - Room At The Top (User: jbwharris)
Sebadoh - Soul and Fire (User: jbwharris)
Bonobo - Cirrus (User: jbwharris)
Wilco - I'll Fight (User: jbwharris)
Scarlett Johansson - I Don't Wanna Grow Up (User: jbwharris)
The Highwomen - The Chain (From the Motion Picture Soundtrack "The Kitchen") (User: jbwharris)
A Tribe Called Quest - We The People.... (User: jbwharris)
Mr. Scruff - Get a Move On! (User: jbwharris)
Mike Williams - Don't Hurt (feat. Brezy) (User: jbwharris)
Memory Tapes - Offers (User: jbwharris)
Maggie Lindemann - Crash and Burn (User: jbwharris)
Belle and Sebastian - White Collar Boy (User: jbwharris)
Ray Charles - Hit the Road Jack (feat. The Raelets) (User: jbwharris)
Jack Pearson - Googolplex (User: jbwharris)
World Party - Way Down Now (User: jbwharris)
Phantogram - Fall in Love (User: jbwharris)
The World Is a Beautiful Place & I Am No Longer Afraid to Die - In Circles (User: jbwharris)
Shawn Colvin - Every Little Thing (He) Does Is Magic (User: jbwharris)
Joshua Speers - Bad Night (Acoustic) (User: jbwharris)
Royal Blood - Little Monster (User: jbwharris)
The Lowest of the Low - A Casual Overdose (User: jbwharris)
Jonas Bonnetta - Little Seldom (User: jbwharris)
Marshmello & Bastille - Happier (Stripped) (User: jbwharris)
The Cranberries - Zombie (User: jbwharris)
Pulp - Common People (full length version) (User: jbwharris)
Andrew Bird - Eyeoneye (User: jbwharris)
Diamond Ortiz - (We Go Together Like) Saturday & Sunday (User: jbwharris)
Elujay - Starchild (User: jbwharris)
Flwr Chyld - Walking Away (User: jbwharris)
Stone Sour - Through Glass (live acoustic) (User: jbwharris)
Savoir Adore - Body Heat (User: jbwharris)
Beyries - To Love Somebody (User: jbwharris)
Lynyrd Skynyrd - Simple Man (User: jbwharris)
Emanuel - Magazines (User: jbwharris)
Strand of Oaks - Radio Kids (User: jbwharris)
Punch Brothers - Kid A (User: jbwharris)
Genesis Owusu - Gold Chains (User: jbwharris)
Sloan - Can't Face Up (User: jbwharris)
Jason Isbell and The 400 Unit - Only Children (User: jbwharris)
Belle and Sebastian - I'm a Cuckoo (User: jbwharris)
The Pretenders - Mystery Achievement (User: jbwharris)
The Smashing Pumpkins - 1979 (User: jbwharris)
Jaunt - Obvious Answer (User: jbwharris)
Sudan Archives - Confessions (User: jbwharris)
Francis Dunnery - Too Much Saturn (User: jbwharris)
KennyHoopla - how will i rest in peace if i'm buried by a highway?// (User: jbwharris)
Fleetwood Mac - Oh Well, Pt. 1 (User: jbwharris)
The Kills - Doing It To Death (User: jbwharris)
Weezer - The Good Life (User: jbwharris)
Amy Shark - Don't Turn Around (User: jbwharris)
Duke Hugh - Common Ground (feat. Renato Paris) (User: jbwharris)
Richard Thompson - Oops! I Did It Again (User: jbwharris)
Jason Derulo - Want To Want Me (User: jbwharris)
Jonathan Richman & The Modern Lovers - Roadrunner (User: jbwharris)
Naughty By Nature - O.P.P. (Re-recorded Version) (User: jbwharris)
The Cars - Bye Bye Love (User: jbwharris)
The Amboy Dukes - Journey to the Center of the Mind (User: jbwharris)
TV Priest - This Island (User: jbwharris)
Pretty Lights - We Must Go On (User: jbwharris)
Jim Cosgrove - Cookie Time (User: jbwharris)
Omi - Cheerleader (Felix Jaehn Remix) (User: jbwharris)
Bootsauce - Everyone's A Winner (Remix) (User: jbwharris)
Rani Arbo & Daisy Mayhem - The Green Grass Grows All Around (User: jbwharris)
Hawksley Workman - We Will Still Need a Song (User: jbwharris)
Bartees Strange - Mustang (User: jbwharris)
Doyle Lawson & Quicksilver - On The Sea Of Life (User: jbwharris)
Saba - LOGOUT (feat. Chance the Rapper) (User: jbwharris)
Shania Twain - Man! I Feel Like a Woman! (User: jbwharris)
Talking Heads - Once in a Lifetime (User: jbwharris)
Aretha Franklin - I Never Loved a Man (the Way I Love You) (User: jbwharris)
Siv Jakobsen - How We Used To Love (User: jbwharris)
Flume - Sleepless (feat. Jezzabell Doran) (User: jbwharris)
Death - You're A Prisoner (User: jbwharris)
U2 - Ultra Violet (Light My Way) (User: jbwharris)
Bad Bad Hats - Shame (User: jbwharris)
PJ Harvey - You Said Something (User: jbwharris)
Jake Bugg - Two Fingers (User: jbwharris)
Tom Petty & The Heartbreakers - Learning to Fly (User: jbwharris)
DJ Mehdi - Signatune (Thomas Bangalter edit) (User: jbwharris)
Garbage - I Think I'm Paranoid (User: jbwharris)
Clubhouse - Weekend (User: jbwharris)
Buddy Holly - Rave On (User: jbwharris)
Cherry Poppin' Daddies - Zoot Suit Riot (User: jbwharris)
Wolf Alice - The Last Man on Earth (User: jbwharris)
Paul Metsa - You Can't Be Brave (If You're Not Scared) (User: jbwharris)
Two of a Kind - One World, Many Stories (User: jbwharris)
The Lemonheads - Mrs. Robinson (User: jbwharris)
Dezron Douglas & Brandee Younger - This Woman's Work (User: jbwharris)
Little Richard - Long Tall Sally (The Thing) (User: jbwharris)
Sam Roberts - Fixed To Ruin (User: jbwharris)
Said the Whale - Honey Lungs (User: jbwharris)
Caveman - Helpless (User: jbwharris)
Koko Taylor - Wang Dang Doodle (User: jbwharris)
Paul McCartney & Beck - Find My Way (User: jbwharris)
Born Ruffians - Fade to Black (User: jbwharris)
Jagwar Ma - Uncertainty (User: jbwharris)
The Verve - The Drugs Don't Work (User: jbwharris)
Boards of Canada - Cold Earth (User: jbwharris)
The Cranberries - Dreams (User: jbwharris)
White Reaper - Real Long Time (User: jbwharris)
The Zephyr Bones - HURRICANES (User: jbwharris)
Sufjan Stevens - Holland (User: jbwharris)
Todd Snider - Turn Me Loose (I'll Never Be the Same) (User: jbwharris)
Stevie Wonder - We Can Work It Out (User: jbwharris)
Bobby Darin - Splish Splash (User: jbwharris)
The Romantics - What I Like About You (User: jbwharris)
Michelle - FYO (User: jbwharris)
Katrina and the Waves - Walking on Sunshine (2004 Version) (User: jbwharris)
Kings of Leon - Wait for Me (User: jbwharris)
The J. Geils Band - Looking for a Love (User: jbwharris)
Turn Turn Turn - Cold Hard Truth (User: jbwharris)
Jack Johnson - Taylor (User: jbwharris)
Deathray - Wild As I Wanna Be (User: jbwharris)
The Chicks - Not Ready to Make Nice (User: jbwharris)
Silly Bus - History Hip Hop (User: jbwharris)
Christine and the Queens - I disappear in your arms (User: jbwharris)
Donovan Woods - Whatever Keeps You Going - Children's Choir (feat. J.P. Robarts P.S. Music Project) (User: jbwharris)
Nancy Sinatra - TONIGHT YOU BELONG TO ME (User: jbwharris)
Sex Pistols - God Save the Queen (User: jbwharris)
Charley Crockett - Midnight Run (User: jbwharris)
James Brown & The Famous Flames - I Got You (I Feel Good) (User: jbwharris)
Brave Shores - More Like You (User: jbwharris)
Glass Animals - Your Love (Déjà Vu) (User: jbwharris)
Northside - Take Five (User: jbwharris)
The Smiths - William, It Was Really Nothing (User: jbwharris)
Flume - Holdin On (User: jbwharris)
Cibo Matto - We Love Our Lawyers (User: jbwharris)
Devo - Through Being Cool (User: jbwharris)
Lana Del Rey - Chemtrails Over the Country Club (User: jbwharris)
Leon Bridges - If It Feels Good (Then It Must Be) (User: jbwharris)
Hayley Williams - My Limb (User: jbwharris)
Belle and Sebastian - I'm a Cuckoo (User: jbwharris)
Gary Clark Jr. - Pearl Cadillac (User: jbwharris)
Black Eyed Peas - Hey Mama (User: jbwharris)
Sly & The Family Stone - Dance to the Music (User: jbwharris)
Andrew St James - Stageline (User: jbwharris)
Tina and the B-Sides - in my own time (User: jbwharris)
Taylor Swift - Fearless (User: jbwharris)
The Birthday Party - Release the Bats (User: jbwharris)
A Tribe Called Quest - Can I Kick It? (User: jbwharris)
OutKast - Hey Ya! (User: jbwharris)
Travis Linville - I'm Still Here (User: jbwharris)
Lizzo - Worship (User: jbwharris)
Smash Mouth - Why Can't We Be Friends (User: jbwharris)
Sufjan Stevens - Come on! Feel the Illinoise! (User: jbwharris)
Cabaret Voltaire - Sensoria (User: jbwharris)
Against Me! - Full Sesh (User: jbwharris)
Kim Gordon - Sketch Artist (User: jbwharris)
Black Pumas - Colors (User: jbwharris)
Public Enemy - Bring the Noise (User: jbwharris)
Elvis Costello - Brilliant Mistake (User: jbwharris)
Red Hot Chili Peppers - Breaking the Girl (User: jbwharris)
Deerhunter - Breaker (User: jbwharris)
Brigitte Bardot & Serge Gainsbourg - Bonnie and Clyde (User: jbwharris)
Dessa - Bombs Away (User: jbwharris)
The Jesus and Mary Chain - Blues From a Gun (User: jbwharris)
New Order - Blue Monday (User: jbwharris)
Sinéad O'Connor - John I Love You (User: jbwharris)
The Strypes - Blue Collar Jane (User: jbwharris)
Beth Orton - Blood Red River (User: jbwharris)
BLOOD $MOKE BODY - Black Velvet (User: jbwharris)
Baauer - HOME (feat. Bipolar Sunshine) (User: jbwharris)
Weather Report - Black Market (User: jbwharris)
Citizen - Black and Red (User: jbwharris)
New Order - Bizarre Love Triangle '94 (User: jbwharris)
Shovels & Rope - Birmingham (User: jbwharris)
Jenny Lewis with The Watson Twins - The Big Guns (User: jbwharris)
Built to Spill - Big Dipper (User: jbwharris)
My Morning Jacket - Big Decisions (User: jbwharris)
Fontaines D.C. - Big (User: jbwharris)
Tufts Beelzebubs - Better Days/Where It's At (User: jbwharris)
The Emotions - Best of My Love (User: jbwharris)
Groj - Bereth En Eithel (Original Mix) (User: jbwharris)
OutKast - Behold a Lady (User: jbwharris)
Purity Ring - begin again (User: jbwharris)
Bettye LaVette - Before The Money Came (The Battle Of Bettye LaVette) (User: jbwharris)
Bettye LaVette - Before The Money Came (The Battle Of Bettye LaVette) (User: jbwharris)
Michael Vest - Beautiful People (User: jbwharris)
T. Rex - Bang a Gong (Get It On) (User: jbwharris)
Dan Deacon - Baltihorse (User: jbwharris)
Horsegirl - Ballroom Dance Scene (User: jbwharris)
XTC - The Ballad of Peter Pumpkinhead (User: jbwharris)
Leon Bridges - Bad Bad News (User: jbwharris)
Love Cult - Backslide (User: jbwharris)
AC/DC - Back in Black (User: jbwharris)
Do Make Say Think - Auberge Le Mouton Noir (User: jbwharris)
Bon Iver - AUATC (User: jbwharris)
Billy Bragg & Wilco - At My Window Sad and Lonely (User: jbwharris)
David Bowie - Ashes to Ashes (User: jbwharris)
Kings of Leon - Around the World (User: jbwharris)
Babes in Toyland - Ariel (User: jbwharris)
James Monroe Iglehart & The Original Broadway Cast of Aladdin - Arabian Nights (User: jbwharris)
Dylan Cartlidge - Anything Could Happen (User: jbwharris)
They Might Be Giants - Ana Ng (User: jbwharris)
Zephaniah OHora - All American Singer (User: jbwharris)
Sly & The Family Stone - Advice (User: jbwharris)
Lannds - O.O.W (User: jbwharris)
Glass Beach - calico (User: jbwharris)
David Bromberg - Kansas City (User: jbwharris)
Pearls Before Swine - Another Time (User: jbwharris)
Samia - Triptych (User: jbwharris)
Laura Marling - Next Time (User: jbwharris)
Disq - Daily Routine (User: jbwharris)
Bee Gees - You'll Never See My Face Again (User: jbwharris)
George Harrison - Mama You've Been On My Mind (User: jbwharris)
Yeah Yeah Yeahs - Heads Will Roll (A-Trak Remix) (User: jbwharris)
Glass Beach - calico (User: jbwharris)
Ramones - I Wanna Be Your Boyfriend (User: jbwharris)
Mamalarky - Schism Trek (User: jbwharris)
Anti-Flag - Brandenburg Gate (User: jbwharris)
The Interrupters - Gave You Everything (User: jbwharris)
Oh Brother - I'm a Nice Guy (User: jbwharris)
Jason Derulo - Take You Dancing (User: jbwharris)
The Cooltrane Quartet - White Flag (User: jbwharris)
Houndmouth - Sedona (User: jbwharris)
Chris Isaak - Wicked Game (User: jbwharris)
Travis - Where Is The Love (User: jbwharris)
The Jayhawks - Sister Cry (User: jbwharris)
The Hold Steady - Chicago Seemed Tired Last Night (User: jbwharris)
Barbara Lynn - I’m A Good Woman (User: jbwharris)
The Chapin Sisters - Toxic (User: jbwharris)
Choices Made - Sideroads (User: jbwharris)
Joel Levi - Light in the Neon Sign (User: jbwharris)
Shane Leonard - Empire Builder (User: jbwharris)
Briston Maroney - Freakin' Out on the Interstate (User: jbwharris)
Daughter - Landfill (User: jbwharris)
Q - Take Me Where Your Heart Is (User: jbwharris)
Bedtime Beats - Green Steps (User: jbwharris)
Mark Ronson featuring Amy Winehouse - Valerie (feat. Amy Winehouse) (User: jbwharris)
grandson - Dirty (User: jbwharris)
Riela - yourplace (User: jbwharris)
Hop Along - How Simple (User: jbwharris)
Sea Wolf - You're A Wolf (User: jbwharris)
Viola Beach - Boys That Sing (User: jbwharris)
Live - Lightning Crashes (User: jbwharris)
Lisa Loeb - Stay (I Missed You) (User: jbwharris)
Shoffy - I'll Be Home Soon (User: jbwharris)
Beck - Dreams (User: jbwharris)
Del Amitri - Roll to Me (User: jbwharris)
Faith Boblett - Didn't Want You (User: jbwharris)
BANKS - Drowning (User: jbwharris)
Leon Bridges - Forgive You (User: jbwharris)
Tal Bachman - She's So High (User: jbwharris)
Frana - Herpes Zoroaster (User: jbwharris)
Lorde - The Louvre (User: jbwharris)
RPA & The United Nations of Sound - Royal Highness (User: jbwharris)
Muzz - Bad Feeling (User: jbwharris)
Sam Carlson - Leave Me Alone (User: jbwharris)
Sinai Vessel - Shameplant (User: jbwharris)
Gus Dapperton - I'm On Fire (User: jbwharris)
The Trews - God Speed Rebel (User: jbwharris)
Sneaker Pimps - 6 Underground (User: jbwharris)
Matchbox Twenty - Never Going Back Again (User: jbwharris)
The Runaways - Cherry Bomb (User: jbwharris)
Dinosaur Jr. - Feel the Pain (User: jbwharris)
Tom Petty - Zombie Zoo (User: jbwharris)
The KLF - 3 A.M. Eternal (Radio Freedom edit) (User: jbwharris)
Carole King - You've Got a Friend (User: jbwharris)
Coldplay - Champion of the World (Reimagined) (User: jbwharris)
Gus Dapperton - I'm On Fire (User: jbwharris)
Classixx & Local Natives - Weekends (User: jbwharris)
The Brit Box - Pearl (User: jbwharris)
Charly Bliss - Chatroom (User: jbwharris)
Kurt Vile - Wakin On A Pretty Day (User: jbwharris)
Real Estate - Paper Cup (feat. Sylvan Esso) (User: jbwharris)
New Order - Bizarre Love Triangle (User: jbwharris)
Blur - Girls & Boys (User: jbwharris)
The Champs - Tequila (User: jbwharris)
Gnarls Barkley - Gone Daddy Gone (User: jbwharris)
The Isley Brothers - Shout (User: jbwharris)
Jason Derülo - Want to Want Me (User: jbwharris)
Jamiroquai - Canned Heat (User: jbwharris)
Teddybears - SunShine (User: jbwharris)
Shame - Water In The Well (User: jbwharris)
Live Society - Carry Me Back (User: jbwharris)
Controller.Controller - Heavy As A Heart (User: jbwharris)
Bleach Lab - Never Be (User: jbwharris)
The Polyphonic Spree - Lithium (User: jbwharris)
Jukebox the Ghost - I Love You Always Forever (User: jbwharris)
Nick Lowe - A Quiet Place (User: jbwharris)
Phoenix - Identical (From the Motion Picture "On the Rocks") (User: jbwharris)
Spoon - I Summon You (User: jbwharris)
Sawyer Fredericks - Should've Known Better (User: jbwharris)
Blue Swede - Hooked on a Feeling (User: jbwharris)
Franz Ferdinand - Take Me Out (User: jbwharris)
Cherry Poppin' Daddies - Zoot Suit Riot (User: jbwharris)
The Proclaimers - I'm Gonna Be (500 Miles) (User: jbwharris)
Katrina and the Waves - Walking on Sunshine (User: jbwharris)
Buddy Holly - Rave On (User: jbwharris)
The Strokes - Last Nite (User: jbwharris)
La Roux - Bulletproof (User: jbwharris)
Omi - Cheerleader (Felix Jaehn Remix) (User: jbwharris)
Elvis Presley vs. Junkie XL - A Little Less Conversation (User: jbwharris)
Mr. Scruff - Get a Move On (User: jbwharris)
Violent Femmes - Blister In The Sun (User: jbwharris)
Jack Peñate - Torn on the Platform (User: jbwharris)
Kool & The Gang - Celebration (User: jbwharris)
Len - Steal My Sunshine (User: jbwharris)
Ray Charles - Hit the Road Jack (User: jbwharris)
DJ Shadow - Reconstruction (Medley) (User: jbwharris)
Black Eyed Peas - Hey Mama (User: jbwharris)
The Soup Dragons - I'm Free (User: jbwharris)
OutKast - Hey Ya! (User: jbwharris)
Talking Heads - Burning Down the House (User: jbwharris)
Tone Lōc - Funky Cold Medina (User: jbwharris)
Stray Cats - Rock This Town (User: jbwharris)
U2 - Beautiful Day (User: jbwharris)
Gorillaz - Feel Good Inc. (User: jbwharris)
Walk the Moon - Shut Up and Dance (User: jbwharris)
KC and The Sunshine Band - (Shake, Shake, Shake) Shake Your Booty (User: jbwharris)
Maroon 5 feat. Christina Aguilera - Moves Like Jagger (User: jbwharris)
Madonna - Holiday (User: jbwharris)
James Brown - I Got You (I Feel Good) (User: jbwharris)
New Order - Bizarre Love Triangle (User: jbwharris)
Jerry Lee Lewis - Great Balls of Fire (User: jbwharris)
Ramones - Blitzkrieg Bop (User: jbwharris)
Teddybears - SunShine (User: jbwharris)
The Emotions - Best of My Love (User: jbwharris)
The Isley Brothers - Shout (User: jbwharris)
The B-52's - Love Shack (User: jbwharris)
Jamiroquai - Canned Heat (User: jbwharris)
Weezer - Buddy Holly (User: jbwharris)
The Police - It's Alright For You (User: jbwharris)
David Bowie - Suffragette City (User: jbwharris)
Smash Mouth - Why Can't We Be Friends (User: jbwharris)
The Black Keys - Lonely Boy (User: jbwharris)
Fatboy Slim - Praise You (User: jbwharris)
Marvin Gaye - Got To Give It Up (Part 1) (User: jbwharris)
Jason Derülo - Want to Want Me (User: jbwharris)
The Fratellis - Chelsea Dagger (User: jbwharris)
Little Richard - Long Tall Sally (User: jbwharris)
Locksley - The Whip (User: jbwharris)
KT Tunstall - Suddenly I See (User: jbwharris)
James - Curse Curse (User: jbwharris)
Happy Mondays - Step On (User: jbwharris)
Michael Jackson - Don't Stop 'Til You Get Enough (User: jbwharris)
Daft Punk - One More Time (User: jbwharris)
The Knack - My Sharona (User: jbwharris)
Arctic Monkeys - I Bet You Look Good on the Dancefloor (User: jbwharris)
Young M.C. - Bust a Move (User: jbwharris)
Paul Anka - Wonderwall (User: jbwharris)
Dead or Alive - You Spin Me Round Like A Record (User: jbwharris)
MC Hammer - U Can't Touch This (User: jbwharris)
Madcon feat. Ray Dalton - Don't Worry (User: jbwharris)
T. Rex - Bang a Gong (Get It On) (User: jbwharris)
Deee-Lite - Groove Is in the Heart (User: jbwharris)
Stealers Wheel - Stuck in the Middle With You (User: jbwharris)
The Romantics - What I Like About You (User: jbwharris)
Ozzy Osbourne - Crazy Train (User: jbwharris)
Lynyrd Skynyrd - Simple Man (User: jbwharris)
Rani Arbo & Daisy Mayhem - The Green Grass Grows All Around (User: jbwharris)
Tom Chapin - The Picknic of the World (User: jbwharris)
Snow White - With a Smile and a Song (User: jbwharris)
Recess Monkey - Messy Nessie (User: jbwharris)
David Bowie - Magic Dance (User: jbwharris)
Bobby Darin - Splish Splash (User: jbwharris)
Alan Menken - Colors of the Wind (User: jbwharris)
Silly Bus - History Hip Hop (User: jbwharris)
Two of a Kind - One World, Many Stories (User: jbwharris)
Jack Pearson - Googolplex (User: jbwharris)
Jim Cosgrove - Cookie Time (User: jbwharris)
Aladdin - Arabian Nights (User: jbwharris)
Junie B. Jones Cast - You Can Be My Friend (User: jbwharris)
Luther Vandross - If I Had A Hammer (User: jbwharris)
Sawyer Fredericks - Should've Known Better (User: jbwharris)
Tom Boy - Young & Sad (User: jbwharris)
Red Robyn - Got Me (feat. The World of Birds) (User: jbwharris)
Electric Light Orchestra - Strange Magic (User: jbwharris)
Little Dragon - Ritual Union (User: jbwharris)
Lana Del Rey - Wild at Heart (User: jbwharris)
Best Coast - For The First Time (User: jbwharris)
Tracey Hewat - Candle in the Wind (User: jbwharris)
Mystic Braves - Desert Island (User: jbwharris)
Moon Taxi - Restless (User: jbwharris)
Rufus Wainwright - Peaceful Afternoon (User: jbwharris)
Deerhunter - Plains (User: jbwharris)
The Pastels - Nothing To Be Done (User: jbwharris)
King Gizzard & The Lizard Wizard - Trapdoor (User: jbwharris)
Neil Young - Oh, Lonesome Me (User: jbwharris)
Jamie Lidell - Multiply (User: jbwharris)
Young the Giant - Something To Believe In (User: jbwharris)
Embrace - The Shots Still Ringing (User: jbwharris)
Cracker - Where Have Those Days Gone (User: jbwharris)
nathan bajar - Devil Girl (User: jbwharris)
Arlo Parks - Cola (User: jbwharris)
Julia Church - Japan (User: jbwharris)
Jazzystics, Dinah Eastwood & Francoise Sanders - Sleeping Satellite (User: jbwharris)
salami rose joe louis - We’re Dumb (User: jbwharris)
Dolly Parton - I Will Always Love You (User: jbwharris)
Lowell - God Is A Fascist (User: jbwharris)
Spanish Love Songs - Beach Front Property (User: jbwharris)
Son Little - hey rose (User: jbwharris)
Solange - Cranes in the Sky (User: jbwharris)
Paul Simon - Me and Julio Down by the Schoolyard (User: jbwharris)
Shy Harry - Never Let Me Fall Away (User: jbwharris)
Matt Maeson - Hallucinogenics (Stripped) (User: jbwharris)
Devin Morrison & Fitz Ambro$e - Tommy Strong (User: jbwharris)
John Vanderslice - Dear Sarah Shu (User: jbwharris)
Black Grape - Reverend Black Grape (User: jbwharris)
Jean Deaux - Energy (User: jbwharris)
Metric - Gimme Sympathy (User: jbwharris)
beabadoobee - Care (User: jbwharris)
Ludwig Göransson - Killmonger (User: jbwharris)
Michael Jackson - The Girl Is Mine (User: jbwharris)
L'Isle - Like a Virgin (User: jbwharris)
XTC - Dear God (User: jbwharris)
Firedrill! - Easy Lover (User: jbwharris)
Ocean Pleasant - Party Trick (User: jbwharris)
Sault - Why We Cry Why We Die (User: jbwharris)
STEVAN - She Goes (User: jbwharris)
The Flys - Got You (Where I Want You) (User: jbwharris)
Half Moon Run - Undercurrents (feat. Dylan Phillips) [Extended Isolation Version] (User: jbwharris)
Highly Suspect & Terrible Johnny - These Days (User: jbwharris)
Catherine Wheel - I Want To Touch You (User: jbwharris)
Ólafur Arnalds - Say My Name (feat. Arnór Dan) (User: jbwharris)
This Will Destroy You - Burial on the Presidio Banks (User: jbwharris)
2 Unlimited - Get Ready For This (User: jbwharris)
Local Natives - When Am I Gonna Lose You (User: jbwharris)
Leonard Cohen - Chelsea Hotel (User: jbwharris)
Frou Frou - Let Go (User: jbwharris)
The Kooks - Naïve (User: jbwharris)
Pixies - Velouria (User: jbwharris)
Wild Nothing - Chinatown (User: jbwharris)
Year of Summers - Harder Softer Always (feat. Radio Trapani) (User: jbwharris)
The Dandy Warhols - Godless (User: jbwharris)
David Bowie - "Heroes" (2017 Remastered Version) (User: jbwharris)
Shirley Adamson - The Man Who Sold the World (User: jbwharris)
Skye Wallace - Swing Batter (User: jbwharris)
Gord Downie - Budget Shoes (User: jbwharris)
The Orb - Little Fluffy Clouds (User: jbwharris)
The Boo Radleys - Does This Hurt? (User: jbwharris)
Culture Club - Karma Chameleon (User: jbwharris)
Billie Eilish - everything i wanted (User: jbwharris)
Waxahatchee - Light of a Clear Blue Morning (Bonus Track) (User: jbwharris)
Toto - Africa (User: jbwharris)
James Arthur - Say You Won't Let Go (User: jbwharris)
Joni Mitchell - Big Yellow Taxi (User: jbwharris)
Lil Nas X - MONTERO (Call Me by Your Name) (User: jbwharris)
The Beatles - I Am the Walrus (User: jbwharris)
Blue Rodeo - Hasn't Hit Me Yet (User: jbwharris)
Fine Young Cannibals - Suspicious Minds (User: jbwharris)
Devon Kay & The Solutions - Oh Glorious Nothing (User: jbwharris)
Urselle - What's Up (User: jbwharris)
Pale Saints - Throwing Back the Apple (User: jbwharris)
Royal & the Serpent - Overwhelmed (User: jbwharris)
Lee Avril - Cold Chill (User: jbwharris)
Life of Dillon - MIA (User: jbwharris)
Emerger - Urban Wilderness (Reimagined) (User: jbwharris)
Pearl Jam - Why Go (User: jbwharris)
Celeste - Hear My Voice (User: jbwharris)
The Antlers - I Don't Want Love (User: jbwharris)
The Jayhawks - Sister Cry (User: jbwharris)
Héctor Lavoe - El Infierno (User: jbwharris)
Stela Cole - Throwing Up Butterflies (User: jbwharris)
Modest Mouse - Dramamine (User: jbwharris)
Ken Boothe - Everything I Own (User: jbwharris)
The Offspring - Self Esteem (User: jbwharris)
The Offspring - Self Esteem (User: jbwharris)
Caroline Martin - Without Permission (User: jbwharris)
I Mother Earth - Shortcut To Moncton (User: jbwharris)
Ryan Adams - Stay With Me (User: jbwharris)
Black Belt Eagle Scout - Run It to Ya (User: jbwharris)
John Prine - Speed Of The Sound Of Loneliness (User: jbwharris)
Ferraro - wish you were gay (User: jbwharris)
The National - You Had Your Soul With You (User: jbwharris)
The Killers - Somebody Told Me (User: jbwharris)
Marvin Gaye - How Sweet It Is (To Be Loved By You) (User: jbwharris)
Sault - I Just Want to Dance (User: jbwharris)
Low Cut Connie - Revolution Rock n Roll (User: jbwharris)
Gary Louris - Almost Home (User: jbwharris)
Steam - Na Na Hey Hey Kiss Him Goodbye (User: jbwharris)
The Waterboys - This Is The Sea (User: jbwharris)
Blu Detiger - Figure It Out (User: jbwharris)
Kiss the Tiger - Hold On To Love (User: jbwharris)
Death - You're A Prisoner (User: jbwharris)
Sault - Free (User: jbwharris)
Amber Mark - My People (User: jbwharris)
Galaxie 500 - Blue Thunder (User: jbwharris)
Emancipator - Blue Dream (Koresma Remix) (User: jbwharris)
Elujay - Blu (User: jbwharris)
Stella Starlight Trio - Black Hole Sun (User: jbwharris)
Ruby Amanfu - Bitch (From "Little Fires Everywhere") (User: jbwharris)
St. Lucia - Bigger (User: jbwharris)
The House of Love - Beatles and the Stones (User: jbwharris)
Massive Attack - Be Thankful for What You've Got (User: jbwharris)
The Jim Jones Revue - Bag O' Demons (User: jbwharris)
The Cooltrane Quartet & Cassandra Beck - Back for Good (User: jbwharris)
David Gray - Babylon (User: jbwharris)
The Cooltrane Quartet - …Baby One More Time (User: jbwharris)
London Grammar - Baby It's You (User: jbwharris)
Letters to Cleo - Awake (User: jbwharris)
Grimes - Artangels (User: jbwharris)
Floating Points - ARP3 (User: jbwharris)
Dionne Warwick - Anyone Who Had a Heart (User: jbwharris)
The Chemical Brothers - All Rights Reversed (feat. Kla (User: jbwharris)
Lost In Society - All Is Fair (User: jbwharris)
Les Crossaders & Anakelly - All I Wanna Do (User: jbwharris)
Cage the Elephant - Ain't No Rest for the Wicked (Unpeeled) (User: jbwharris)
Jennifer Hudson - Ain't No Mountain High Enough (User: jbwharris)
Vampire Weekend - A-Punk (User: jbwharris)
Floating Points - ARP3 (User: jbwharris)
Jason Isbell and The 400 Unit - White Man's World (User: jbwharris)
Khamari - The Heat (User: jbwharris)
Stateless - Bloodstream (User: jbwharris)
Abigail Fierce - Pitch Dark (User: jbwharris)
The Lumineers - Sick In The Head (User: jbwharris)
Still Haze & Xandra - Sentimental (User: jbwharris)
Anna of the North - Believe (User: jbwharris)
No Vacation - Days (User: jbwharris)
Nick Drake - Things Behind the Sun (User: jbwharris)
Surf Rock is Dead - Late Risers (User: jbwharris)
Get Dead - Fire Sale (User: jbwharris)
The Hold Steady - Stuck Between Stations (User: jbwharris)
Stella Starlight Trio - Sunrise (User: jbwharris)
Jay-Z and Linkin Park - Jigga What / Faint (User: jbwharris)
Elley Duhé - SAVIOR (User: jbwharris)
Jet - Cold Hard Bitch (User: jbwharris)
Grateful Dead - Touch of Grey (User: jbwharris)
The Velvet Underground - Rock & Roll (User: jbwharris)
Skinny Living - Let Go (User: jbwharris)
Brijean - Day Dreaming (User: jbwharris)
Cosmo’s Demos - Just Friends (User: jbwharris)
Adele - Make You Feel My Love (User: jbwharris)
jxdn - Angels & Demons (User: jbwharris)
Travis - Nina's Song (User: jbwharris)
Wayfarer - Sleeper (User: jbwharris)
Marilyn Manson - Personal Jesus (User: jbwharris)
Psalm One - Anxious, Nervous and Imperfect (feat. Afrokeys) (User: jbwharris)
Stevie Ray Vaughan & Double Trouble - Pride and Joy (User: jbwharris)
Foster the People - Imagination (User: jbwharris)
Jimmy Eat World - The Middle (User: jbwharris)
Shane Leonard - Strange Forms (User: jbwharris)
Pistol Annies - Best Years of My Life (User: jbwharris)
Elijah Banks - Gushy (User: jbwharris)
UMI - Midnight Blues (User: jbwharris)
EVE 6 - Inside Out (User: jbwharris)
Yo La Tengo - Friday I'm In Love (User: jbwharris)
Razorlight - Golden Touch (User: jbwharris)
Cassandra Beck - You Gotta Be (User: jbwharris)
Sam Lynch - Darkest Places (User: jbwharris)
John Prine - That's the Way That the World Goes Round (User: jbwharris)
Stompin' Tom Connors - The Ketchup Song (User: jbwharris)
Pretty Uglys - Party Friends (User: jbwharris)
Tim Heidecker - Tobin and the Judge (User: jbwharris)
Jeff Rosenstock - Nikes (Alt) (User: jbwharris)
Betøng - Everlong (User: jbwharris)
Kris Kristofferson - Me and Bobby McGee (User: jbwharris)
Madonna - Vogue (User: jbwharris)
Madonna - Vogue (User: jbwharris)
The Shins - New Slang (User: jbwharris)
JUTO - BTW (User: jbwharris)
Jeremie Albino - Klondike Man (User: jbwharris)
Stateless - Bloodstream (User: jbwharris)
Tegan and Sara - Closer (User: jbwharris)
Conor Oberst - Mamah Borthwick (A Sketch) (User: jbwharris)
Lande Hekt - Undone (User: jbwharris)
etiéne soirée - RunUp (User: jbwharris)
Sen Morimoto - Goosebumps (User: jbwharris)
Kasabian - British Legion (User: jbwharris)
The Raconteurs - Sunday Driver (User: jbwharris)
The Bangles - The Real World (User: jbwharris)
Our Man in the Field - Thin (I Used to Be Bullet Proof) (User: jbwharris)
Grant-Lee Phillips - Lily-A-Passion (User: jbwharris)
Tash Sultana - Sweet & Dandy (User: jbwharris)
The Soup Dragons - Divine Thing (User: jbwharris)
Duran Duran - Girls On Film (Remastered) (User: jbwharris)
Talker - Suck Up (User: jbwharris)
Julia Jacklin - CRY (User: jbwharris)
Ethan Fields - Cooler Than Me (User: jbwharris)
Marcella Detroit - I Believe (User: jbwharris)
KennyHoopla - ESTELLA// (feat. Travis Barker) (User: jbwharris)
The Offspring - Self Esteem (User: jbwharris)
Madonna - Vogue (User: jbwharris)
Lila - The Boy With The Thorn In His Side (feat. Rhythmic Control) (User: jbwharris)
Jennifer Hudson - Ain't No Mountain High Enough (User: jbwharris)
Neon Trees - Used To Like (Acoustic) (User: jbwharris)
Souvenirs - Be Sweet (User: jbwharris)
Leila - Underwaters (one for keni) (User: jbwharris)
Stella Starlight Trio - Sunrise (User: jbwharris)
Black Belt Eagle Scout - Run It to Ya (User: jbwharris)
The Jim Jones Revue - Bag O' Demons (User: jbwharris)
The Watchmen - Any Day Now (User: jbwharris)
The Who - The Real Me (User: jbwharris)
Weezer - All My Favorite Songs (User: jbwharris)
Rilo Kiley - Silver Lining (User: jbwharris)
The Lemonheads - Mrs. Robinson (User: jbwharris)
White Reaper - Real Long Time (User: jbwharris)
Suzanne Vega - Left of Center (live) (User: jbwharris)
The Avalanches - The Divine Chord (feat. MGMT & Johnny Marr) (User: jbwharris)
10,000 Maniacs - These Are Days (User: jbwharris)
Paul McCartney & Beck - Find My Way (User: jbwharris)
Gnarls Barkley - Who's Gonna Save My Soul (User: jbwharris)
The J. Geils Band - Looking for a Love (User: jbwharris)
Lord Huron - Not Dead Yet (User: jbwharris)
The Lumineers - Angela (User: jbwharris)
Arlo Parks - Hurt (User: jbwharris)
The Cars - Bye Bye Love (User: jbwharris)
The Highwomen - The Chain (User: jbwharris)
Tom Petty and The Heartbreakers - Learning to Fly (User: jbwharris)
Dinosaur Jr. - I Ran Away (User: jbwharris)
Florence + the Machine - Hunger (User: jbwharris)
Lucero - Back in Ohio (User: jbwharris)
Juliana Hatfield - Mouthful of Blood (User: jbwharris)
Bob Dylan - Shelter from the Storm (User: jbwharris)
Strand of Oaks - Radio Kids (User: jbwharris)
Japanese Breakfast - Be Sweet (User: jbwharris)
Violent Femmes - American Music (User: jbwharris)
Kings of Leon - Wait for Me (User: jbwharris)
R.E.M. - Catapult (User: jbwharris)
Jealous of the Birds - Pendulum (User: jbwharris)
David Gray - Please Forgive Me (User: jbwharris)
Leon Bridges - Bad Bad News (User: jbwharris)
Twin Shadow - Johnny & Jonnie (User: jbwharris)
beabadoobee - Last Day on Earth (User: jbwharris)
Pixies - Where Is My Mind? (User: jbwharris)
Vampire Weekend - This Life (User: jbwharris)
Six Gallery - Just Hey (User: jbwharris)
Gatsby's American Dream - Don't Think Twice, It's All Right (User: jbwharris)
Kaleo - Break My Baby (User: jbwharris)
Jack White - I'm Shakin' (User: jbwharris)
Bakar - 1st Time (User: jbwharris)
Celeste - Hear My Voice (User: jbwharris)
The Clash - This is Radio Clash (User: jbwharris)
Tune-Yards - hold yourself (User: jbwharris)
Garbage - Empty (User: jbwharris)
Dylan Cartlidge - Anything Could Happen (User: jbwharris)
Tom Waits - Hang on St. Christopher (User: jbwharris)
Hiss Golden Messenger - Sanctuary (User: jbwharris)
Laura Marling - Strange Girl (User: jbwharris)
Lana Del Rey - Chemtrails Over the Country Club (User: jbwharris)
Hurray For The Riff Raff - Rican Beach (User: jbwharris)
Steve Cropper - Bush Hog (User: jbwharris)
Israel Nash - Canyonheart (User: jbwharris)
Jason Isbell and The 400 Unit - Only Children (User: jbwharris)
Bettye LaVette - Before The Money Came (The Battle Of Bettye LaVette) (User: jbwharris)
Lucero - Outrun the Moon (User: jbwharris)
Amy Helm - Breathing (User: jbwharris)
The Band - When I Paint My Masterpiece (User: jbwharris)
Melissa Carper - Makin' Memories (User: jbwharris)
Shakey Graves - Roll the Bones (User: jbwharris)
Shovels & Rope - Birmingham (User: jbwharris)
Rhiannon Giddens - Calling Me Home (User: jbwharris)
The Jayhawks - Blue (User: jbwharris)
Los Lobos - One Time One Night (User: jbwharris)
Turn Turn Turn - Papercut (User: jbwharris)
Todd Snider - Turn Me Loose (I'll Never Be the Same) (User: jbwharris)
Zephaniah OHora - All American Singer (User: jbwharris)
Charley Crockett - Midnight Run (User: jbwharris)
The Brother Brothers - On The Road Again (User: jbwharris)
The Byrds - Mr. Spaceman (User: jbwharris)
Church of Roswell - Rocketeer (User: jbwharris)
Billie Joe + Norah - Long Time Gone (User: jbwharris)
Travis Linville - I'm Still Here (User: jbwharris)
Rock And Hyde - Dirty Water (User: jbwharris)
Mono - Life in Mono (User: jbwharris)
The Smiths - William, It Was Really Nothing (User: jbwharris)
Endgames - First-Last-For-Everything (User: jbwharris)
The Waterboys - The Whole of the Moon (User: jbwharris)
World Party - Way Down Now (User: jbwharris)
The Monks - Johnny B. Rotten (User: jbwharris)
Sarah McLachlan - Possession (User: jbwharris)
Peter Godwin - Baby's in the Mountains (User: jbwharris)
Living Colour - Leave It Alone (User: jbwharris)
Jane's Addiction - Stop! (User: jbwharris)
Voice of America - Story of Love (User: jbwharris)
The Psychedelic Furs - Pretty in Pink (User: jbwharris)
The Lords of the New Church - Dance With Me (User: jbwharris)
Northside - Take 5 (User: jbwharris)
General Public - Tenderness (User: jbwharris)
Prince - Purple Rain (User: jbwharris)
Machines of Loving Grace - Butterfly Wings (User: jbwharris)
Collective Soul - Shine (User: jbwharris)
Moist - Believe Me (User: jbwharris)
Cabaret Voltaire - Sensoria (User: jbwharris)
The Shamen - Move Any Mountain (User: jbwharris)
Eleven - Rainbow's End (User: jbwharris)
my bloody valentine - Only Shallow (User: jbwharris)
Magazine - The Light Pours Out Of Me (User: jbwharris)
Soundgarden - Hunted Down (User: jbwharris)
The Pogues - Yeah, Yeah, Yeah, Yeah, Yeah (User: jbwharris)
Arcadia - Election Day (User: jbwharris)
School Of Fish - Take Me Anywhere (User: jbwharris)
Blur - Coffee & TV (User: jbwharris)
Heaven 17 - Crushed By the Wheels of Industry (User: jbwharris)
Furniture - Brilliant Mind (User: jbwharris)
Barenaked Ladies - Brian Wilson (User: jbwharris)
Madness - Our House (User: jbwharris)
Re-Flex - The Politics of Dancing (User: jbwharris)
Juliana Hatfield - Universal Heart-Beat (User: jbwharris)
Cypress Hill - Insane in the Brain (User: jbwharris)
Queen City Kids - Follow you There (User: jbwharris)
Gavin Fitch - Tract Homes (User: jbwharris)
The Crystal Furs - Burn Us Down (User: jbwharris)
Artms - Ydmtr (User: jbwharris)
Dining Dead - White Russians (User: jbwharris)
Black Rebel Motorcycle Club - Shuffle Your Feet (User: jbwharris)
U2 - The Troubles (User: jbwharris)
Arkells - Abigail (User: jbwharris)
Arctic Monkeys - Brianstorm (Live) (User: jbwharris)
The Clash - Junco Partner (User: jbwharris)
SG Lewis - Blue (User: jbwharris)
Krister Axel - Weightless Heart (feat. Courtney Hartman, Shane Leonard & J.E. Sunde) (User: jbwharris)
Elbow - Starlings (User: jbwharris)
The Russian Futurists - You Dot, Me Dot, T Dot (User: jbwharris)
The Sugarcubes - Birthday (User: jbwharris)
Pulp - Common People (full length version) (User: jbwharris)
KALLITECHNIS - colo(u)rs (User: jbwharris)
The Modern Lovers - Roadrunner (User: jbwharris)
Laraaji - Feeling Lovely (User: jbwharris)
The Horrors - Lout (User: jbwharris)
Laura Marling - Strange Girl (User: jbwharris)
Aerosmith - Walk This Way (User: jbwharris)
Jungle - Keep Moving (User: jbwharris)
Jon Batiste - CRY (User: jbwharris)
Coldplay - Orphans (User: jbwharris)
DJ Shadow - Rocket Fuel (feat. De La Soul) (User: jbwharris)
Robbie Williams - Millennium (User: jbwharris)
Tanya Tucker - Delta Dawn (User: jbwharris)
Televisor - I'm Yours Tonight (feat. Brenton Mattheus & Lambert McGaughy) (User: jbwharris)
Newton Faulkner - Teardrop (User: jbwharris)
Miss Grit - Grow Up To (User: jbwharris)
The Soup Dragons - Divine Thing (User: jbwharris)
Public Enemy - Black Steel in the Hour of Chaos (User: jbwharris)
Gang of Youths - The Heart Is a Muscle (User: jbwharris)
Brittany Howard - He Loves Me (User: jbwharris)
The Standells - Sometimes Good Guys Don't Wear White (User: jbwharris)
DMX - Ruff Ryders' Anthem (User: jbwharris)
Cold War Kids - Hospital Beds (User: jbwharris)
Islands - (We Like To) Do It with the Lights On (User: jbwharris)
Tuns - We Stand United (User: jbwharris)
Cate Le Bon - Daylight Matters (User: jbwharris)
Portishead - Wandering Star (User: jbwharris)
Dave Monks - Love (User: jbwharris)
Witch Prophet - Manifest (User: jbwharris)
The Dandy Warhols - We Used to Be Friends (User: jbwharris)
The Rolling Stones - Jumpin' Jack Flash (User: jbwharris)
Kinnie Starr - I'm Ready (feat. Spek) (User: jbwharris)
Emily Barker - The Woman Who Planted Trees (User: jbwharris)
Beachy Head - Destroy Us (User: jbwharris)
The Virginia Sil'hooettes - Telephone (User: jbwharris)
Stars on 33 - Something You Can Feel (User: jbwharris)
Steve Cradock - I Am the Sea (User: jbwharris)
Hüsker Dü - Pink Turns to Blue (User: jbwharris)
Ray LaMontagne - Strong Enough (User: jbwharris)
R.E.M. - Man on the Moon (User: jbwharris)
Aerosmith - Dream On (User: jbwharris)
Seratones - Over You (User: jbwharris)
The Fratellis - Chelsea Dagger (User: jbwharris)
The Rolling Stones - Route 66 (User: jbwharris)
Ramones - Blitzkrieg Bop (User: jbwharris)
My Morning Jacket - Wordless Chorus (User: jbwharris)
Overcoats - The Fool (User: jbwharris)
Mercury Rev - Courtyard (feat. Beth Orton) (User: jbwharris)
Pavement - Unseen Power of the Picket Fence (User: jbwharris)
Alice Merton - No Roots (User: jbwharris)
G. Love & Special Sauce - Cold Beverage (User: jbwharris)
The Allman Brothers Band - Midnight Rider (User: jbwharris)
Lenny Kravitz - Low (User: jbwharris)
The Killers - All These Things That I've Done (User: jbwharris)
Ndidi O - Hands High (User: jbwharris)
Ghostly Kisses - Empty Note (User: jbwharris)
mute choir - Shadowboxing (User: jbwharris)
Patrick Watson - Melody Noir (User: jbwharris)
Pavement - Major Leagues (User: jbwharris)
Jurassic 5 - Concrete Schoolyard (User: jbwharris)
Mo Kenney - Maybe I Am (User: jbwharris)
The Clash - Rock the Casbah (User: jbwharris)
The Juliana Hatfield Three - My Sister (User: jbwharris)
Natalie Prass - Short Court Style (User: jbwharris)
Fleet Foxes - He Doesn't Know Why (User: jbwharris)
Harry Styles - Lights Up (User: jbwharris)
Liam Gallagher - Wall Of Glass (User: jbwharris)
Pronoun - a million other things (User: jbwharris)
The Go-Go's - This Town (User: jbwharris)
Lynyrd Skynyrd - Tuesday's Gone (User: jbwharris)
Parliament - Chocolate City (User: jbwharris)
The Lytics - Last Bit (Lovely Words) (User: jbwharris)
Minutemen - History Lesson Part 2 (User: jbwharris)
The Motels - So L.A. (User: jbwharris)
Rag'n'Bone Man - All You Ever Wanted (User: jbwharris)
My Morning Jacket - Feel You (User: jbwharris)
Squeeze - Goodbye Girl (User: jbwharris)
Washed Out - All I Know (User: jbwharris)
Neon Dreams - Sick of Feeling Useless (User: jbwharris)
Less Than Jake - History of a Boring Town (User: jbwharris)
Haley Bonar - Kismet Kill (User: jbwharris)
Simian Mobile Disco - I Believe (User: jbwharris)
Gene Tellem - Big Bill (User: jbwharris)
Crystal Castles - Not in Love (feat. Robert Smith) (User: jbwharris)
Tesla Boy - Synchronizing (User: jbwharris)
Jamie T - Sticks 'n' Stones (User: jbwharris)
Macklemore & Ryan Lewis - Same Love (feat. Mary Lambert) (User: jbwharris)
T. Rex - Rip Off (User: jbwharris)
Sugar Pie DeSanto - Use What You Got (User: jbwharris)
Dinosaur Jr. - In a Jar (User: jbwharris)
Linda Martell - Color Him Father (User: jbwharris)
Elle King - Under the Influence (User: jbwharris)
