Belouis Some - Imagination (User: melons)
Double - The Captain of Her Heart - Radio Version (User: melons)
Jane Siberry - The Very Large Hat (User: melons)
Desperate Journalist - Hollow (User: melons)
Alisha - Too Turned On (User: melons)
Robert Wyatt - Gharbzadegi (User: melons)
New Model Army - No Rest (User: melons)
Red Lorry Yellow Lorry - Talk About the Weather (User: melons)
Loose Ends - Hangin' On a String (User: melons)
James Brown - Living in America - From "Rocky IV" Soundtrack (User: melons)
May East - Maraka (User: melons)
Tetê Espíndola - Escrito Nas Estrelas (User: melons)
Loudness - Crazy Night (User: melons)
'Om' Alec Khaoli - Say You Love Me (User: melons)
French Cassettes - City Kitty (User: melons)
French Cassettes - Good For It (User: melons)
Meija - Buttons (User: melons)
INXS - What You Need (User: melons)
Brenda K. Starr - Pickin' up Pieces - 12" Vocal (User: melons)
Starpoint - Object Of My Desire (User: melons)
Alisha - Too Turned On (User: melons)
New Order - The Perfect Kiss - 2022 Digital Master (User: melons)
Big Audio Dynamite - E=MC2 (User: melons)
The Jesus and Mary Chain - Just Like Honey (User: melons)
The Waterboys - The Whole of the Moon - 2004 Remaster (User: melons)
Bob Monkhouse - Dear Old Syracuse (User: melons)
Gizmo! - All Peacocks Singing With Gizmo! (User: melons)
Colour Haze - Did el it (User: melons)
Truckfighters - Intermission (User: melons)
Gizmo Varillas - Paraiso (User: melons)
Ecstatic Vision - March of the Troglodytes (User: melons)
R.I.P. - The Scythe (User: melons)
Peace De Résistance - Alphabet Au Pair (User: melons)
Mrs Jynx - dusty (User: melons)
Simon Fraser University Pipe Band - Highland Fling 4 Step (User: melons)
Sam Isaac - Sticker, Star and Tape (User: melons)
Robin Williamson - Idyll - Parade (User: melons)
Amazing Blondel - Lady Marion's Galliard (User: melons)
Lo-Pan - Intro (User: melons)
Magna Carta - Elizabethan (User: melons)
Trader Horne - Morning Way (User: melons)
Microwave Prince - I Need Your Love - Video Mix (User: melons)
Les Dawson - I'm Just Another Sweetheart (User: melons)
Tír Na Nóg - Goodbye My Love (User: melons)
Steeleye Span - Gaudete - 2009 Remaster (User: melons)
Tudor Lodge - Madeline (User: melons)
Cob - Let It Be You (User: melons)
Slapp Happy - The Owl (User: melons)
The John Renbourn Group - A Maid In Bedlam (User: melons)
Fursaxa - Alone in the Dark Wood (User: melons)
Sandra Kerr - The Miller's Song (User: melons)
Malicorne - Misère (User: melons)
Shed - Intro (User: melons)
Jerry Goldsmith - The Gremlin Rag - Full Version (User: melons)
Kermit - Rainbow Connection - From "The Muppet Movie"/Soundtrack Version (User: melons)
White Hills - Bits (User: melons)
Sandra Kerr - Mouse Round - Here's a Pin (User: melons)
Sandra Kerr - Mouse Round - Here's a Pin (User: melons)
Horrid Henry - Rockstar (User: melons)
John Fahey - When The Springtime Comes Again (User: melons)
Spirogyra - Love Is A Funny Thing (User: melons)
Saule - Dusty Men (User: melons)
These Trails - Psyche II (User: melons)
Gryphon - Kemp's Jig (User: melons)
Trees - The Garden Of Jane Delawney (User: melons)
Third Ear Band - Earth - 2018 Remaster (User: melons)
Veronique Chalot - Danse En Circle (User: melons)
Księżyc - Verlaine, Pt. 1 (User: melons)
Emmanuelle Parrenin - Topaze (User: melons)
Malicorne - Le luneux (User: melons)
Art Bears - The Bath of Stars (User: melons)
Mac DeMarco - Enter Sandman (User: melons)
Gene Pitney - I'm Gonna Be Strong (User: melons)
Hello Kitty - I'm Gonna Be a Star (User: melons)
Gene Pitney - I'm Gonna Be Strong (User: melons)
Fats Domino - I'm Gonna Be A Wheel Some Day (User: melons)
Star Candy - I'm Gonna Be A Star (User: melons)
Jason Weaver - I Just Can't Wait to Be King - From "The Lion King" Soundtrack (User: melons)
Marty Robbins - I'm Gonna Be a Cowboy (User: melons)
Jill Sobule - Supermodel (User: melons)
Buffy Sainte-Marie - I'm Gonna Be a Country Girl Again (User: melons)
Peggy Seeger - I'm Gonna Be an Engineer (User: melons)
Iron Curtain - love can never die (User: melons)
Nicolas Jaar - Mud (User: melons)
Gloria de Oliveira - Further Than the Stars (User: melons)
Patrick Cowley - Love Come Set Me Free (User: melons)
Rick Cuevas - The Birds (User: melons)
Sparks - Angst in My Pants (User: melons)
The Blue Nile - Heatwave (User: melons)
Lives Of Angels - Golden Age (User: melons)
Scribble - Mother of Pearl (User: melons)
Bryan Ferry - Another Time, Another Place (User: melons)
Bullion - Heaven Is Over (User: melons)
New Order - Your Silent Face - 2020 Digital Master (User: melons)
Domenique Dumont - Ono Mambo Haiku (User: melons)
Satoshi & Makoto - Crepuscule Leger (User: melons)
Ryuichi Sakamoto - The Left Bank (User: melons)
Labyrinth Ear - Navy Light (User: melons)
J Foerster - Botanique (User: melons)
Dean & Britta - Neon Lights (User: melons)
Spacemen 3 - I Love You (User: melons)
Misha Panfilov Sound Combo - Days As Echoes (User: melons)
Roxy Music - Mother of Pearl (User: melons)
Orbital - Semi Detached (User: melons)
Manfred Mann - Semi-Detached, Suburban Mr. James - Mono Version (User: melons)
Lucia Fasano - Habitable Planets (User: melons)
Mark Bell - A Salute to Those People Who Say Fuck You (User: melons)
Foot and Mouth - I Want My Mommy (User: melons)
Cameron Allan - Bikini Atoll (User: melons)
Mix - Do You Do It? (User: melons)
The Igniters - Hakka Suru (User: melons)
Tsk Tsk Tsk - Sedation (User: melons)
THE Couch - Full Treatment (User: melons)
Poets of the Machine - Arabs (User: melons)
Whadya Want? - Open Spaces (User: melons)
Maria Kozic - Trust Me (User: melons)
Maria Kozic - Trust Me (User: melons)
Jumbo - Siento Que... (User: melons)
Mumbo Jumbo - Wind It Up (User: melons)
Brendan Canty - Semi-Detached (User: melons)
Two Lone Swordsmen - Circulation (User: melons)
Mira Calix - Umchunga Locks (User: melons)
Mira Calix - Umchunga Locks (User: melons)
Red Snapper - 4 Dead Monks - Original Demo (User: melons)
Plone - Miniature Magic (User: melons)
Plone - Years and Elements (User: melons)
Plone - Plaything (User: melons)
Jimi Tenor - Wear My Bikini (User: melons)
Autechre - Stop Look Listen (User: melons)
Plaid - Ilasas (User: melons)
Broadcast - Hammer Without a Master (User: melons)
The Moody Blues - Melancholy Man (User: melons)
Boards of Canada - Orange Romeda (User: melons)
Squarepusher - Freeman, Hardy & Willis Acid [Chosen by Warp co-founder Steve Beckett] (User: melons)
Aberfeldy - Love Is an Arrow (User: melons)
Stephen Malkmus & The Jicks - Bike Lane (User: melons)
The United States of America - Stranded in Time (User: melons)
Assagai - Hey Jude (User: melons)
Project Gemini - After The Dawn (User: melons)
The Sugarcubes - Walkabout (User: melons)
Talking Heads - Paper - 2005 Remaster (User: melons)
Mott the Hoople - All the Young Dudes - David Bowie & Ian Hunter Vocal (User: melons)
Roxy Music - Street Life (User: melons)
A Certain Ratio - Samo (User: melons)
Carly Rae Jepsen - The Loneliest Time (feat. Rufus Wainwright) (User: melons)
Cathal Coughlan - Amused As Hell (User: melons)
Beastie Boys - Shake Your Rump (User: melons)
The Superjesus - Enough to Know (User: melons)
Joey Dosik - Game Winner (User: melons)
Pulp - I Want You - 2012 Remastered (User: melons)
Joey Dosik - Game Winner (User: melons)
Roxy Music - Street Life (User: melons)
Mott the Hoople - All the Young Dudes - David Bowie & Ian Hunter Vocal (User: melons)
Roxy Music - Street Life (User: melons)
Bianca - La Fourmi (User: melons)
Bianca - La Fourmi (User: melons)
PJ Harvey - Electric Light (User: melons)
Crowded House - Not the Girl You Think You Are (User: melons)
Electric Light Orchestra - Livin' Thing (User: melons)
Nadine Shah - Fool (User: melons)
The Creatures - Right Now (User: melons)
Sun City Girls - Cooking with Satan (User: melons)
Sun City Girls - Cooking with Satan (User: melons)
Les Rallizes Dénudés - Oz Days (User: melons)
Josh Johnson - Return Recoil (User: melons)
Shubh Saran - The Profane (User: melons)
Tigran Hamasyan - Rain Shadow (User: melons)
Oliver Nelson - The Critic's Choice (User: melons)
Rahsaan Roland Kirk - One Note Samba (User: melons)
Aaron Parks - Roadside Distraction (User: melons)
Brian Blade & The Fellowship Band - Embers (User: melons)
Betty Carter - I Could Write a Book (User: melons)
Mose Allison - The Seventh Son (User: melons)
Wynton Kelly Trio - It's All Right (User: melons)
James Moody - Disappointed (User: melons)
Phil Woods - Doxy (User: melons)
Jacky Terrasson - 3. Sequentia: Lacrimosa (User: melons)
Ella Fitzgerald - Sunshine Of Your Love (User: melons)
Ahmad Jamal Trio - Ahmad's Blues (User: melons)
Ahmad Jamal - I Say A Little Prayer (User: melons)
Roy Hargrove - Bring It On Home To Me (User: melons)
Prefab Sprout - Goodbye Lucille #1 - 2007 Remastered Version (User: melons)
The Colourfield - Thinking of You (User: melons)
Scritti Politti - The Word Girl (User: melons)
China Crisis - Black Man Ray (User: melons)
Dokken - In My Dreams (User: melons)
Ratt - Lay It Down (User: melons)
The Funky Knuckles - Knuckaround (User: melons)
Benny Neyman - Waarom fluister ik je naam nog (User: melons)
Georgie Davis - Blackstar (User: melons)
Andre Hazes - Buona Sera / Oh Marie - Live (User: melons)
One Way - Let's Talk - Extended Version (User: melons)
Roberto Jacketti & The Scooters - Make Me Smile (User: melons)
André van Duin - Een boutje en een moertje en een schroefje en een nippeltje (User: melons)
René & Angela - Save Your Love (for # 1) (User: melons)
Koos Alberts - Ik zal je nooit vergeten (User: melons)
Zinno - What’s Your Name? (User: melons)
Normaal - Oerend hard (User: melons)
Ivan - Baila (User: melons)
W.A.S.P. - Wild Child (User: melons)
Mötley Crüe - Home Sweet Home (User: melons)
Thereza Bazar - Gotcha! (User: melons)
Kirlian Camera - Blue Room - extended version (User: melons)
Sequal - It's Not Too Late (User: melons)
The Sisters of Mercy - Marian - Version (User: melons)
Depeche Mode - Shake the Disease (User: melons)
Avishai Cohen - Beyond (User: melons)
Kate Bush - Cloudbusting (User: melons)
Sophia George - Girlie Girlie (User: melons)
The Cure - Inbetween Days (User: melons)
Klymaxx - Meeting In The Ladies Room (User: melons)
Change - Mutual Attraction - Single Version (User: melons)
Steve Arrington - Feel so Real (User: melons)
Force M.D.'s - Tender Love (User: melons)
Billy Bragg - Between The Wars (User: melons)
The Pogues - Sally MacLennane (User: melons)
The Smiths - The Headmaster Ritual - 2011 Remaster (User: melons)
Echo & the Bunnymen - Bring On The Dancing Horses (User: melons)
Alka Yagnik - Dekho Dekho Dekho Magar Pyar Se (User: melons)
Belle and Sebastian - Wrapped Up in Books (User: melons)
Alka Yagnik - Dekho Dekho Dekho Magar Pyar Se (User: melons)
Minoru Fushimi - Shinzō-San (User: melons)
Zazou Bikaye - Nostalgie (User: melons)
R.E.M. - Begin the Begin (User: melons)
Sébastien Tellier - La Ritournelle (User: melons)
Madlib - Road of the Lonely Ones (User: melons)
DJ Shadow - Midnight in a Perfect World (User: melons)
Four Tet - Two Thousand And Seventeen (User: melons)
Siriusmo - High Together (User: melons)
This Mortal Coil - Song To The Siren - Remastered (User: melons)
LL Cool J - I Can't Live Without My Radio (User: melons)
Paul Hardcastle - 19 (User: melons)
Freestyle - Don't Stop the Rock (User: melons)
The Motorcycle Boy - Big Rock Candy Mountain (User: melons)
J.M. Silk - Music Is The Key - Steve Silk Hurley House Key (User: melons)
Mantronix - Bassline (User: melons)
Strafe - Set It Off (Vocal) (User: melons)
Mr. Fingers - Mystery Of Love (User: melons)
Marvin Gaye - Sanctified Lady (User: melons)
Cameo - Single Life (User: melons)
Eddie Murphy - Party All the Time (User: melons)
Blyth Power - Chevy Chase (User: melons)
Shop Assistants - All Day Long (User: melons)
The Adventures - Feel The Raindrops (User: melons)
Do Re Mi - Man Overboard (User: melons)
a-ha - Hunting High and Low (User: melons)
Level 42 - Something About You (User: melons)
Tears for Fears - Head Over Heels (User: melons)
Strawberry Switchblade - Michael Who Walks by Night (User: melons)
Dead Can Dance - Enigma of the Absolute (User: melons)
Camera Obscura - Eighties Fan (User: melons)
The Amphetameanies - Last Night (User: melons)
Captain Beefheart & His Magic Band - Pompadour Swamp (User: melons)
Melodic Energy Commission - Galloop (User: melons)
Deer Eat Birds - Pompadour (User: melons)
Fabio Fabor - Pompadour (User: melons)
Katy J Pearson - Alligator (User: melons)
Opus Kink - I Love You, Baby (User: melons)
Hans Helwinden - From Ukraine With Love (User: melons)
Hans Hollestelle - Kon-Tiki (User: melons)
Eiafuawn - Good God Y'All (User: melons)
Morphine - Good (User: melons)
The Wet Darlings - Good Dog (User: melons)
Grey Dog - Janie (Hide Your Eyes) (User: melons)
The Autumns - Apple (User: melons)
The Autumns - Pale Trembles a Gale (User: melons)
Future Islands - Spirit (User: melons)
Turquoise Days - Grey Skies (User: melons)
Teenage Waitress - Grey Sky (User: melons)
Belle and Sebastian - Wrapped Up in Books (User: melons)
XTC - Wrapped In Grey - 2001 Remaster (User: melons)
The Delgados - Under Canvas Under Wraps (User: melons)
Barry Adamson - Under Wraps (User: melons)
Yppah - Gumball Machine Weekend (User: melons)
The Autumns - She Whispers The Winter Snow (User: melons)
Front 242 - Quite Unusual - 1 (User: melons)
John Lennon - Watching The Wheels - Remastered 2010 (User: melons)
Nice Face - Decipher (User: melons)
Mick Mercury & the Meteors - Fancy Hat (User: melons)
Lora Jol - Heart-Shaped Rock (User: melons)
Excellent Skeleton - On Mercury Sea (User: melons)
Brotherhood - The Monkey that Became President (User: melons)
Tindersticks - Singing (User: melons)
Gordon Tate - The Absolute (User: melons)
Felt - I Will Die With My Head In Flames (User: melons)
Mathieu Séguin - Un Beau Moment (User: melons)
The Beatles - Honey Pie - Remastered 2009 (User: melons)
Bird Thongchai - บ้านของเรา (User: melons)
How To Calm A Parrot - Walking Your Bird (User: melons)
Sidney Gish - Bird Tutorial (User: melons)
Cherry People - And Suddenly (User: melons)
A Northern Chorus - Watershed Divide (User: melons)
Tove Lo - disco tits (User: melons)
Woo - Wallpaper (User: melons)
Duggee & The Squirrels - Disco Duck (User: melons)
Tiny Little Houses - Richard Cory (User: melons)
Horace Peterkin - Big Bamboo (User: melons)
Burial - His Rope (User: melons)
Jhené Aiko - LSD (User: melons)
Donovan - Jersey Thursday (User: melons)
Bob Dylan - Honey, Just Allow Me One More Chance (User: melons)
Bootsy Collins - Preview Side Too (User: melons)
Nightbus - Way Past Three (User: melons)
The Kount - The Way You Make Me Feel (User: melons)
The Revolution One - Intro (User: melons)
Meshell Ndegeocello - Beautiful (User: melons)
Bug Teeth - Virgo (User: melons)
Mary Lou Williams - miss d.d. (User: melons)
Mary Lou Lord - Some Jingle Jangle Morning (User: melons)
R.E.M. - Laughing (User: melons)
David Crosby - Laughing (User: melons)
Sparks - Tips for Teens (User: melons)
Spellling - Hard to Please (User: melons)
Kode9 - The Break Up (User: melons)
Todd Rundgren - Tic Tic Tic, It Wears Off - 2015 Remaster (User: melons)
schizoid seinfeld - The Twinkle in Your Eyes (User: melons)
Lucio Battisti - Dieci Ragazze (User: melons)
Nadka Karadjova - Пиленце Пее, Мамо (User: melons)
Roy Ayers - Baby I Need Your Love (User: melons)
ビクター・ファンタスティック・オーケストラ - SPARKLE (User: melons)
Ensemble Pirin - Na ti, mome dzivri ( Take those slippers, maiden) (User: melons)
Daiquiri - Desde que te Fuiste (User: melons)
Pierre Daven-Keller - Melancholia (User: melons)
Ivo Papazov - Марийкино хоро (User: melons)
Janet Jackson - What Have You Done for Me Lately (User: melons)
Иван Дяков - Йовано, Йованке (User: melons)
Slavka Kalcheva - Mari Mome (User: melons)
Network Music Ensemble - You’re the Very Best: Transition (Groove Version) (User: melons)
ALASKALASKA - Happyface (User: melons)
Network Music Ensemble - You’re the Very Best: Transition (Groove Version) (User: melons)
Iraina Mancini - Undo the Blue - Français (User: melons)
Kagoule - Made Of Concrete (User: melons)
Bert Jansch - The Bright New Year - 2015 Remaster (User: melons)
Berta Bigtoe - Catskill (User: melons)
Donnie Alexzander - Untitled (User: melons)
Francis Cabrel - L'encre de tes yeux - Remastered (User: melons)
Bartholme - Free Form Freak-Out No. 1 (2011 Sonic Boom Stereo Remaster) (User: melons)
The Red Krayola - Music (2011 Sonic Boom Remaster) (User: melons)
Tracyanne & Danny - Cellophane Girl (User: melons)
Futurecop! - We Belong (User: melons)
Actually - Tropical Winter (User: melons)
Jonny Makeup - O.M.G. (User: melons)
Wet Look - I Love You Love Me (User: melons)
Wylderness - Wet Look (User: melons)
Campfire Social - Everything Changed (User: melons)
Animal Collective - Doggy (User: melons)
Dream the Electric Sleep - Elizabeth (User: melons)
Elisabeth Elektra - Hush Hush (User: melons)
Nancy Elizabeth - Electric (User: melons)
Electroflesh - Elizabeth (User: melons)
Tracyanne & Danny - It Can’t Be Love Unless It Hurts (User: melons)
Zoey Van Goey - Sweethearts In Disguise (User: melons)
Stevie Jackson - Where Do All the Good Girls Go? (User: melons)
Peter Parker - Eliot (User: melons)
Clock Opera - Whippoorwill (User: melons)
The Phenomenal Handclap Band - Do What You Like (User: melons)
Best Coast - When I'm With You (User: melons)
1990s - Psyche-Ward Pick-Up No. 9 (User: melons)
1990s - You're Supposed To Be My Friend (User: melons)
The 1900s - When I Say Go (User: melons)
Abagail Grey - Apple Cherub Dove (User: melons)
Trembling Blue Stars - Abba on the Jukebox (User: melons)
Trembling Bells - I Made A Date (With An Open Vein) (User: melons)
Silver Columns - Brow Beaten (User: melons)
The Divine Comedy - Generation Sex (User: melons)
Vic Godard - Nice on the Ice (User: melons)
Looper - Ballad of Ray Suzuki (User: melons)
The Ladybug Transistor - Oceans in the Hall (User: melons)
Broadcast - Echo's Answer (User: melons)
Mercury Rev - Opus 40 - Early Rough Version (User: melons)
Bill Wells Octet - Olympic Material (User: melons)
Bill Wells Octet - Wiltz (User: melons)
Bill Wells Octet - Om Namah Shivaya (User: melons)
Bill Wells Octet - Chimps (User: melons)
Bill Wells Octet - Requiem Pour Un Con (User: melons)
The Jon Spencer Blues Explosion - Wail (User: melons)
Cornelius - Count Five or Six (User: melons)
The King Blues - I Got Love (User: melons)
Meryl Streep - Shabbiness Doesn't Matter (User: melons)
Meryl Streek - Full of Grace (User: melons)
Sleater-Kinney - I Wanna Be Your Joey Ramone (User: melons)
The Flaming Lips - Waitin' for a Superman - Mokran Mix; 2017 Remaster (User: melons)
Giant Sand - The Beat Goes On (User: melons)
V-Twin - Thankyou Baby (User: melons)
Salako - Porpoise Sunlamp (User: melons)
Salako - The Bird and the Bag (User: melons)
Salako - The Moonlight Radiates a Purple Glow in His World (User: melons)
The Delgados - The Actress (User: melons)
Grove - Feed My Desire (User: melons)
Belle and Sebastian - Photo Jenny (User: melons)
Teenage Fanclub - Sparky's Dream (User: melons)
The Lotus Eaters - The First Picture of You (User: melons)
Harold Land - You Don't Know What Love Is (User: melons)
Mrs. GREEN APPLE - インフェルノ (User: melons)
Ministry - Over the Shoulder (User: melons)
The Damned - The Shadow of Love (User: melons)
Sheila Chandra - Strange Minaret (User: melons)
Luiz Gonzaga - Forró Nº 1 (feat. Gal Costa) (User: melons)
Charly McClain - Radio Heart (User: melons)
Tokyo - Garota de Berlim (User: melons)
The Loft - Up The Hill And Down The Slope (User: melons)
Paul Haig - Heaven Help You Now (User: melons)
Vicious Pink - Fetish (User: melons)
The Pastels - Comin' Through (User: melons)
Sodastream - autumn sung (User: melons)
Unbunny - Let It All Burn (User: melons)
Le Orme - Ad gloriam (User: melons)
Zarelli - The Dog (User: melons)
R.E.M. - Swan Swan H (User: melons)
Willie Griffin - Where There's Smoke There's Fire (User: melons)
Papa M - Over Jordan (User: melons)
Pete Dello and Friends - It's What You've Got (User: melons)
The Pastels - So Far Away - Remastered (User: melons)
AC Acoustics - Stunt Girl (User: melons)
The Ladybug Transistor - Oceans in the Hall (User: melons)
Orchestral Manoeuvres in the Dark - Joan Of Arc - Remastered (User: melons)
Johnny Logan - What's Another Year (User: melons)
David Bowie - Ashes to Ashes - 2017 Remaster (User: melons)
Orange Juice - Tender Object (User: melons)
The Beach Boys - Don't Worry Baby - Remastered 2001 (User: melons)
Dexys Midnight Runners - Liars A to E (User: melons)
Sparks - Beat the Clock (User: melons)
Augustus Pablo - King Tubby Meets The Rockers Uptown (User: melons)
Santa Dog - Theme from Camberwick Green (User: melons)
Linx - All My Yesterdays - 2011 Remaster (User: melons)
Depeche Mode - New Life (User: melons)
Gary Numan - I Dream of Wires (User: melons)
Gary Numan - We Are Glass (User: melons)
Beggar & Co. - (Somebody) Help Me Out - Edit (User: melons)
Dexys Midnight Runners - Come On Eileen (User: melons)
XTC - Making Plans for Nigel (User: melons)
Alaskan Tapes - Notes (User: melons)
Holland-Dozier - New Breed Kinda Woman (User: melons)
Kate Bush - Sat in Your Lap (User: melons)
Ken Boothe - Everything I Own (User: melons)
Vernon Elliott - Intro and dialogue (User: melons)
Νίκος Ξυλούρης - Pote Tha Kani Xasteria (User: melons)
Squeeze - Up The Junction (User: melons)
Madness - Baggy Trousers (User: melons)
Racey - Shame (User: melons)
The Wombles - Minuetto Allegretto (User: melons)
Talk Talk - Mirror Man - 1997 Remaster (User: melons)
The Korgis - If I Had You (User: melons)
Talk Talk - Mirror Man - 1997 Remaster (User: melons)
XTC - Making Plans for Nigel (User: melons)
Mihalis Violaris - Ta Rialia (User: melons)
Julio Iglesias - Begin the Beguine (Volver A Empezar) (User: melons)
Lipps, Inc. - Funkytown - Single Version (User: melons)
Sheena Easton - Modern Girl (User: melons)
Bee Gees - To Love Somebody (User: melons)
Chuck Berry - My Ding-A-Ling - Live At Lanchester Arts Festival,1972 (User: melons)
The Velvet Underground - All Tomorrow's Parties (User: melons)
Dave Edmunds - Girls Talk (User: melons)
Echo & the Bunnymen - Crocodiles - Live (User: melons)
Shakin' Stevens - Green Door (User: melons)
Echo & the Bunnymen - Crocodiles - Live (User: melons)
Shakin' Stevens - Green Door (User: melons)
Soft Cell - Tainted Love (User: melons)
Spyro Gyra - Morning Dance - Live In Lakeville, PA / 1997 (User: melons)
Dexys Midnight Runners - All In All (This One Last Wild Waltz) (User: melons)
Dean Martin - That's Amore (User: melons)
Echo & the Bunnymen - Stars Are Stars (User: melons)
Talking Heads - Once in a Lifetime - 2005 Remaster (User: melons)
Queen - Crazy Little Thing Called Love - Remastered 2011 (User: melons)
The Rubettes - Sugar Baby Love (User: melons)
The Teardrop Explodes - ... and the Fighting Takes Over (User: melons)
Martha and the Muffins - Echo Beach (User: melons)
Bee Gees - Love You Inside Out (User: melons)
David Bowie - Starman - 2012 Remaster (User: melons)
Electric Light Orchestra - Kuiama - 2003 Remaster (User: melons)
Wings - With A Little Luck - Remastered 1993 (User: melons)
The Jesus and Mary Chain - Sometimes Always (User: melons)
Frank Black - Headache (User: melons)
The Wedding Present - Kennedy (User: melons)
Pulp - Babies (User: melons)
Wendy & Bonnie - I Realized You (User: melons)
The Rationals - Glowin' (User: melons)
Matthew E. White - Rock & Roll Is Cold (User: melons)
Bo Hansson - The Black Riders & Flight to the Ford (User: melons)
Land of the Loops - Growing Concern (User: melons)
Gomez - Revolutionary Kind (User: melons)
Cat's Eyes - The Duke Of Burgundy (User: melons)
Chuck Senrick - Dreamin' (User: melons)
Allen Toussaint - Country John (User: melons)
Loudon Wainwright III - The Swimming Song (User: melons)
Oppenheimer Analysis - Don't Be Seen With Me (User: melons)
Arab Strap - Compersion, Pt. 1 (User: melons)
Tony Allen - Go Back (User: melons)
La Sera - Real Boy (User: melons)
U.S. Girls - Rage Of Plastics (User: melons)
This Is the Kit - Silver John (User: melons)
Ramsey Lewis - Les Fleur (User: melons)
Spike Fuck - Body By Crystal (User: melons)
Amon Düül II - She Came Through the Chimney (User: melons)
A.L. Lloyd & Alf Edwards - The Unfortunate Rake (User: melons)
Charles Watson - Voices Carry Through the Mist (User: melons)
Goldfrapp - Happiness (User: melons)
Fifty Foot Hose - God Bless The Child (User: melons)
Fifty Foot Hose - Red The Sign Post (User: melons)
Esquivel and His Orchestra - Mini Skirt (User: melons)
Fifty Foot Hose - Rose (User: melons)
Jay Som - Devotion (User: melons)
Jay Som - Devotion (User: melons)
Fadoul - Al Zman Saib (User: melons)
Garland Jeffreys - Wild In The Streets (User: melons)
Big Star - O My Soul (User: melons)
The Byrds - Triad (User: melons)
Will Powers - Dancing For Mental Health (User: melons)
The Cure - Why Can't I Be You? (User: melons)
Buffalo Daughter - Socks, Drugs And Rock'n'roll - 2022 Remastered (User: melons)
David Hasselhoff - Head On (User: melons)
Sonic Youth - Death Valley '69 (w/ Lydia Lunch) (User: melons)
Hüsker Dü - Celebrated Summer (User: melons)
R.E.M. - Can't Get There From Here - Remastered (User: melons)
Dead or Alive - Lover Come Back (To Me) (User: melons)
Miami Sound Machine - Conga! (User: melons)
Marti Jones - Lonely Is (As Lonely Does) (User: melons)
Destruction - Bestial Invasion (User: melons)
Kix - Midnite Dynamite (User: melons)
Platinum Blonde - Crying Over You (User: melons)
Freddie Mercury - I Was Born To Love You (User: melons)
G. Craig Ball - Tasty Pig Feet ! (User: melons)
Lambrusco Dark - Decorticator (User: melons)
GNR - Dunas (User: melons)
譚詠麟 - 愛情陷阱 (User: melons)
Indochine - 3e Sexe (User: melons)
Arcadia - Election Day (User: melons)
ABC - Be Near Me (User: melons)
'Til Tuesday - Voices Carry (User: melons)
Friend - THIS DOG DON'T BITE (User: melons)
D.ST. - The Home of Hip Hop (User: melons)
Toddy Tee - Batterram - 12" Vocal Version (User: melons)
Schoolly D - P.S.K. 'What Does It Mean'? (User: melons)
Fine Young Cannibals - Johnny Come Home (User: melons)
Prince - Raspberry Beret (User: melons)
DeBarge - Rhythm of the Night (User: melons)
Stevie Wonder - Part-Time Lover (User: melons)
Sudan Archives - Selfish Soul (User: melons)
Lou Barlow - Home (User: melons)
Adam and the Ants - Physical (You're So) - Single Version (User: melons)
Honeyrider - Honeyrider - Superstar Love Machine (User: melons)
Momus - The Hairstyle of the Devil (User: melons)
Free Kitten - Never Gonna Sleep (User: melons)
Madlib - Road of the Lonely Ones (User: melons)
GANGgajang - Sounds of Then (This Is Australia) (User: melons)
Prince - Temptation (User: melons)
Isley, Jasper, Isley - Caravan of Love (User: melons)
ぬいぐるみクレヨン Lush Crayon - パームサンデー (User: melons)
Aretha Franklin - Freeway of Love - Single Mix (User: melons)
Cherrelle - Saturday Love (User: melons)
Secret Shine - Spellbound (User: melons)
The Mekons - Hard to Be Human Again (User: melons)
Redskins - Kick over the statues! (User: melons)
The Chameleons - Singing Rule Britannia (User: melons)
Colourbox - The Moon Is Blue (User: melons)
Duran Duran - A View to a Kill (User: melons)
Lone Justice - Ways To Be Wicked (User: melons)
Meat Puppets - Up on the Sun (User: melons)
Faith No More - We Care a Lot (User: melons)
The Rah Band - Clouds Across the Moon (User: melons)
Neneh Cherry - Manchild (User: melons)
Magazine - The Light Pours Out Of Me (User: melons)
Darrow Fletcher - What Good Am I Without You (User: melons)
The Beatles - Sun King - Remastered 2009 (User: melons)
The Pointer Sisters - Dirty Work (User: melons)
Nolan Porter - If I Could Only Be Sure (User: melons)
Ebo Taylor - will you promise (User: melons)
The Jesus and Mary Chain - Sometimes Always (User: melons)
Manfred Mann Chapter Three - One Way Glass (User: melons)
Guided by Voices - Game of Pricks (User: melons)
R.E.M. - I Believe (User: melons)
dEUS - Little Arithmetics (User: melons)
Sugar - A Good Idea (User: melons)
Kállay Saunders - go slow (User: melons)
Lynda Randle - 'Til the Storm Passes By (User: melons)
Tainy - Adicto (with Anuel AA & Ozuna) (User: melons)
William Onyeabor - Atomic Bomb (User: melons)
Ahmed Fakroun - Nisyan (User: melons)
Mahmoud Ahmed - Fetsum Denq LeDJ Nèsh (User: melons)
Le Tigre - Hot Topic (User: melons)
Queen - Cool Cat - Remastered 2011 (User: melons)
Koji Kikkawa - にくまれそうなNEWフェイス - LIVE (User: melons)
Splitsing - Wind en zeilen (User: melons)
John Kennedy's Love Gone Wrong - King Street (User: melons)
Fellini - Rock Europeu (User: melons)
Gamma Like Very Ultra - Wes Parker's Allergy Song (User: melons)
Sonic Youth - Tuff Gnarl (User: melons)
Dead Sea - Lotion (User: melons)
Javier Santiago - Intro - ReBirth (User: melons)
Greenskeepers - Lotion (User: melons)
Tuffy - Dog Bless You (User: melons)
Boy/Girl - bite! (User: melons)
The Arrogant Worms - Malcolm (User: melons)
Judy Henske - High Flying Bird (User: melons)
Soulwax - E Talking (User: melons)
Jurassic 5 - Work It Out (User: melons)
Risto - Rakkauden Rock (User: melons)
The The - Sweet Bird Of Truth (User: melons)
BC Camplight - Atom Bomb (User: melons)
Hawkwind - Quark, Strangeness and Charm (User: melons)
Betty Wright - Shoorah! Shoorah! (User: melons)
The B-52's - Roam (User: melons)
En Attendant Ana - Same Old Story (User: melons)
Chet Baker - Look for the Silver Lining (User: melons)
Purple Kloud - Fend (User: melons)
Sansa Asylum - Ravens in Autumn (User: melons)
The Husbands - I Idolize you (User: melons)
Swarm of Angels - Narcoleptic's Romance (User: melons)
New Collapse - Reconstruct (User: melons)
Autonervous - Love Sick (User: melons)
Control Alt Deus - Aftermath (extended vocal mix by Aktivehate) (User: melons)
Felix White - Rudderless (User: melons)
David Rudder - High Mass (User: melons)
Jorgie Porter - Quivia Andrews (User: melons)
Pussycat - Georgie (User: melons)
On Being An Angel - You Say (User: melons)
Alice Donut - Where Is My Mind (User: melons)
WY - A Walk Outside (User: melons)
Steve Buscemi's Dreamy Eyes - Forever (User: melons)
Per och Olof - Händerna (User: melons)
Nova Blast - Lost&Found (User: melons)
New Feelings - Hitman (User: melons)
Melby - Overthinking (User: melons)
Mary Anne's Polar Rig - Dopamine Detox (User: melons)
Loaver - Songs we use (User: melons)
Lilla Parasit - Feather Soul (User: melons)
Kluster B - Backseat Liberty (User: melons)
Kindsight - Who Are You (User: melons)
Kindsight - Hi Life (User: melons)
Julia Rakel - Next Xmas (User: melons)
Jo Yonderly - Giant golden frog (User: melons)
Jerka - Living on my own (User: melons)
Hippopotamus - Horse Race (User: melons)
Gula Blend - Va ifred (User: melons)
Guds Pengar - Komet (User: melons)
E. Björklund - Klarar mig själv (User: melons)
Delsbo Beach Club - Cryin' (Such a disgrace) (User: melons)
Chez Ali - Shake Shack (User: melons)
Cat Princess - Marxist with a Twist (User: melons)
Benz - Murder Serenade (User: melons)
änsendå - Dödläge (User: melons)
Mary Anne's Polar Rig - Something About Your Way (User: melons)
Talking Flowers - Bedroom Wall (User: melons)
Talking Flowers - Storytelling (User: melons)
Library Card - Sunflowers (User: melons)
Nature TV - Summer Nights (User: melons)
OPENSIGHT - Another New Beginning (User: melons)
afternoon bike ride - Grid Search (User: melons)
Vincent - True Love (User: melons)
Crime Of Passing - Interlude (User: melons)
Goody Goody - #1 Dee Jay (Single Version) (User: melons)
Daryll Dobson - Final Frontier (User: melons)
Eddie Kendricks - Date With The Rain (User: melons)
Stark Reality - Merry Go Round (User: melons)
salami rose joe louis - Suddenly (User: melons)
salami rose joe louis - Suddenly (User: melons)
Helvetia - Lower Case (User: melons)
Stelvio Cipriani - Vicino A Te (User: melons)
Stelvio Cipriani - L'attesa (User: melons)
Bruno Nicolai - Terzo Delitto (User: melons)
Stelvio Cipriani - L'attesa (User: melons)
The Holydrug Couple - Lunes 1 De Abril (User: melons)
Rendez Vous - The Others (User: melons)
Amir Bresler - Please Do (User: melons)
Aurat - الزام (User: melons)
Liquids - Malignant Humor (User: melons)
Triptides - Wake (User: melons)
Automatic - Electrocution (User: melons)
Plums - Fine Madeline (User: melons)
Macabre Plaza - Till the Wheels Fall Off (User: melons)
Sports Coach - stretching (User: melons)
Sin Kitty - Wondering (User: melons)
Triathalon - GARDEN 2 - Spencer. Remix (User: melons)
Sin Kitty - Wondering (User: melons)
Sven Wunder - Hanami (User: melons)
PVA - Comfort Eating (User: melons)
Brijean - Drive Slow (User: melons)
Pat Martino - Both Sides Now (User: melons)
Luigi Malatesta - Gungala nido (User: melons)
Pat Martino - Both Sides Now (User: melons)
Breakwater - No Limit (User: melons)
I Marc 4 - Trama nella metropoli (User: melons)
Stove - Duckling Fantasy (User: melons)
Stuck - Serf the Web (User: melons)
Alan Tew - THE FENCE (A) (User: melons)
Azymuth - Unknown Jam (User: melons)
Bruce Sherman - Slow R&B (User: melons)
Mother Lion - I'm The Fool (User: melons)
Galt Macdermot - And He Will Not Come Again (User: melons)
Paul Collins - I don't fit in (User: melons)
Cube - Concert Boy - Original 12" Version (User: melons)
The Sweet Enoughs - Cabin Days (User: melons)
Pachyman - Sunset Sound (User: melons)
KOLUMBO - Evening Time (User: melons)
KOLUMBO - Felicia (User: melons)
Blood Orange - The Complete Knock (User: melons)
Nightlife Unlimited - Tell Me (User: melons)
Anadol - Görünmez Hava (User: melons)
Giuliano Sorgini - Diversivo (User: melons)
Magdy Al Hussainy - Music de Carnaval (User: melons)
Galt Macdermot - Come Away Death (User: melons)
blue smiley - spin (User: melons)
Cavern of Anti-Matter - Phase Modulation Shuffle (Edit) (User: melons)
Twilight - Scorpittiarus (User: melons)
Geoffrey Landers - Camella (User: melons)
Princess Demeny - New York Grief '86 (User: melons)
Hollow Ship - Magic Mountain (User: melons)
Yusef Lateef - Love Theme From Spartacus - Remastered (User: melons)
Felt - Destination (User: melons)
STERÖID - S.M.O.K.E SHOW (User: melons)
Speed, Glue & Shinki - DON'T SAY NO - 2017 Remaster (User: melons)
Gabriel Yared - Bungalow Zen (User: melons)
The System - Almost Grown (User: melons)
The Sylvers - Only One Can Win (User: melons)
Eric Copeland - Motor (User: melons)
Polyrock - Your Dragging Feet (User: melons)
The Soft Moon - Try (User: melons)
Evans Pyramid - Never Gonna Leave You (User: melons)
Rogér Fakhr - Had to Come Back Wet (User: melons)
Angelyne - My list (User: melons)
Straw Man Army - Faces In The Dark (User: melons)
Bailey's Nervous Kats - First Love (User: melons)
John Tropea - Can't Hide Love (User: melons)
Grant Green - maybe tomorrow (User: melons)
Aldo Nova - Fantasy (User: melons)
Pylon - Cool - Extra (User: melons)
Pet Shimmers - Mortal Sport Argonaut (User: melons)
Tommy Blake - Lordy Hoody (User: melons)
Jeff Phelps - Excerpts From Autumn (Instrumental) (User: melons)
Don Shirley - This Nearly Was Mine (User: melons)
atoem - Particles (User: melons)
Poppyheads - This One's For You (User: melons)
Gentle Despite - Darkest Blue (User: melons)
Poppyheads - Dreamabout (User: melons)
The Springfields - Sunflower (User: melons)
The Golden Dawn - George Hamilton's Dead (User: melons)
St. Christopher - You Deserve More Than a Maybe (User: melons)
St. Christopher - You Deserve More Than a Maybe (User: melons)
The Sea Urchins - Please Rain Fall (User: melons)
Another Sunny Day - I'm in Love With a Girl Who Doesn't Know I Exist (User: melons)
The Orchids - It's Only Obvious (User: melons)
The Beatles - For No One - Remastered 2009 (User: melons)
Candi Staton - Young Hearts Run Free (User: melons)
Manic Street Preachers - Mausoleum - Remastered (User: melons)
Roxy Music - To Turn You On (User: melons)
Siouxsie and the Banshees - Ornaments of Gold (User: melons)
Lou Reed - New York Telephone Conversation (User: melons)
Jawbreaker - Do You Still Hate Me? (User: melons)
Fugazi - Smallpox Champion (User: melons)
Merle Haggard - I Think I ll Just Stay Here And Drink - Re-Recorded (User: melons)
Björk - Jóga (User: melons)
Camp Lo - Luchini Aka This Is It (User: melons)
Bob Mould - Sinners and Their Repentances (User: melons)
Arcade Fire - Empty Room (User: melons)
The Pharcyde - Soul Flower - Remix (User: melons)
Young Marble Giants - Constantly Changing (User: melons)
The Modern Lovers - Astral Plane (User: melons)
The Jesus and Mary Chain - The Hardest Walk (User: melons)
Donny Hathaway - You've Got A Friend - LIVE (User: melons)
Sleater-Kinney - The Drama You've Been Craving (User: melons)
Geto Boys - Mind Of A Lunatic (User: melons)
Grateful Dead - Casey Jones - 2013 Remaster (User: melons)
Blondie - Will Anything Happen (User: melons)
Beat Happening - Honey Pot (User: melons)
近藤浩治 - Super Mario Bros. Main Theme (User: melons)
Devo - That's Pep (User: melons)
Dead Kennedys - Let's Lynch the Landlord (User: melons)
Devo - That's Pep (User: melons)
Hole - Softer, Softest (User: melons)
Bobbie Gentry - Hurry, Tuesday Child (User: melons)
Can - Mushroom (User: melons)
Liz Phair - Soap Star Joe - Remastered (User: melons)
J Dilla - The Diff'rence (User: melons)
Richard Hell - Another World - 2017 Remaster Audio; Remastered (User: melons)
Gang of Four - Guns Before Butter (User: melons)
Aphex Twin - #5 (User: melons)
Andrew W.K. - She Is Beautiful (User: melons)
They Might Be Giants - We Want a Rock (User: melons)
Serge Gainsbourg - L'Hôtel Particulier (User: melons)
c0ncernn - go white enby go (User: melons)
Talking Heads - Heaven (User: melons)
Portishead - Biscuit (User: melons)
Aretha Franklin - Never Grow Old - Live at New Temple Missionary Baptist Church, Los Angeles, CA, 01/13/72 (User: melons)
Television - Guiding Light (User: melons)
Dinosaur Jr. - Poledo (User: melons)
The Rolling Stones - Far Away Eyes - Remastered (User: melons)
Johnny Cash - Thirteen (User: melons)
Ween - Baby Bitch (User: melons)
Nine Inch Nails - That's What I Get (User: melons)
Fleetwood Mac - Honey Hi - 2015 Remaster (User: melons)
Radiohead - Motion Picture Soundtrack (User: melons)
Slint - Breadcrumb Trail (User: melons)
Pavement - Father to a Sister of Thought (User: melons)
Public Enemy - Louder Than a Bomb (User: melons)
Israel Kamakawiwo'ole - White Sandy Beach of Hawai'i (User: melons)
Van Dyke Parks - Van Dyke Parks (User: melons)
The Magnetic Fields - Reno Dakota (User: melons)
The Flaming Lips - The Big Ol' Bug Is the New Baby Now (User: melons)
Brian Eno - Everything Merges With The Night - 2004 Digital Remaster (User: melons)
Big Star - Daisy Glaze (User: melons)
Nas - One Love (feat. Q-Tip) (User: melons)
Elliott Smith - Oh Well, Okay (User: melons)
Wire - Reuters - 2006 Remastered Version (User: melons)
The Flying Burrito Brothers - Juanita (User: melons)
The Pogues - I'm a Man You Don't Meet Every Day (User: melons)
Richard & Linda Thompson - Did She Jump Or Was She Pushed? (User: melons)
Slayer - Aggressive Perfector (User: melons)
Black Sabbath - Lord of This World (User: melons)
Patti Smith - Birdland (User: melons)
Throbbing Gristle - Exotica (User: melons)
Tom Waits - Frank's Wild Years (User: melons)
Nick Drake - Harvest Breed (User: melons)
Belle and Sebastian - The Stars of Track and Field (User: melons)
PJ Harvey - Rub 'til It Bleeds (User: melons)
A Tribe Called Quest - Ham 'N' Eggs (User: melons)
Steely Dan - Josie (User: melons)
Minutemen - #1 Hit Song (User: melons)
The Byrds - Wasn't Born To Follow (User: melons)
Stevie Wonder - Pastime Paradise (User: melons)
Sonic Youth - Eric's Trip (Album Version) (User: melons)
Guided by Voices - Gold Star For Robot Boy (User: melons)
The Who - Armenia City In The Sky - Incl. Two Radio London Jingles (User: melons)
Bob Dylan - Ballad of a Thin Man (User: melons)
my bloody valentine - I Only Said (User: melons)
Bob Dylan - Ballad of a Thin Man (User: melons)
The Stone Roses - This Is The One - Remastered (User: melons)
Nirvana - Serve the Servants (User: melons)
The Stone Roses - This Is The One - Remastered (User: melons)
Sly & The Family Stone - (You Caught Me) Smilin' - Single Version (User: melons)
Pixies - Gouge Away (User: melons)
Beastie Boys - Egg Man (User: melons)
Neutral Milk Hotel - The Fool (User: melons)
The Band - In A Station - Remastered 2000 (User: melons)
David Bowie - Subterraneans - 2017 Remaster (User: melons)
Bruce Springsteen - My Hometown (User: melons)
MC5 - I Want You Right Now (User: melons)
David Bowie - Subterraneans - 2017 Remaster (User: melons)
MC5 - I Want You Right Now (User: melons)
DJ Shadow - Midnight in a Perfect World (User: melons)
Jeff Buckley - Forget Her (User: melons)
R.E.M. - West of the Fields (User: melons)
Elvis Costello & The Attractions - Moods For Moderns (User: melons)
Ramones - Havana Affair - 2016 Remaster (User: melons)
The Beach Boys - Don't Talk (Put Your Head On My Shoulder) - Mono / Remastered (User: melons)
The Rolling Stones - Turd on the Run (User: melons)
The Replacements - Tommy Gets His Tonsils Out (User: melons)
Radiohead - Electioneering (User: melons)
Jethro Tull - Locomotive Breath - Steven Wilson Stereo Remix (User: melons)
James Brown - I Don't Mind - Live At The Apollo Theater/1962 (User: melons)
The Beatles - One After 909 - Remastered 2009 (User: melons)
The Velvet Underground - The Black Angel's Death Song (User: melons)
Prince - The Ballad of Dorothy Parker (User: melons)
Joy Division - Candidate - 2007 Remaster (User: melons)
Jimi Hendrix - 1983...(A Merman I Should Turn To Be) (User: melons)
ABBA - Does Your Mother Know (User: melons)
Pink Floyd - Lucifer Sam - 2011 Remaster (User: melons)
The Smiths - Rusholme Ruffians - 2011 Remaster (User: melons)
The Kinks - Phenomenal Cat - 2018 Stereo Remaster (User: melons)
Neil Young - The Needle and the Damage Done - 2009 Remaster (User: melons)
Love - Bummer in the Summer - 2015 Remaster (User: melons)
The Fatima Mansions - Popemobile to Paraguay (User: melons)
The Go-Betweens - Head Full of Steam - Remastered (User: melons)
The Go-Betweens - Head Full of Steam - Remastered (User: melons)
Bow Wow Wow - Go Wild in the Country (User: melons)
The Raincoats - Fairytale in the Supermarket (User: melons)
Chic - My Forbidden Lover (User: melons)
Neil Young - Journey Through the Past (User: melons)
Orange Juice - Consolation Prize (User: melons)
Caroline Rose - More of the Same (User: melons)
Lala Lala - Siren 042 (User: melons)
Tired Lion - Fresh (User: melons)
Anna of the North - Meteorite (User: melons)
Amanda Tenfjord - Die Together (User: melons)
AJJ - brave as a noun (User: melons)
Flower Face - Spiracle (User: melons)
Press Club - Suburbia (User: melons)
Waaju - Listening Glasses (User: melons)
Captain Beefheart & His Magic Band - Big Eyed Beans from Venus (User: melons)
WAAX - Labrador (User: melons)
Captain Beefheart & His Magic Band - Big Eyed Beans from Venus (User: melons)
Magazine - Back To Nature - 2007 Digital Remaster (User: melons)
ABBA - One of Us (User: melons)
Todd Rundgren - Zen Archer - 2015 Remaster (User: melons)
The Specials - Stereotype / Stereotype, Pt. 2 - 2015 Remaster (User: melons)
The Soft Boys - Queen of Eyes (User: melons)
ABC - All Of My Heart (User: melons)
The Residents - The Walrus Hunt (User: melons)
The Residents - The Walrus Hunt (User: melons)
Curtis Mayfield - When Seasons Change (User: melons)
Hüsker Dü - The Girl Who Lives on Heaven Hill (User: melons)
Dead Kennedys - MTV Get Off the Air (User: melons)
Rites of Spring - For Want Of (User: melons)
The Dead Milkmen - Bitchin' Camaro (User: melons)
Free Cake For Every Creature - i wanna make you bread (User: melons)
Manu Dibango - Electric Africa - Remastered (User: melons)
Yoko Oginome - ダンシング・ヒーロー(Eat You Up) (User: melons)
Kid Abelha - Lágrimas e chuva (User: melons)
Lorna G - Giro (User: melons)
Yabby You - Stranger To My Bredrin (User: melons)
UB40 - V's Version (User: melons)
Suzanne Vega - Marlene on the Wall (User: melons)
The Dream Academy - Life in a Northern Town (User: melons)
Feargal Sharkey - A Good Heart (User: melons)
a-ha - The Sun Always Shines on T.V. (User: melons)
Clio - Faces - Prod. by Roberto Ferrante - 2020 Remaster (User: melons)
The Cool Notes - Spend The Night (User: melons)
Book of Love - Boy (User: melons)
The Style Council - Walls Come Tumbling Down (User: melons)
Run–D.M.C. - King Of Rock (User: melons)
Midge Ure - If I Was (User: melons)
The Hooters - And We Danced (User: melons)
Mr. Eco - Salad Bar Nation (User: melons)
Robert Wyatt - The Age Of Self (User: melons)
Rose Laurens - American Love (User: melons)
The Communards - You Are My World (User: melons)
Corey Hart - Never Surrender (User: melons)
The Cult - She Sells Sanctuary (User: melons)
The Outfield - Your Love (User: melons)
BC Camplight - Fire in England (User: melons)
Phil Cordell - RED LADY (User: melons)
Earth, Wind & Fire - September (User: melons)
Isobel Campbell - Come Undone (User: melons)
Lee Dorsey - Love Lots of Lovin' (feat. Betty Harris) (User: melons)
John Martyn - Auntie Aviator (User: melons)
Dandy Livingstone - Let's Come Together (User: melons)
The Lewis Express - Danca De Duas Maos (User: melons)
Pretenders - Tattooed Love Boys - 2006 Remaster (User: melons)
Habibi - Nice (User: melons)
Maximum Balloon - Tiger (User: melons)
Joe Goddard - Home (User: melons)
Gorky's Zygotic Mynci - Let's Get Together (In Our Minds) (User: melons)
Pet Shop Boys - I Wouldn't Normally Do This Kind of Thing - Beatmasters Mix; 2001 Remaster (User: melons)
Isaac Hayes - Good Love 6-9-9-6-9 (User: melons)
Boots and Cats - Dinosaur Dance (User: melons)
Sly & The Family Stone - Everyday People (User: melons)
BC Camplight - Fire in England (User: melons)
R.E.M. - Can't Get There From Here (User: melons)
Aztec Camera - Still On Fire (User: melons)
R.E.M. - Can't Get There From Here (User: melons)
Parsley Sound - Ease Yourself and Glide (User: melons)
The Goon Sax - Make Time 4 Love (User: melons)
Chas & Dave - Ain't No Pleasing You (User: melons)
Four Tet - Two Thousand And Seventeen (User: melons)
Bill Callahan - Riding For the Feeling (User: melons)
Scarce - All Sideways (User: melons)
McAlmont & Butler - Yes - Full Version (User: melons)
Manic Street Preachers - Yes - Remastered (User: melons)
McAlmont & Butler - Yes - Full Version (User: melons)
Sweeping Promises - Hunger for a Way Out (User: melons)
Kate Bush - Running Up That Hill (A Deal with God) (User: melons)
Gary Moore - Out in the Fields (User: melons)
Harry Nilsson - Jump into the Fire (User: melons)
Clinic - Distortions (User: melons)
Harry Nilsson - Jump into the Fire (User: melons)
QFX - Freedom (User: melons)
Harrdy Sandhu - Dance Like (User: melons)
Arno - Dance Like a Goose (User: melons)
Electric Choc - Shock The Beat - Original Piano Mix (User: melons)
The Vanities - I'd Rather Die (Than Have a Job in a Tie) (User: melons)
Nicolai Dunger - I'd Rather Die (User: melons)
The Pastels - Comin' Through (User: melons)
The Monochrome Set - Eine Symphonie Des Grauens (User: melons)
The Pastels - Comin' Through (User: melons)
The The - This Is The Day (User: melons)
Unit 4 + 2 - Concrete And Clay (User: melons)
Wilson Pickett - Land Of 1000 Dances (User: melons)
Gorky's Zygotic Mynci - Let's Get Together (In Our Minds) (User: melons)
R.E.M. - Fall On Me - 2011 Remaster (User: melons)
The Wedding Present - Go Out and Get 'em Boy! (User: melons)
A Tribe Called Quest - Jazz (We've Got) (User: melons)
Electric Light Orchestra - Mr. Blue Sky (User: melons)
Beach House - Take Care (User: melons)
Guillemots - Trains to Brazil (User: melons)
Lambchop - Up With People (User: melons)
R.E.M. - Fall on Me (User: melons)
Clinic - Distortions (User: melons)
Pulp - Little Girl (With Blue Eyes) (User: melons)
Dexys Midnight Runners - This is What She's Like (User: melons)
The Clash - This is England - Remastered (User: melons)
The Replacements - Bastards of Young - 2008 Remaster (User: melons)
Talking Heads - Stay up Late - 2005 Remaster (User: melons)
Oingo Boingo - Just Another Day (User: melons)
Maffia - Hallelujah (User: melons)
Newcleus - Space is the Place (User: melons)
Gorky's Zygotic Mynci - Let's Get Together (In Our Minds) (User: melons)
linda di franco - T.V. Scene - Sensurround Mix (User: melons)
Teenage Fanclub - What You Do To Me (User: melons)
Grace Jones - Slave to the Rhythm - Hot Blooded Version (User: melons)
Sly Fox - Let's Go All the Way (User: melons)
Diana Ross - Chain Reaction (User: melons)
Nu Shooz - I Can't Wait (User: melons)
Fishbone - ? (Modern Industry) (User: melons)
Jocelyn Brown - Love's Gonna Get You (User: melons)
The Joubert Singers - Stand on the Word (Studio Version) (User: melons)
The Jets - Crush On You (User: melons)
Tom Waits - Jockey Full of Bourbon (User: melons)
Kim Carnes - Crazy in the Night (Barking at Airplanes) (User: melons)
The Highwaymen - Highwayman (User: melons)
Scritti Politti - Don't Work That Hard (User: melons)
The Colourfield - Castles in the Air (User: melons)
