Jay-Z & Alicia Keys - Empire State of Mind (User: jbwharris)
Brother Ali - Goin' Through It (User: jbwharris)
Dan Le Sac vs Scroobius Pip - Letter from God To Man (User: jbwharris)
Rascalz - Northern Touch (feat. Kardinal Offishall, Thrust, Choclair & Checkmate) [2018 Mix] (User: jbwharris)
A$AP Rocky - F**kin' Problems (feat. Drake, 2 Chainz & Kendrick Lamar) (User: jbwharris)
Eminem - Lose Yourself (Soundtrack Version) (User: jbwharris)
The Streets - Blinded by the Lights (User: jbwharris)
Bakar - Hell N Back (User: jbwharris)
Tech N9ne - Red Kingdom (User: jbwharris)
Shabazz Palaces - Shine a Light (feat. Thaddillac) (User: jbwharris)
Psalm One - Anxious, Nervous and Imperfect (feat. Afrokeys) (User: jbwharris)
Missy Elliott - Work It (User: jbwharris)
Tierra Whack - Dora (User: jbwharris)
Vince Staples - ARE YOU WITH THAT? (User: jbwharris)
Kanye West & The Weeknd - Hurricane (feat. Lil Baby) (User: jbwharris)
Gorillaz - On Melancholy Hill (User: jbwharris)
Cypress Hill - How could I just kill a man (User: jbwharris)
Public Enemy - Bring the Noise (User: jbwharris)
Jay-Z & Kanye West - Gotta Have It (User: jbwharris)
Monie Love - It's a Shame (My Sister) [feat. True Image] (User: jbwharris)
Haviah Mighty - Atlantic (User: jbwharris)
Run the Jewels - goonies vs. E.T. (User: jbwharris)
slowthai - nhs (User: jbwharris)
Digable Planets - Where I'm From (User: jbwharris)
Drake - Best I Ever Had (User: jbwharris)
Guru - Le Bien, Le Mal (User: jbwharris)
Ize - This Is Not a Drill (User: jbwharris)
Eminem - Love the Way You Lie (feat. Rihanna) (User: jbwharris)
JAY-Z - 99 Problems (User: jbwharris)
MC Frontalot feat. Brad Sucks - Livin' At The Corner Of Dude & Catastrophe (User: jbwharris)
The Kid LAROI - WITHOUT YOU (User: jbwharris)
Carter Ace - Baggage (User: jbwharris)
Noel Scales - Hobby (User: jbwharris)
Run the Jewels - 36" Chain (User: jbwharris)
Mitski - Stay Soft (User: jbwharris)
Tune-Yards - Water Fountain (User: jbwharris)
Radiohead - Follow Me Around (User: jbwharris)
Spoon - Lucifer On The Sofa (User: jbwharris)
Big Thief - Time Escaping (User: jbwharris)
Tom Petty & The Heartbreakers - Even the Losers (User: jbwharris)
Hippo Campus - Blew Its (User: jbwharris)
Counting Crows - Mr. Jones (User: jbwharris)
Ed Sheeran - Overpass Graffiti (User: jbwharris)
Tate McRae X Khalid - working (User: jbwharris)
John Mayer - Last Train Home (User: jbwharris)
alt-J - Get Better (User: jbwharris)
Animal Collective - Walker (User: jbwharris)
Sufjan Stevens - Casimir Pulaski Day (User: jbwharris)
Hole - Celebrity Skin (User: jbwharris)
The Traveling Wilburys - Last Night (User: jbwharris)
Billie Eilish - everything i wanted (User: jbwharris)
Courtney Barnett - Pedestrian at Best (User: jbwharris)
Black Country, New Road - Chaos Space Marine (User: jbwharris)
David Bowie - Life on Mars? (User: jbwharris)
Fleetwood Mac - Go Your Own Way (User: jbwharris)
Patti Smith Group - Because the Night (User: jbwharris)
Low - Disarray (User: jbwharris)
Depeche Mode - It's No Good (User: jbwharris)
Talking Heads - And She Was (User: jbwharris)
The Glorious Sons - Hold Steady (User: jbwharris)
Ron Gallo - Young Lady, You're Scaring Me (User: jbwharris)
54-40 - Baby Ran (User: jbwharris)
Rise Against - Nowhere Generation (User: jbwharris)
Wintersleep - Weighty Ghost (User: jbwharris)
Tokay Lewis - Who Wants Me Now (User: jbwharris)
Major Lance - Since I Lost My Baby’s Love (User: jbwharris)
New Radicals - You Get What You Give (User: jbwharris)
Sarah McLachlan - Into the Fire (User: jbwharris)
Happy Mondays - Step On (User: jbwharris)
Violent Femmes - Gone Daddy Gone (User: jbwharris)
The Beat - Twist & Crawl (User: jbwharris)
Coldplay - Clocks (User: jbwharris)
Haircut 100 - Love Plus One (User: jbwharris)
Feist - My Moon My Man (User: jbwharris)
Nirvana - About a Girl (User: jbwharris)
David Bowie - Lets Dance (User: jbwharris)
Broken Social Scene - Anthems for a Seventeen Year Old Girl (User: jbwharris)
The Walkmen - We've Been Had (User: jbwharris)
Do Nothing - LeBron James (User: jbwharris)
Bronski Beat - Smalltown Boy (User: jbwharris)
Elvis Presley - Mystery Train (User: jbwharris)
Crystal Gayle - Sneakin' Out The Back Door (User: jbwharris)
Marty Robbins - El Paso (User: jbwharris)
Esther Marrow - He Don't Appreciate It' (User: jbwharris)
Merle Haggard - One Day At A Time (User: jbwharris)
The Kinks - I Gotta Move (User: jbwharris)
A Taste of Honey - Rescue Me (User: jbwharris)
Blonde Redhead - In Particular (User: jbwharris)
Lee Dorsey - A Lover Was Born (User: jbwharris)
Madness - It Must Be Love (User: jbwharris)
Shabba Ranks - Twice My Age (User: jbwharris)
The Mohawks - The Champ (User: jbwharris)
War - Low Rider (User: jbwharris)
Bee Gees - Fanny (Be Tender With My Love) (User: jbwharris)
AroarA - #14 (User: jbwharris)
Bill Withers - Harlem (User: jbwharris)
Country Joe & The Fish - Rockin' Round The World (User: jbwharris)
Soak - last july (User: jbwharris)
Spoon - My Babe (User: jbwharris)
David Ellis - Misty Heights (User: jbwharris)
Hawksley Workman - Smoke Baby (User: jbwharris)
Neoni - Carry on Wayward Son (User: jbwharris)
Thin Lear - Maniacs (User: jbwharris)
LCD Soundsystem - Get Innocuous! (User: jbwharris)
Devendra Banhart - A Sight to Behold (User: jbwharris)
The Jesus and Mary Chain - Blues From a Gun (User: jbwharris)
The Odds - Not Another Love Song (User: jbwharris)
Nick Cave & the Bad Seeds - Straight to You (2010 Remastered Version) (User: jbwharris)
Sloan - Money City Maniacs (User: jbwharris)
MAKE FRIENDS - When Nothing's Said (User: jbwharris)
Gotye - Somebody That I Used to Know (feat. Kimbra) (User: jbwharris)
The River South - There's Nothing Beneath Us (User: jbwharris)
Set Sail - I Can't Get Enough (User: jbwharris)
Holy Ghost! - Epton on Broadway, Pt. 1 (User: jbwharris)
Andy Shauf - Try Again (User: jbwharris)
Kate Nash - Pumpkin Soup (User: jbwharris)
Sarah Harmer - Basement Apt. (User: jbwharris)
Built to Spill - I Would Hurt a Fly (User: jbwharris)
Built to Spill - Reasons (User: jbwharris)
Whitney - No Woman (User: jbwharris)
The Clash - I'm So Bored With the U.S.A. (User: jbwharris)
Foxes in Fiction - Memory Pools (User: jbwharris)
The Constantines - Working Full-Time (User: jbwharris)
The Beatnuts - Watch Out Now (User: jbwharris)
Swim Good Now - Since U Asked (feat. Merival) (User: jbwharris)
Weezer - The Good Life (User: jbwharris)
Arlo Parks - Softly (User: jbwharris)
Diamond Ortiz - Boomerang (User: jbwharris)
Kurt Vile - Baby's Arms (User: jbwharris)
Dylan Sinclair - Just Anybody (User: jbwharris)
The Modern Lovers - Roadrunner (User: jbwharris)
MISC - Une chiée (User: jbwharris)
Stefani Kimber - Bad Luck (User: jbwharris)
Ill Considered - First Light (User: jbwharris)
Bon Iver - Skinny Love (User: jbwharris)
MGMT - Congratulations (User: jbwharris)
Mulherin - On Me (feat. Dijon) (User: jbwharris)
Abigoba - So What (User: jbwharris)
The Telescopes - And Let Me Drift Away (User: jbwharris)
Devin Tracy - ThinkOfYou (User: jbwharris)
Fontaines D.C. - A Hero's Death (User: jbwharris)
Mark Lettieri - Red Dwarf (User: jbwharris)
beabadoobee - He Gets Me So High (User: jbwharris)
Rancid - Time Bomb (User: jbwharris)
USS (Ubiquitous Synergy Seeker) - Who's With Me (User: jbwharris)
Beastie Boys - Sure Shot (User: jbwharris)
Whitney Houston - I Have Nothing (User: jbwharris)
Modest Mouse - Float On (User: jbwharris)
Calum Jones - Change For the Better (User: jbwharris)
The Birthday Party - Release the Bats (User: jbwharris)
Adrian Chalifour - Open Heart (User: jbwharris)
Michael Jackson - Don't Stop 'Til You Get Enough (User: jbwharris)
Billy Joel - Piano Man (User: jbwharris)
The Decemberists - Down by the Water (User: jbwharris)
Ella Fitzgerald & Joe Pass - Nature Boy (User: jbwharris)
Jason Collett - Rave On Sad Songs (User: jbwharris)
spencer. - bbybbybby (User: jbwharris)
One Nine - Difficult Days (User: jbwharris)
The Beaches - Snake Tongue (User: jbwharris)
Jan Davis - Watusi Zombie (User: jbwharris)
Yukon Blonde - Saturday Night (User: jbwharris)
Leon Vynehall - Sugar Slip (The Lick) (User: jbwharris)
Freya Ridings - Maps (User: jbwharris)
Sanders Bohlke - Smalltown Boy (User: jbwharris)
The Revivalists - All My Friends (User: jbwharris)
The Waking Eyes - On a Train (User: jbwharris)
Old Man Luedecke - Wait A While (User: jbwharris)
Taylor Knox - The Stars (User: jbwharris)
K1 N15 - You're Not Rolling (User: jbwharris)
SR-71 - Right Now (User: jbwharris)
Joy Oladokun - breathe again (User: jbwharris)
M.I.L.K. - Need A Witness (User: jbwharris)
Moon Duo - Sleepwalker (User: jbwharris)
Arlo Parks - Romantic Garbage (User: jbwharris)
yunè pinku - Affection (User: jbwharris)
Kaleo - All The Pretty Girls (User: jbwharris)
John K. Samson - Requests (User: jbwharris)
Barrie - Darjeeling (User: jbwharris)
Jason Derulo - Want To Want Me (User: jbwharris)
The Birds - No Good Without You (User: jbwharris)
Japandroids - The House That Heaven Built (User: jbwharris)
Junkhouse - Praying For The Rain (User: jbwharris)
The White Stripes - Jolene (User: jbwharris)
World Party - Way Down Now (User: jbwharris)
John K. Samson - Millennium for All (User: jbwharris)
Meron T & Paya - Can We (User: jbwharris)
Aerosmith - I Don't Want to Miss a Thing (User: jbwharris)
Waxahatchee - Lilacs (User: jbwharris)
The Rescues - Losing my religion (User: jbwharris)
Sky - Some Kinda Wonderful (User: jbwharris)
Concrete Blonde - Everybody Knows (User: jbwharris)
Winston Marshall - Althea (feat. Kodiak Blue & Shura) (User: jbwharris)
Ryan Adams & The Cardinals - Down In A Hole (User: jbwharris)
Jamie Lidell - Another Day (Rustie Remix) (User: jbwharris)
Rolling Blackouts Coastal Fever - The Way It Shatters (User: jbwharris)
IceBoy Violet - Vanity (User: jbwharris)
The Corrs - I Never Loved You Anyway (User: jbwharris)
The Fratellis - Chelsea Dagger (User: jbwharris)
New Order - Love Vigilantes (User: jbwharris)
Arctic Monkeys - I Bet You Look Good on the Dancefloor (User: jbwharris)
Lila Tristram - Leaving Song (User: jbwharris)
Maeta - Babygirl (User: jbwharris)
AJ Mitchell - Everytime (Cover) (User: jbwharris)
Luxe - A83 (User: jbwharris)
Roy Ayers - Hummin' (User: jbwharris)
Bend Sinister - Shannon (User: jbwharris)
The Smith Street Band - Chips & Gravy (User: jbwharris)
Cuff the Duke - Take My Money And Run (User: jbwharris)
DJ Hank - Stay (User: jbwharris)
The Watchmen - All Uncovered (User: jbwharris)
Catherine Feeny - Police State (User: jbwharris)
Cut Copy - Out There on the Ice (User: jbwharris)
Ryan Shaw - Love In Pain (feat. Rob Thomas & Derek Trucks) (User: jbwharris)
Masayoshi Fujita - Cloud of Light (User: jbwharris)
Patti Smith - Gimme Shelter (User: jbwharris)
The Hold Steady - Unpleasant Breakfast (User: jbwharris)
The Go-Go's - This Town (User: jbwharris)
Hannah Georgas - No Need To Argue (feat. Lucius) (User: jbwharris)
Blind Melon - No Rain (User: jbwharris)
Urban Dance Squad - Demagogue (User: jbwharris)
Mission of Burma - That's When I Reach for My Revolver (User: jbwharris)
The Barbarians - Moulty (User: jbwharris)
LETCHI - Insane (User: jbwharris)
Mk.gee - Priorities (User: jbwharris)
Bob James - (Take Me To The) Mardi Gras (7-inch version) (User: jbwharris)
Charles Wesley Godwin - Strong (User: jbwharris)
Betty Davis - Game Is My Middle Name (User: jbwharris)
Jaclyn Davies - Cheap Thrills (feat. Kyle Nachtigal) (User: jbwharris)
The Tangerine Zoo - Wake Up Sun (User: jbwharris)
Mississippi John Hurt - Boys, You're Welcome (User: jbwharris)
Aero Flynn - Twist (User: jbwharris)
Harry Nilsson - Everybody's Talkin' (From "Midnight Cowboy") (User: jbwharris)
Andy Gibb - I Just Want to Be Your Everything (User: jbwharris)
Kaleo - Break My Baby (User: jbwharris)
The The - This Is The Day (User: jbwharris)
Faith No More - We Care a Lot (User: jbwharris)
Childish Gambino - IV. Sweatpants (User: jbwharris)
Ben Hauke & Cecil B - Concrete Womb (User: jbwharris)
Aidan Knight - Jasper (User: jbwharris)
Courtney Marie Andrews - If I Told (User: jbwharris)
Jahkoy - Granted (User: jbwharris)
Uss - Big Life (26 Letters) (User: jbwharris)
Beirut - Postcards From Italy (User: jbwharris)
Idman - Down For It (User: jbwharris)
Oumou Sangare - Saa Magni (User: jbwharris)
Sufjan Stevens - Holland (User: jbwharris)
The Dandy Warhols - Bohemian Like You (User: jbwharris)
Robert Connely Farr - If It Was Up To Me (User: jbwharris)
emawk - tea (User: jbwharris)
Janis Ian - At Seventeen (User: jbwharris)
Lil Nas X - THATS WHAT I WANT (User: jbwharris)
Swedish House Mafia, The Weeknd - Moth To A Flame - Extended Mix (User: jbwharris)
New Order - Shellshock (User: jbwharris)
Lloyd Cole and The Commotions - Perfect Skin (User: jbwharris)
Shannon Lyon - backyard song (User: jbwharris)
Smashing Pumpkins - Today (User: jbwharris)
The Tragically Hip - The Darkest One (User: jbwharris)
Santrofi-Ansa - shakabula (User: jbwharris)
Carson McHone - Still Life (User: jbwharris)
The Fall - Pat-Trip Dispenser (User: jbwharris)
Foals - 2am (User: jbwharris)
Spoon - Held (User: jbwharris)
The Creatures - Miss The Girl (User: jbwharris)
Cleopatrick - Hometown (User: jbwharris)
Matt Maeson - Hallucinogenics (User: jbwharris)
Buck Owens - My Heart Skips a Beat (User: jbwharris)
Jean Ritchie - A Short Life Of Trouble (User: jbwharris)
Arca - Estrogen (User: jbwharris)
Charley Crockett - I Need Your Love (User: jbwharris)
The Head and the Heart - Virginia (Wind In The Night) (User: jbwharris)
yunè pinku - Affection (User: jbwharris)
Smog - Held (User: jbwharris)
Samm Henshaw - Chicken Wings (User: jbwharris)
Frank Ocean - Pink + White (User: jbwharris)
Scott Walker - Copenhagen (User: jbwharris)
Michael Kiwanuka - All My Life (User: jbwharris)
Catrin Finch & Seckou Keita - Ceffylau (User: jbwharris)
Imagine Dragons - Whatever It Takes (User: jbwharris)
St Dominic's Trio - One Day (User: jbwharris)
Serge Gainsbourg - En Melody (User: jbwharris)
F!res - The Lonely Sea (User: jbwharris)
The Mountain Goats - Going Invisible 2 (User: jbwharris)
Midnight Oil - Blue Sky Mine (2011 Remaster) (User: jbwharris)
Mylo - Drop The Pressure (User: jbwharris)
Tami Neilson - Sister Mavis (User: jbwharris)
Corb Lund - Rye Whiskey / Time To Switch To Whiskey (User: jbwharris)
Roberta Flack - Jesse (User: jbwharris)
Jon Batiste - CRY (User: jbwharris)
Juniore - Panique (User: jbwharris)
Thundercat - Unrequited Love (User: jbwharris)
Enter Shikari - Sorry You're Not a Winner (User: jbwharris)
Kaiser Chiefs - Ruby (User: jbwharris)
Ramones - Blitzkrieg Bop (2016 Remaster) (User: jbwharris)
Gully Boys - Russian Doll (User: jbwharris)
AJ Mitchell - Everytime (Cover) (User: jbwharris)
David Ellis - Misty Heights (User: jbwharris)
The Black Crowes - Jealous Again (User: jbwharris)
Arctic Monkeys - American Sports (User: jbwharris)
The Church - Under the Milky Way (User: jbwharris)
Margo Price - Pay Gap (User: jbwharris)
Jackson Browne - The Pretender (User: jbwharris)
Doves - The Man Who Told Everything (Summer Version) (User: jbwharris)
Hiss Golden Messenger - Biloxi (User: jbwharris)
Andy Bell - World Of Echo (User: jbwharris)
Nation of Language - Wounds of Love (User: jbwharris)
Terror Sheets - Sword (User: jbwharris)
Big Nothing - Always on My Mind (User: jbwharris)
Spoon - Held (User: jbwharris)
Spoon - On The Radio (User: jbwharris)
Laundromat - Combo (User: jbwharris)
Brother Ali - Goin' Through It (User: jbwharris)
Destroyer - Eat the Wine, Drink the Bread (User: jbwharris)
Ought - Habit (User: jbwharris)
Hollerado - Pick Me Up (User: jbwharris)
HÆLOS - Kyoto (User: jbwharris)
Faye Webster - In a Good Way (User: jbwharris)
The Weather Station - Tried To Tell You (User: jbwharris)
Róisín Murphy - Murphy’s Law (User: jbwharris)
Ducks Ltd. - Grand Final Day (User: jbwharris)
Ibibio Sound Machine - All That You Want (User: jbwharris)
Amber Mark - One (User: jbwharris)
Sonic Youth - Dirty Boots (User: jbwharris)
Kim Gordon - Grass Jeans (User: jbwharris)
Lush - Kiss Chase (User: jbwharris)
The Devil and Her Chauffeur - Never Let Me Go (User: jbwharris)
Bonobo - Rosewood (User: jbwharris)
Depeche Mode - Enjoy The Silence (Ricki Tik Tik Mix) (User: jbwharris)
Dawn Richard - Bussifame (User: jbwharris)
Denzel Curry - Walkin (User: jbwharris)
Lucius - Next to Normal (User: jbwharris)
Missing Persons - Destination Unknown (User: jbwharris)
The Avalanches feat. Leon Bridges - Interstellar Love (ft. Leon Bridges) (User: jbwharris)
ODESZA - The Last Goodbye (feat. Bettye LaVette) (User: jbwharris)
The Minders - Hooray For Tuesday (User: jbwharris)
A Flock of Seagulls - Space Age Love Song (User: jbwharris)
Riki - Marigold (User: jbwharris)
Sharon Van Etten - Porta (User: jbwharris)
The Lumineers - Ophelia (User: jbwharris)
The Lumineers - WHERE WE ARE (User: jbwharris)
The Lumineers - BRIGHTSIDE (User: jbwharris)
Warpaint - Champion (User: jbwharris)
Handsome Boy Modeling School - The Truth (User: jbwharris)
Jarv Dee x Bad Colours feat. Shabazz Palaces - Clouds (User: jbwharris)
Curtis Harding - Where's The Love (User: jbwharris)
Gary Clark Jr. - Bright Lights (User: jbwharris)
!!! - All I Wanted Was a Photograph (User: jbwharris)
MGMT - Little Dark Age (User: jbwharris)
TORRES - Wandering Star (User: jbwharris)
Hatchie - Quicksand (User: jbwharris)
The Weeknd - Gasoline (User: jbwharris)
Radiohead - Burn the Witch (User: jbwharris)
Jim James - State of the Art (A.E.I.O.U) (User: jbwharris)
DJ Shadow - Building Steam With a Grain of Salt (User: jbwharris)
Zaki Ibrahim - Orbit 1: One (User: jbwharris)
Khruangbin - B-Side (feat. Leon Bridges) (User: jbwharris)
Delvon Lamarr Organ Trio - I Wanna Be Where You Are (User: jbwharris)
Janelle Monáe - Neon Valley Street (User: jbwharris)
Curtis Mayfield - Break It Down (User: jbwharris)
Robert Glasper feat. Baby Rose & Rapsody - Expectations (User: jbwharris)
Moonchild feat. Mumu Fresh - Don't Hurry Home (User: jbwharris)
Ivy Sole - Otherside (User: jbwharris)
Big K.R.I.T. - Southside of the Moon (User: jbwharris)
Lady Wray - Under The Sun (User: jbwharris)
Stevie Wonder feat. Gary Clark Jr. - Where Is Our Love Song (User: jbwharris)
Gary Clark Jr. feat. Andra Day - Pearl Cadillac (User: jbwharris)
Samm Henshaw - Grow (User: jbwharris)
Experience Unlimited - People (User: jbwharris)
The Chambers Brothers - Uptown (User: jbwharris)
Earl Sweatshirt - Fire in the Hole (User: jbwharris)
Saba feat. Krayzie Bone - Come My Way (User: jbwharris)
Burna Boy - Pull Up (User: jbwharris)
Gyptian - Hold You (Hold Yuh) (User: jbwharris)
Grace Jones - Slave to the Rhythm (User: jbwharris)
Blue Rodeo - Hasn't Hit Me Yet (User: jbwharris)
Blancmange - Don't Tell Me (User: jbwharris)
Metric - Breathing Underwater (User: jbwharris)
Jeff Buckley - Grace (User: jbwharris)
The Cure - Lovesong (User: jbwharris)
Sean Matsukawa - Palm (feat. Kaiya Crawford) (User: jbwharris)
HAIM - Summer Girl (User: jbwharris)
Taylor Knox - The Stars (User: jbwharris)
rum.gold - Where There's Smoke (User: jbwharris)
Leon Vynehall - Sugar Slip (The Lick) (User: jbwharris)
Inhaler - Fade Into You (User: jbwharris)
Mission of Burma - That's When I Reach for My Revolver (User: jbwharris)
Patti Smith - Gimme Shelter (User: jbwharris)
Lee Dorsey - Four Corners (Part 2) (User: jbwharris)
Calum Jones - Change For the Better (User: jbwharris)
Odie - Little Lies (User: jbwharris)
Max Helgemo - Uncovered (User: jbwharris)
Prides - What's Love Got To Do With It (User: jbwharris)
Japanese Breakfast - Posing in Bondage (User: jbwharris)
Lily Denning - Me, Myself & I (User: jbwharris)
Gord Downie - Hotel Worth (User: jbwharris)
MoonLove - Cast Your Troubles and Dreams Away (User: jbwharris)
Mother Mother - Bit By Bit (User: jbwharris)
Self Esteem - I Do This All the Time (User: jbwharris)
Thomas Oliver - Coffee (User: jbwharris)
Peter Gabriel - This Is the Picture (Excellent Birds) (User: jbwharris)
Jeff Buckley - Grace (User: jbwharris)
Margaret Glaspy - Before We Were Together (User: jbwharris)
Mitski - Love Me More (User: jbwharris)
James Yorkston and The Athletes - Midnight Feast (User: jbwharris)
Anne Pigalle - Soho Mon Amour (User: jbwharris)
Grace Petrie - Black Tie (User: jbwharris)
Lynks - Everyone's Hot and I'm Not (User: jbwharris)
Freddie Lewis - Growing Pains (User: jbwharris)
Maritn Carthy & The Watersons - Come Sunday (Radio 1 Session, 13th Dec 1994) (User: jbwharris)
Maritn Carthy & The Watersons - Come Sunday (Radio 1 Session, 13th Dec 1994) (User: jbwharris)
Maritn Carthy & The Watersons - The Swallow (Radio 1 Session, 13th Dec 1994) (User: jbwharris)
Maritn Carthy & The Watersons - Mick Dam (Radio 1 Session, 13th Dec 1994) (User: jbwharris)
Maritn Carthy & The Watersons - Jacobs Well (Radio 1 Session, 13th Dec 1994) (User: jbwharris)
LAVA LA RUE - Vest & Boxers (User: jbwharris)
Ana Silvera - Halos (User: jbwharris)
Eliza Carthy & Norma Waterson - Ukulele Lady (User: jbwharris)
The Weeknd - Dawn FM (User: jbwharris)
The Weeknd - Here We Go… Again (feat. Tyler, the Creator) (User: jbwharris)
Eliza Carthy & Norma Waterson - Poor Wayfaring Stranger (User: jbwharris)
Waterson:Carthy - Death and the Lady (User: jbwharris)
The Weeknd - Less Than Zero (User: jbwharris)
Norma Waterson - The Chaps of Cockaigny (User: jbwharris)
Norma Waterson - The Chaps of Cockaigny (User: jbwharris)
Norma Waterson - Black Muddy River (User: jbwharris)
Waterson:Carthy - When First I Came To Caledonia (User: jbwharris)
Waterson:Carthy - When First I Came To Caledonia (User: jbwharris)
The Waterdaughters - John Ball (User: jbwharris)
Lal Waterson & Mike Waterson - Red Wine Promises (User: jbwharris)
The Weeknd - Phantom Regret by Jim (User: jbwharris)
The Watersons - Seven Virgins (The Leaves of Life) (User: jbwharris)
The Weeknd - Don’t Break My Heart (User: jbwharris)
Labi Siffre - bless the telephone (User: jbwharris)
Dusty Springfield - The Look Of Love (User: jbwharris)
Ezra Furman - Love You So Bad (User: jbwharris)
The Weeknd - Gasoline (User: jbwharris)
Mary Cigarettes - Whatever Turns You On (User: jbwharris)
The Weeknd - Out of Time (User: jbwharris)
Kae Tempest - Firesmoke (User: jbwharris)
The Weeknd - How Do I Make You Love Me? (User: jbwharris)
Lou Reed - Walk on the Wild Side (User: jbwharris)
Janelle Monáe - Make Me Feel (User: jbwharris)
Guided by Voices - Re-Develop (User: jbwharris)
The Undertones - My Perfect Cousin (User: jbwharris)
Weyes Blood - Do You Need My Love (6 Music Session, 12 April 2017) (User: jbwharris)
The Smile - You'll Never Work in Television Again (User: jbwharris)
Beastie Boys - Get It Together (feat. Q‐Tip) (User: jbwharris)
Premiata Forneria Marconi - Celebration (User: jbwharris)
The Dyes - Your Love Has Turned To Hate (User: jbwharris)
Screaming Females - Shake It Off (User: jbwharris)
Eurythmics - You Hurt Me (And I Hate You) (User: jbwharris)
Soursob - SPT (User: jbwharris)
Flat Worms - Circle (User: jbwharris)
Green/Blue - Disregard (User: jbwharris)
Scientists - Dissonance (User: jbwharris)
nicfit - Human Inane (User: jbwharris)
Dion Lunadon - Schreien (User: jbwharris)
The Control Freaks - Get Some Help (User: jbwharris)
The Courettes - Edge of My Nerves (User: jbwharris)
Joy Cleaner - Selling the Mood (User: jbwharris)
The Sad Tomorrows - Unsustainable Practices (User: jbwharris)
The Bevis Frond - Everyone Rise (User: jbwharris)
Courtney Barnett - Write a List of Things to Look Forward To (User: jbwharris)
The Umbrellas - Lonely (User: jbwharris)
Connie Francis - Don't Ever Leave Me (User: jbwharris)
Small Factory - Valentine (User: jbwharris)
T. Valentine - Teen Age Jump (User: jbwharris)
David Bowie - Valentine's Day (User: jbwharris)
The Valentines - Breakaway (User: jbwharris)
The Valentines - I Can't Dance With You (User: jbwharris)
The Original Sins - Hang Me (User: jbwharris)
The Rutles - I Must Be in Love (User: jbwharris)
Pink Slip Daddy - For Lovers Only (User: jbwharris)
Joe Bataan - Subway Joe (User: jbwharris)
The Harvey Averne Band - Stand (User: jbwharris)
Orchestra Harlow - Grazin' In The Grass (Una Miradita De Amor) (User: jbwharris)
Saison - Please Don't Go (User: jbwharris)
Shoshin - Make Moves (User: jbwharris)
Clairo - Amoeba (User: jbwharris)
Sofi Tukker - Original Sin (User: jbwharris)
mindchatter - It's Ok (It's Not Ok) (User: jbwharris)
King Princess - Little Bother (User: jbwharris)
O. Wake - Riper Than Ripe (User: jbwharris)
Arlo Parks - Softly (User: jbwharris)
Disclosure X ZEDD - You've Got To Let Go If You Want To Be Free (User: jbwharris)
Oberka - Saxamaphone (User: jbwharris)
Neil Frances - dancing (User: jbwharris)
Etienne de Crécy - Am I Wrong (User: jbwharris)
Peaness - How I'm Feeling (User: jbwharris)
Rufus Wainwright - Rules and Regulations (User: jbwharris)
Aztec Camera - Oblivious (User: jbwharris)
Florence + the Machine - Dog Days Are Over (User: jbwharris)
Pure - Pure (User: jbwharris)
The Charlatans - The Only One I Know (User: jbwharris)
Joe Jackson - Steppin' Out (User: jbwharris)
Quarteto Em Cy - Tudo Que Você Podia Ser (User: jbwharris)
Earl Scruggs - You Ain't Going Nowhere (User: jbwharris)
The Byrds - You Ain't Goin' Nowhere (User: jbwharris)
Brittany Howard - Short And Sweet feat. Bon Iver (User: jbwharris)
Brittany Howard - Short and Sweet (User: jbwharris)
Sampa the Great - OMG (User: jbwharris)
Gregor - A Song About Holding Hands (User: jbwharris)
Bullion - O Vermona (User: jbwharris)
Timmy Thomas - Why Can't We Live Together (User: jbwharris)
Minnie Riperton - Reasons (User: jbwharris)
Syrinx - Hollywood Dream Trip (User: jbwharris)
Syrinx - Tillicum (User: jbwharris)
Group Listening - Sunset Village (User: jbwharris)
The World - Managerial Material (User: jbwharris)
Ghost - Here Comes The Sun (User: jbwharris)
Frankie Knuckles - Your Love (User: jbwharris)
Van Morrison - Sweet Thing (User: jbwharris)
Dolly Parton - Jolene (User: jbwharris)
Best Coast - Crazy for You (User: jbwharris)
The White Stripes - We're Going to Be Friends (User: jbwharris)
Fizzyfeez - Salo, Ou 42 Mesures De Dépendance... (User: jbwharris)
The Ronettes - Be My Baby (User: jbwharris)
Elvis Costello & The Attractions - I Hope You're Happy Now (User: jbwharris)
Ram John Holder - Brixton Blues (User: jbwharris)
Lo Fidelity Allstars - Battleflag (feat. Pigeonhed) (User: jbwharris)
Bow Wow Wow - C30 C60 C90 Go (User: jbwharris)
A Certain Ratio - I Won't Stop Loving you (Bernard Sumner Remix) (User: jbwharris)
Lush - De-Luxe (User: jbwharris)
July - Dandelion Seeds (User: jbwharris)
Smog - Let's Move to the Country (User: jbwharris)
Lou Reed - Satellite of Love (User: jbwharris)
The Disposable Heroes Of Hiphoprisy - Television The Drug Of The Nation (User: jbwharris)
The Smashing Pumpkins - Tonight, Tonight (User: jbwharris)
Abstract Orchestra - Bistro (User: jbwharris)
Oddisee - That's Love (User: jbwharris)
Smog - Let's Move to the Country (User: jbwharris)
The Walkmen - The Rat (User: jbwharris)
Pierre Henry - Psyche Rock (Fatboy Slim's Malpaso Mix) (User: jbwharris)
Misty's Big Adventure - Home Taping's Killing Music (User: jbwharris)
David Bowie - Drive-In Saturday (Recorded live at the Public Hall, Cleveland on 25/11/72) (User: jbwharris)
The Cramps - New Kind Of Kick (User: jbwharris)
Clams Casino - Water Theme 2 (User: jbwharris)
The Dandy Warhols - Ride (User: jbwharris)
The Yardbirds - Heart Full of Soul (User: jbwharris)
Jockstrap - 50/50 (User: jbwharris)
K1 N15 - You're Not Rolling (User: jbwharris)
Gonzales - Advantage Points (User: jbwharris)
Scott Walker - Copenhagen (User: jbwharris)
Michael Rother & Vittoria Maccabruni - Edgy Smiles (User: jbwharris)
Faith No More - We Care a Lot (original version) (User: jbwharris)
The Barbarians - Moulty (User: jbwharris)
Nilüfer Yanya - Stabalise (User: jbwharris)
Bob Dylan - I've Made Up My Mind to Give Myself to You (User: jbwharris)
The Fall - Pat-Trip Dispenser (User: jbwharris)
Ben Lamar Gay - Aunt Lola and the Quail (User: jbwharris)
The Birds - No Good Without You Baby (User: jbwharris)
Arca - Estrogen (User: jbwharris)
Arca - Estrogen (User: jbwharris)
The Contours - First I Look At The Purse (User: jbwharris)
Santrofi-Ansa - shakabula (User: jbwharris)
QUINQUIS - Adkrog (User: jbwharris)
Kraftwerk - Geiger Counter / Radioactivity (User: jbwharris)
The Mothers of Invention - Trouble Every Day (User: jbwharris)
Catrin Finch & Seckou Keita - Ceffylau (User: jbwharris)
The Cactus Blossoms - Love Tomorrow (User: jbwharris)
Charley Crockett - I Need Your Love (User: jbwharris)
Willie Nelson - Angel Flying Too Close To The Ground (User: jbwharris)
Ian Noe - Pine Grove (Madhouse) (User: jbwharris)
Jeremy Ivey - Orphan Child (User: jbwharris)
Buck Owens - My Heart Skips a Beat (User: jbwharris)
Carson McHone - Still Life (User: jbwharris)
Charles Wesley Godwin - Strong (User: jbwharris)
Patsy Cline - Back in Baby's Arms (User: jbwharris)
The Cactus Blossoms - Ballad of an Unknown (User: jbwharris)
St. Dominic's Trio - One Day (User: jbwharris)
Jason Isbell and The 400 Unit - If We Were Vampires (User: jbwharris)
Foo Fighters - The Last Song (User: jbwharris)
My Morning Jacket - Magic Bullet (User: jbwharris)
Babeheaven - Craziest Things (User: jbwharris)
Maya Jane Coles - Wait For You (feat. Tricky) (User: jbwharris)
Doves - At The Tower (Instrumental Edit) (User: jbwharris)
Noel Gallagher's High Flying Birds - She Taught Me How to Fly (User: jbwharris)
Sloan - I Can't Sleep (User: jbwharris)
The Chemical Brothers - The Devil Is in the Details (User: jbwharris)
The Rifles - When I'm Alone (User: jbwharris)
Jake Bugg - Rabbit Hole (User: jbwharris)
Primitive Radio Gods - Standing Outside a Broken Phone Booth With Money in My Hand (User: jbwharris)
Taylor Swift - mad woman (User: jbwharris)
Inhaler - When It Breaks (User: jbwharris)
The Lumineers - Patience (User: jbwharris)
Placebo vs Kosheen - Hide The Bitter Placebo (DJ Sandstorm) (User: jbwharris)
Gorillaz - Don't Get Lost in Heaven (User: jbwharris)
Sylvan Esso - Kick Jump Twist (User: jbwharris)
Starflyer 59 - Messed Up Over You (User: jbwharris)
Bronze Radio Return - There Will Be Another (User: jbwharris)
Our Lady Peace - Naveed (User: jbwharris)
Kaleo - Way Down We Go (User: jbwharris)
Imagine Dragons - Whatever It Takes (User: jbwharris)
Mötley Crüe - Kickstart My Heart (User: jbwharris)
Mumford & Sons - Little Lion Man (User: jbwharris)
Commodores - Easy (User: jbwharris)
Chic - Dance, Dance, Dance (Yowsah, Yowsah, Yowsah) (User: jbwharris)
Ace of Base - All That She Wants (User: jbwharris)
Shabazz Palaces feat. Thaddillac - Shine a Light (User: jbwharris)
The Weeknd - Sacrifice (User: jbwharris)
The Weeknd - Phantom Regret by Jim (User: jbwharris)
Sex Pistols - God Save the Queen (User: jbwharris)
Queen - Get Down, Make Love (User: jbwharris)
KC and The Sunshine Band - Keep It Comin’ Love (User: jbwharris)
Toro y Moi - Postman (User: jbwharris)
Kanye West - Moon (User: jbwharris)
Foals - 2am (User: jbwharris)
Glass Animals - heat waves (slowed) (User: jbwharris)
alt‐J - The Actor (User: jbwharris)
Andy Gibb - I Just Want to Be Your Everything (User: jbwharris)
Brothers Johnson - Strawberry Letter 23 (User: jbwharris)
Hole - Violet (User: jbwharris)
Doja Cat - Celebrity Skin (User: jbwharris)
Spoon - Wild (User: jbwharris)
Arlo Parks - Softly (User: jbwharris)
Portugal. The Man - What, Me Worry? (User: jbwharris)
Eric Hilton - Artifact22 (User: jbwharris)
Earth, Wind & Fire - Serpentine Fire (User: jbwharris)
Vanilla - Still Love U (User: jbwharris)
Fred again.., Romy & HAAi - Lights Out (User: jbwharris)
Bonobo feat. Miguel Atwood‐Ferguson - Polyghost (User: jbwharris)
Betty Davis - Game Is My Middle Name (User: jbwharris)
Joi - If I'm In Luck I Just Might Get Picked Up (User: jbwharris)
Rolling Blackouts Coastal Fever - The Way It Shatters (User: jbwharris)
Blue Öyster Cult - Searchin’ for Celine (User: jbwharris)
Nirvana - About a Girl (User: jbwharris)
Isaiah Rashad - THIB (User: jbwharris)
Kokoroko - Something's Going On (User: jbwharris)
Roy Ayers - Hummin' (User: jbwharris)
Velella Velella - Glower Power (User: jbwharris)
Wet Leg - Too Late Now (User: jbwharris)
Cloakroom - A Force at Play (User: jbwharris)
Say She She, Piya Malik - Forget Me Not (User: jbwharris)
DJ Hank - Stay (User: jbwharris)
Cassius - Foxxy (User: jbwharris)
Hundred Waters - Xtalk (User: jbwharris)
King Gizzard & The Lizard Wizard - Interior People Confidence Man Remix (User: jbwharris)
Animal Collective - We Go Back (User: jbwharris)
Sam Prekop - Ghost (User: jbwharris)
D'Angelo - Feel Like Makin' Love (User: jbwharris)
Aero Flynn - Twist (User: jbwharris)
The Lowest of the Low - Bleed A Little While Tonight (User: jbwharris)
Lowest of the Low - Bleed a Little While Tonight - 2018 Remaster (User: jbwharris)
The Lowest of the Low - Bleed A Little While Tonight (User: jbwharris)
Death from Above 1979 - Freeze Me (User: jbwharris)
Trans-X - Living on Video (User: jbwharris)
Armand van Helden - Flowerz (12" version) (User: jbwharris)
Bend Sinister - Truth II (User: jbwharris)
Phoebe Bridgers - Kyoto (User: jbwharris)
Cleopatrick - Hometown (User: jbwharris)
Boy Golden - KD and Lunch Meat (User: jbwharris)
The Smashing Pumpkins - Tonight, Tonight (User: jbwharris)
ODESZA - The Last Goodbye (feat. Bettye LaVette) (User: jbwharris)
Tokyo Police Club - Bambi (User: jbwharris)
Bella Clava - I Forgot My Mantra (User: jbwharris)
The Joy Formidable - Into The Blue (User: jbwharris)
Tres Leches - Fireworks (User: jbwharris)
Fiona Apple - Criminal (User: jbwharris)
The Soundcarriers - Traces (User: jbwharris)
Shifting Gears - Drum Nation (User: jbwharris)
Sweeping Promises - Hunger for a Way Out (User: jbwharris)
Yard Act - Rich (User: jbwharris)
Shamir - Marriage (User: jbwharris)
Samm Henshaw - Chicken Wings (User: jbwharris)
Erykah Badu - Sometimes... (User: jbwharris)
Fontaines D.C. - Jackie Down The Line (User: jbwharris)
Celeste - Stop This Flame (User: jbwharris)
Trio Mocotó - Nao Adianta (User: jbwharris)
Menomena - Five Little Rooms (User: jbwharris)
Radiohead - Weird Fishes/Arpeggi (User: jbwharris)
Nilüfer Yanya - midnight sun (User: jbwharris)
The Dodos - Quiet Voices (User: jbwharris)
The Dodos - Pale Horizon (User: jbwharris)
The Dodos - Annie (User: jbwharris)
The Dodos - The Surface (User: jbwharris)
Smog - Held (User: jbwharris)
Spoon - Lucifer On The Sofa (User: jbwharris)
Spoon - Satellite (User: jbwharris)
Spoon - Astral Jacket (User: jbwharris)
Spoon - On The Radio (User: jbwharris)
Spoon - Feels Alright (User: jbwharris)
Spoon - My Babe (User: jbwharris)
Spoon - Wild (User: jbwharris)
Spoon - The Devil & Mister Jones (User: jbwharris)
Spoon - The Hardest Cut (User: jbwharris)
Spoon - Held (User: jbwharris)
EVE 6 - Inside Out (User: jbwharris)
Big Wreck - Locomotive (User: jbwharris)
The Shins - New Slang (User: jbwharris)
Arcade Fire - Rebellion (User: jbwharris)
Beth Ditto - I'm Alive (User: jbwharris)
Blink - All the Small Things (User: jbwharris)
Liam Gallagher - Everything’s Electric (User: jbwharris)
Liam Gallagher - Everything's Electric (User: jbwharris)
Smashing Pumpkins - Bullet With Butterfly Wings (User: jbwharris)
Metallica - The Unforgiven (User: jbwharris)
Built to Spill - Carry the Zero (User: jbwharris)
Sloan - If It Feels Good Do It (User: jbwharris)
Milagros Mendoza - Como Ayer (User: jbwharris)
Snow Patrol - Chasing Cars (User: jbwharris)
Shamir - Nuclear (User: jbwharris)
Curtis Harding - Can't Hide It (User: jbwharris)
F!res - The Lonely Sea (User: jbwharris)
Deerhunter - Never Stops (User: jbwharris)
Black Rebel Motorcycle Club - Stop (User: jbwharris)
The Head and the Heart - Virginia (Wind In The Night) (User: jbwharris)
Big Thief - Certainty (User: jbwharris)
alt‐J - Walk A Mile (User: jbwharris)
Delvon Lamarr Organ Trio - Get Da Steppin' (User: jbwharris)
Daft Punk - Giorgio by Moroder (User: jbwharris)
Donna Summer - I Feel Love (User: jbwharris)
Mexican Institute of Sound - México (User: jbwharris)
Beck - Wow (GUAU! Mexican Institute of Sound Remix) (User: jbwharris)
Arlo Parks - Softly (User: jbwharris)
Kavinsky Feat. Tyson - First Blood (User: jbwharris)
The Who - Baba O’Riley (User: jbwharris)
Björk - Big Time Sensuality (LP Version) (User: jbwharris)
Vero - BEG! (User: jbwharris)
The Presidents of the United States of America - Peaches (User: jbwharris)
Shuggie Otis - Strawberry Letter 23 (User: jbwharris)
Betty Davis - If I'm In Luck I Might Get Picked Up (User: jbwharris)
Shocking Blue - Love Buzz (User: jbwharris)
Fontaines D.C. - A hero's death (Soulwax remix) (User: jbwharris)
Sly & The Family Stone - Everyday People (User: jbwharris)
Lizzo - Good as Hell (User: jbwharris)
Plastic Bertrand - Ça plane pour moi (User: jbwharris)
INXS - Don’t Change (User: jbwharris)
Hot Chip - dancing in the dark (User: jbwharris)
Wet Leg - Too Late Now (User: jbwharris)
Elastica - S.O.F.T. (User: jbwharris)
Aesop Rock - Kirby (User: jbwharris)
Blue Scholars - Slick Watts (User: jbwharris)
Orville Peck - Daytona Sand (User: jbwharris)
The Undertones - Teenage Kicks (User: jbwharris)
Joy Division - Transmission (User: jbwharris)
ODESZA - The Last Goodbye (feat. Bettye LaVette) (User: jbwharris)
Mary J. Blige - Good Morning Gorgeous (User: jbwharris)
The Verve - Bitter Sweet Symphony (User: jbwharris)
The Andrew Oldham Orchestra - The Last Time (User: jbwharris)
Best Coast - When I’m With You (User: jbwharris)
Fleetwood Mac - Dreams (User: jbwharris)
Warpaint - Champion (User: jbwharris)
Broken Social Scene - Anthems for a Seventeen Year‐Old Girl (User: jbwharris)
Lusine feat. Vilja Larjosto - Two Dots (User: jbwharris)
The Beatles - I’m Only Sleeping (User: jbwharris)
Durand Jones & The Indications Feat. Y La Bamba - Cruisin' to the Parque (User: jbwharris)
Change - The Time (User: jbwharris)
D'Angelo - Feel Like Makin’ Love (User: jbwharris)
Saba feat. Day Wave - 2012 (User: jbwharris)
Bocafloja feat. Immasoul - Diaspora y Blues (User: jbwharris)
Ivy Sole - Talk that Talk (User: jbwharris)
Lady Wray - Through It All (User: jbwharris)
Lilblackkids - Planet Of The Blues (User: jbwharris)
Ramp - Come Into Knowledge (User: jbwharris)
The Congos - Congoman (User: jbwharris)
Nneka - Space (User: jbwharris)
Erykah Badu - Honey (User: jbwharris)
The Staple Singers - For What It's Worth (User: jbwharris)
Julian Taylor Band - Set Me Free (User: jbwharris)
Carson McHone - Still Life (User: jbwharris)
Dacey - SUMMERTIMEISDONE (User: jbwharris)
Tobi - Don't Touch! (User: jbwharris)
Sharon Jones & The Dap-Kings - 100 Days, 100 Nights (User: jbwharris)
Harry Nilsson - Everybody's Talkin' (From "Midnight Cowboy") (User: jbwharris)
Rheostatics - Here Come The Wolves (User: jbwharris)
Hanson - Mmmbop (User: jbwharris)
Nick Cave & the Bad Seeds - Into My Arms (2011 Remastered Edition) (User: jbwharris)
Ryan Adams & The Cardinals - Down In A Hole (User: jbwharris)
Omar Apollo - Erase (User: jbwharris)
The Unicorns - I Was Born (A Unicorn) (User: jbwharris)
Kate Bush - Running Up That Hill (A Deal with God) (User: jbwharris)
Sleater-Kinney - Worry With You (User: jbwharris)
Van Morrison - Into the Mystic (User: jbwharris)
Vance Joy - Missing Piece (User: jbwharris)
Melt Yourself Down - Balance (User: jbwharris)
Neon Trees - Don't You Want Me (User: jbwharris)
MGMT - Congratulations (User: jbwharris)
Tatiana Hazel - IN MY ROOM! (User: jbwharris)
X - The New World (User: jbwharris)
Sofía Valdés - The Sweet Escape (User: jbwharris)
Grace Potter - I'd Rather Go Blind (User: jbwharris)
boy pablo - i hope she loves me back (User: jbwharris)
Jaclyn Davies - Cheap Thrills (feat. Kyle Nachtigal) (User: jbwharris)
Abhinav Sarswat - Fake Tiger vs. Real Dog (User: jbwharris)
French Horn Rebellion - Caaalifornia (feat. Ghost Beach) [The Soundmen Remix] (User: jbwharris)
Of Monsters and Men - Little Talks (User: jbwharris)
Mad8 vs. Shawn Christopher - Just Another Sleepless Night (Out Of Office Remix) (User: jbwharris)
The Beatles - I Want You (She's So Heavy) (User: jbwharris)
Jarvis Cocker - Paroles Paroles (feat. Laetitia Sadier) (User: jbwharris)
nicfit - Stink (User: jbwharris)
The Avener & Tiwayo - Wild (The Avener Rework) (User: jbwharris)
Leif Vollebekk - Into the Ether (User: jbwharris)
Issy Wood - Muscle (User: jbwharris)
Arlo Parks - Softly (User: jbwharris)
Famous Persona - Ivy (User: jbwharris)
Blockhead - Old Man Yells At Clouds (User: jbwharris)
Goldie, James Davidson & Subjective - Sunlight (feat. Lady Blackbird) (User: jbwharris)
Pynch - The Whole World's Going Crazy (For Love) (User: jbwharris)
Sam Fender - Hypersonic Missiles (User: jbwharris)
Run the Jewels - Ju$t (Ft. Pharrell Williams and Zach De La Rocha) (User: jbwharris)
Emma Charles - Connecticut (User: jbwharris)
Superchunk - Driveway to Driveway (User: jbwharris)
Brandon Wolfe Scott - Razor Love (feat. STACEY) (User: jbwharris)
AJ Mitchell - Everytime (Cover) (User: jbwharris)
Kari Faux - Color Theory (feat. Leven Kali) (User: jbwharris)
Lila Tristram - Leaving Song (User: jbwharris)
One Nine - Difficult Days (User: jbwharris)
FKJ - Lying Together (User: jbwharris)
Trey Graves - Rockabye (feat. Alanna) (User: jbwharris)
David Bowie - Modern Love (2018 Remaster) (User: jbwharris)
The Verve - Slide Away (User: jbwharris)
YellowStraps - Goldress (feat. VYNK) (User: jbwharris)
C+C Music Factory - Gonna Make You Sweat (Everybody Dance Now) (User: jbwharris)
Cyprine & Shake the Disease - Keep Aah (User: jbwharris)
Kilo Kish - NICE OUT (User: jbwharris)
The Goo Goo Dolls - Iris (User: jbwharris)
The Black Crowes - Jealous Again (User: jbwharris)
Soft Cell - Heart Like Chernobyl (User: jbwharris)
The Snuts - Glasgow (User: jbwharris)
tarsiers - Camel (User: jbwharris)
Young Guv - Lo Lo Lonely (User: jbwharris)
Maxi Millz - Burning Ears (User: jbwharris)
Cheap Teeth - Tough Times at the Day Bar (User: jbwharris)
Buffalo Nichols - Lost & Lonesome (User: jbwharris)
Djo - Roddy (User: jbwharris)
The Doobie Brothers - What A Fool Believes (2016 Remastered) (User: jbwharris)
Leon Vynehall - Sugar Slip (The Lick) (User: jbwharris)
Sugar - If I Can't Change Your Mind (User: jbwharris)
Weeping Tile - Basement Apt. (User: jbwharris)
The National - Hey Rosey (User: jbwharris)
The Decemberists - The Wrong Year (User: jbwharris)
Phillip Hamilton - Urbane (feat. Bubby Lewis) (User: jbwharris)
Wayne Anthony - Blow me a kiss (User: jbwharris)
Garbage - #1 Crush (Nellee Hooper Mix) (User: jbwharris)
Self Esteem - Just Kids (User: jbwharris)
Oh Wonder - Without You (User: jbwharris)
Ella Fitzgerald & Joe Pass - Nature Boy (User: jbwharris)
Bachelor Girl - Permission To Shine (User: jbwharris)
Sister Nancy - Ain't No Stopping Nancy (User: jbwharris)
Mitski - Love Me More (User: jbwharris)
Hillsburn - Low Light (User: jbwharris)
The Lemonheads - Into Your Arms (User: jbwharris)
Christine and the Queens - Damn (what must a woman do) (User: jbwharris)
Rolling Blackouts Coastal Fever - The Way It Shatters (User: jbwharris)
Okay Kaya - You’re Still the One (User: jbwharris)
Weston Estate - Saturday Nights (User: jbwharris)
The Menzingers - Strangers Forever (User: jbwharris)
David Bowie - Star (User: jbwharris)
Adeline Hotel - Some Kind of Joke (User: jbwharris)
Micah P. Hinson - She Don‚t Own Me (User: jbwharris)
Calum Jones - Change For the Better (User: jbwharris)
Maeta - Babygirl (User: jbwharris)
Mr. Oizo - Flat Beat (User: jbwharris)
Burton Cummings - You Saved My Soul (User: jbwharris)
Podipto - I'm Going to Canada (Studio Demo) (User: jbwharris)
Freya Ridings - Maps (User: jbwharris)
The Bangles - Eternal Flame (User: jbwharris)
Coldplay X BTS - My Universe (User: jbwharris)
Devin Tracy - ThinkOfYou (User: jbwharris)
R.E.M. - Losing My Religion (User: jbwharris)
Middle Kids - Questions (User: jbwharris)
The Sadies - The Most Despicable Man (User: jbwharris)
Pentangle - Haitian Fight Song (User: jbwharris)
Soak - last july (User: jbwharris)
Sloan - Losing California (User: jbwharris)
Colony House - You Know It (User: jbwharris)
Oscar Thorburn - Burning Out (User: jbwharris)
Willie Nelson - Always on My Mind (User: jbwharris)
Hot Hot Heat - Goodnight Goodnight (User: jbwharris)
Parquet Courts - Ducking & Dodging (User: jbwharris)
Land of Talk - Inner Lover (User: jbwharris)
Deep Tan - beginners' krav maga (User: jbwharris)
Snacks? - Wide Awake (User: jbwharris)
Tokyo Police Club - DLTFWYH (User: jbwharris)
The Corrs - I Never Loved You Anyway (User: jbwharris)
Eagles - Take It Easy (User: jbwharris)
Elvis Presley - Love Me Tender (First 'STAND-UP' show) (User: jbwharris)
Ellis - Buried Myself (User: jbwharris)
Young Magic - The Dancer (User: jbwharris)
Captain Beefheart & His Magic Band - I'm Gonna Booglarize You Baby (User: jbwharris)
The Sea and Cake - Rinky-D**k O.S. Type Rip (Designer Remix) (User: jbwharris)
Carole King - It's Too Late (User: jbwharris)
The Sheepdogs - Please Don't Lead Me On (User: jbwharris)
IDLES - The Beachland Ballroom (User: jbwharris)
NewDad - Ladybird (User: jbwharris)
Mississippi John Hurt - Boys, You're Welcome (User: jbwharris)
The Glorious Sons - Everything Is Alright (User: jbwharris)
Cassels - Beth's Recurring Dream (User: jbwharris)
New Kids on the Block - Step by Step (User: jbwharris)
Patti Smith - Gimme Shelter (User: jbwharris)
Ditz - I Am Kate Moss (User: jbwharris)
Blur - There's No Other Way (User: jbwharris)
The Dragons - Urantia Plains (User: jbwharris)
The Beatles - Helter Skelter (User: jbwharris)
Stefani Kimber - Bad Luck (User: jbwharris)
Mitski - Valentine, Texas (User: jbwharris)
Tokyo Police Club - Ready to Win (User: jbwharris)
UMI - river (User: jbwharris)
Roger Miller - King Of The Road (User: jbwharris)
The Smiths - William, It Was Really Nothing (User: jbwharris)
The Lowest of the Low - Salesmen, Cheats and Liars (User: jbwharris)
Ryan Shaw - Love In Pain (feat. Rob Thomas & Derek Trucks) (User: jbwharris)
Prides - What's Love Got To Do With It (User: jbwharris)
Muse - Feeling Good (User: jbwharris)
Fast Eddie - Acid Thunder (User: jbwharris)
Dawes - When My Time Comes (User: jbwharris)
AlunaGeorge - Attracting Flies (User: jbwharris)
Die Realität - Nur die Realität (User: jbwharris)
QUICKLY, QUICKLY - Feel (User: jbwharris)
Dominique Fils-Aimé - Go Get It (User: jbwharris)
Half Moon Run - Grow Into Love (User: jbwharris)
Robert DeLong - Did it To Myself (User: jbwharris)
Robert DeLong - Did it To Myself (User: jbwharris)
Chaka Khan - Like Sugar (User: jbwharris)
Lucius - Next to Normal (User: jbwharris)
Julia Michaels - If You Need Me (User: jbwharris)
Ruby Waters - Blow (User: jbwharris)
Bakar - The Mission (User: jbwharris)
Erykah Badu;Common - Love Of My Life (User: jbwharris)
Erykah Badu - Love Of My Life (User: jbwharris)
Erykah Badu;Common - Love Of My Life (User: jbwharris)
Foals - Wake Me Up (User: jbwharris)
OMBIIGIZI - Cherry Coke (User: jbwharris)
Lido Pimienta - Eso Que Tu Haces (User: jbwharris)
The Chemical Brothers - The Darkness That You Fear (User: jbwharris)
Mumford & Sons - Little Lion Man (User: jbwharris)
The Dragons - Urantia Plains (User: jbwharris)
Wide Mouth Mason - My Old Self (User: jbwharris)
Land of Talk - Compelled (User: jbwharris)
XTC - Dear God (User: jbwharris)
Mississippi John Hurt - Boys, You're Welcome (User: jbwharris)
Mitski - Love Me More (User: jbwharris)
Olivia Rodrigo - brutal (User: jbwharris)
Yeah Bud!!! - Bfffffs (User: jbwharris)
54-40 - Ocean Pearl (User: jbwharris)
The Charlatans - Sproston Green (User: jbwharris)
Reverend Baron - Waiting on You (User: jbwharris)
Priestgate - Eyes Closed For The Winter (User: jbwharris)
Blonde Redhead - 23 (User: jbwharris)
Jai Paul - He (User: jbwharris)
Phil Collins - In the Air Tonight (User: jbwharris)
John Van Deusen - You Don't Know What You're Asking (User: jbwharris)
Live - I Alone (User: jbwharris)
alt-J - Hunger of the Pine (User: jbwharris)
Vampire Weekend - Unbearably White (User: jbwharris)
Liam Gallagher - Everything's Electric (User: jbwharris)
Franz Ferdinand - Take Me Out (User: jbwharris)
Big Audio Dynamite II - Rush (User: jbwharris)
The Style Council - My Ever Changing Moods (User: jbwharris)
The Specials - Enjoy Yourself (User: jbwharris)
54-40 - Ocean Pearl (User: jbwharris)
R.E.M. - Stand (User: jbwharris)
The Psychedelic Furs - Heartbreak Beat (User: jbwharris)
Arkells - Leather Jacket (User: jbwharris)
Crowded House - Weather with You (User: jbwharris)
Talking Heads - Burning Down the House (User: jbwharris)
Boots Randolph - Yakety Sax (User: jbwharris)
Juno Falls - The last love song (User: jbwharris)
Arcade Fire - Crucified Again (User: jbwharris)
Andy Shauf - You're Out Wasting (User: jbwharris)
Tuns - We Stand United (User: jbwharris)
Princeton - Ms. Bentwich (User: jbwharris)
Boards of Canada - Pete Standing Alone (User: jbwharris)
The Chemical Brothers - MAH (User: jbwharris)
Danny L Harle & Lil Texas - Dreaming (User: jbwharris)
The Black Crowes - Wyoming & Me (User: jbwharris)
Sex Pistols - Submission (User: jbwharris)
Radiohead - There There (User: jbwharris)
Morcheeba - Rome Wasn't Built in a Day (User: jbwharris)
Carm - Land (feat. Justin Vernon) (User: jbwharris)
The Lazy Eyes - Fuzz Jam (User: jbwharris)
Matthew Good - One Of Them Years (User: jbwharris)
Lindsey Bitson - Wash (User: jbwharris)
The Decemberists - Won't Want for Love (Margaret in the Taiga) (User: jbwharris)
Arcade Fire - Keep the Car Running (User: jbwharris)
10,000 Maniacs - Like the Weather (User: jbwharris)
Crash Vegas - Red Earth (User: jbwharris)
Duran Duran - Girls on Film (User: jbwharris)
The Smashing Pumpkins - Drown (User: jbwharris)
The Tragically Hip - Ahead By A Century (User: jbwharris)
Our Lady Peace - Temporary Healing (User: jbwharris)
Our Lady Peace - Good Die Young (User: jbwharris)
Our Lady Peace - Simulation (User: jbwharris)
Our Lady Peace - RK4.Escape Velocity (feat. EMTEE) (User: jbwharris)
Our Lady Peace - Run (User: jbwharris)
Our Lady Peace - 19 Days (User: jbwharris)
Our Lady Peace - Future Disease (User: jbwharris)
Our Lady Peace - Wish You Well (User: jbwharris)
Our Lady Peace - The Message (User: jbwharris)
Our Lady Peace - Holes (User: jbwharris)
Our Lady Peace - Stop Making Stupid People Famous (feat. Pussy Riot) (User: jbwharris)
Phillip Hamilton - Urbane (feat. Bubby Lewis) (User: jbwharris)
Queens of the Stone Age - Feet Don't Fail Me (User: jbwharris)
a-ha - Take On Me (User: jbwharris)
Survivor - Eye of the Tiger (User: jbwharris)
Hop Along - Tibetan Pop Stars (User: jbwharris)
Arctic Monkeys - When the Sun Goes Down (User: jbwharris)
Self Esteem - It's Been a While (User: jbwharris)
Bryson Briight - Foolish (User: jbwharris)
Joel Plaskett - Frontlines of the Hard Times (User: jbwharris)
Julia Jacklin - Don't Know How To Keep Loving You (User: jbwharris)
Nyokabi Kariuki - Equator song (User: jbwharris)
