Basement Jaxx - Fly Life (User: jbwharris)
808 State - Time Bomb (User: jbwharris)
Ron Trent - The Afterlife (User: jbwharris)
KMFDM - Megalomaniac (User: jbwharris)
The Prodigy - Mindfields (User: jbwharris)
Kendrick Lamar - i (User: jbwharris)
Lil Baby - The Bigger Picture (User: jbwharris)
Blood Orange - Sandra's Smile (User: jbwharris)
Sweet Honey In The Rock - Joanne Little (User: jbwharris)
Beyonce - black parade (User: jbwharris)
Public Enemy - Fight the Power (User: jbwharris)
Tracy Chapman - Talkin' Bout a Revolution (User: jbwharris)
Xiuhtezcatl - Take It All Back (User: jbwharris)
Vince Staples - Hands Up (User: jbwharris)
Lauryn Hill - Black Rage (User: jbwharris)
Bob Marley & The Wailers - Get Up, Stand Up (User: jbwharris)
B.B. King - Swing Low Sweet Chariot (User: jbwharris)
Our Native Daughters - Mama's Cryin' Long (User: jbwharris)
Bill Withers - Lean on Me (User: jbwharris)
The Spinners - Ghetto Child (User: jbwharris)
Michael Kiwanuka - Black Man In A White World (User: jbwharris)
Willie Dunn - I Pity The Country (User: jbwharris)
John Legend - Glory ft. Common (User: jbwharris)
Grandmaster Flash and The Furious Five - The Message (User: jbwharris)
Swidt - SEIZE THE DAY (feat. Savage) (User: jbwharris)
KRS-One - Sound of da Police (User: jbwharris)
Marvin Gaye - What's Going On (User: jbwharris)
Snotty Nose Rez Kids - The Warriors (User: jbwharris)
Bob Marley - Redemption Song (User: jbwharris)
Kendrick Lamar - DNA (User: jbwharris)
Joey Badass - For My People (User: jbwharris)
Leanne Betasamosake Simpson - I Pity The Country (User: jbwharris)
Prince - Baltimore (User: jbwharris)
Jorja Smith - Blue Lights (User: jbwharris)
Bobby Sanchez - Quechua 101 Land Back Please (User: jbwharris)
Link Wray - Genocide (User: jbwharris)
Curtis Mayfield - We People Who Are Darker Than Blue (User: jbwharris)
Our Native Daughters - Black Myself (User: jbwharris)
2Pac - Changes (User: jbwharris)
Gil Scott-Heron - The Revolution Will Not Be Televised (User: jbwharris)
Stevie Wonder - Living for the City (User: jbwharris)
Dakota Bear - Setbacks (User: jbwharris)
D'Angelo and The Vanguard - 1000 Deaths (User: jbwharris)
Beyoncé - Freedom (User: jbwharris)
Laura Mvula - Overcome (Ft. Nile Rodgers) (User: jbwharris)
Joy Harjo - Calling the Spirit Back (User: jbwharris)
Hozier - Nina Cried Power (feat. Mavis Staples) (User: jbwharris)
Yuri Petrovski - True (User: jbwharris)
Ralph Castelli - Morning Sex (User: jbwharris)
Nu - Man O To (User: jbwharris)
Axel Boman - Purple Drank (User: jbwharris)
Diplo - Heartless (feat. Morgan Wallen) (User: jbwharris)
Jamiroquai - Cloud 9 (User: jbwharris)
The Chemical Brothers - Gravity Drops (User: jbwharris)
Fatboy Slim - Sunset (Bird of Prey) (User: jbwharris)
Dan Mangan - Robots (User: jbwharris)
Leftfield - Afrika Shox (User: jbwharris)
Sarah McLachlan - Adia (User: jbwharris)
Underworld - Dark & Long (User: jbwharris)
Soulwax - Essential Four (User: jbwharris)
808 State - Cübik (User: jbwharris)
The Chemical Brothers - In Dust We Trust (User: jbwharris)
The Chemical Brothers - Star Guitar (User: jbwharris)
Underworld - Moaner (User: jbwharris)
The Prodigy - Breathe (User: jbwharris)
The Beatles - Not a Second Time (User: jbwharris)
The Smiths - Well I Wonder (User: jbwharris)
Bob Dylan - In My Time of Dyin' (User: jbwharris)
Lee Hazlewood - Break My Mind (User: jbwharris)
Dinosaur Jr. - Drawerings (User: jbwharris)
Lana Del Rey - This Is What Makes Us Girls (User: jbwharris)
Johnny Cash - Bad News (User: jbwharris)
Poco - Legend (User: jbwharris)
King Tuff - Kind of Guy (User: jbwharris)
PJ Harvey - Man-Size (User: jbwharris)
Talking Heads - Life During Wartime (User: jbwharris)
John Lennon - How Do You Sleep? (User: jbwharris)
The Runaways - Rock and Roll (User: jbwharris)
Misfits - Static Age (User: jbwharris)
Muddy Waters - My Home Is In The Delta (User: jbwharris)
Nick Cave & the Bad Seeds - That's What Jazz Is to Me (User: jbwharris)
Pavement - Unfair (User: jbwharris)
Three Dog Night - Good Time Living (User: jbwharris)
X - Adult Books (User: jbwharris)
Acoustic System - Children (User: jbwharris)
Raveena - Mystery (User: jbwharris)
Kenny Rogers - The Hoodooin' Of Miss Fannie Deberry (User: jbwharris)
The Beths - A Real Thing (User: jbwharris)
Tom Waits - 'Til the Money Runs Out (User: jbwharris)
The Quick - Don't You Want It (User: jbwharris)
Arctic Monkeys - I Bet You Look Good on the Dancefloor (User: jbwharris)
Guns N' Roses - Bad Obsession (User: jbwharris)
Daft Punk - One More Time / Aerodynamic (Live) (User: jbwharris)
Big Star - Daisy Glaze (User: jbwharris)
Ozzy Osbourne - No Bone Movies (User: jbwharris)
Broken Social Scene - Our Faces Split the Coast In Half (User: jbwharris)
Paul & Linda McCartney - Uncle Albert / Admiral Halsey (User: jbwharris)
Supermax - Ain't Gonna Feel (User: jbwharris)
Dum Dum Girls - Coming Down (User: jbwharris)
Ty Segall Band - Muscle Man (User: jbwharris)
Sebadoh - License to Confuse (User: jbwharris)
Waxahatchee - La Loose (User: jbwharris)
Nirvana - Come as You Are (User: jbwharris)
...And You Will Know Us by the Trail of Dead - Monsoon (User: jbwharris)
Handsome Furs - All we Want, Baby, is Everything (User: jbwharris)
The Stooges - 1970 (User: jbwharris)
Elvis Presley - Suspicious Minds (User: jbwharris)
Green River - One More Stitch (Bone Bonus) (User: jbwharris)
The Jimi Hendrix Experience - Purple Haze (User: jbwharris)
Jawbreaker - Ache (User: jbwharris)
Grandaddy - The Group Who Couldn't Say (User: jbwharris)
Pearl Jam - Blood (User: jbwharris)
Fiona Apple - Periphery (User: jbwharris)
The Band - Jemima Surrender (User: jbwharris)
The Mamas & the Papas - Free Advice (User: jbwharris)
Slipknot - The Dying Song (Time to Sing) (User: jbwharris)
Norma Jean - Sleep Explosion (User: jbwharris)
Jamie T - British Hell (User: jbwharris)
Quincy Jones - Soul Bossa Nova (User: jbwharris)
Louie Zong - ghost duet (User: jbwharris)
Interpol - Toni (User: jbwharris)
Norma Jean Bell - Just Look-Ah What You'll Be Missing (User: jbwharris)
black midi - Hellfire (User: jbwharris)
Jeff Beck & Johnny Depp - Ooo Baby Baby (User: jbwharris)
Gilla Band - Paul (User: jbwharris)
Moor Mother - BARELY WOKE (feat. Wolf Weston) (User: jbwharris)
Al‐Qasar - Awal (feat. Lee Ranaldo) (User: jbwharris)
Theon Cross - Epistrophy (User: jbwharris)
SCUDFM - One Thing (User: jbwharris)
Lucrecia Dalt - No tiempo (User: jbwharris)
Molly Lewis - Miracle Fruit (User: jbwharris)
The Vacant Lots - Eyes Closed (User: jbwharris)
Bon Iver - re: stacks (User: jbwharris)
Jesca Hoop - Silent Extinction (User: jbwharris)
Eliza - ME vs. ME (User: jbwharris)
Simon & Garfunkel - April Come She Will (User: jbwharris)
Sam Cooke - A Change Is Gonna Come (User: jbwharris)
k.d. lang - Wash Me Clean (User: jbwharris)
The Beatles - Happiness Is a Warm Gun (User: jbwharris)
Grandmaster Flash and The Furious Five - The Message (User: jbwharris)
Grandmaster Flash and The Furious Five - The Message (User: jbwharris)
Simon & Garfunkel - Bookends (User: jbwharris)
Red House Painters - Have You Forgotten (User: jbwharris)
Bill Withers - Harlem (User: jbwharris)
Mercury Rev - Holes (User: jbwharris)
Pearl Jam - Just Breathe (User: jbwharris)
Ashe - Save Myself (User: jbwharris)
Goldfinger - Here in Your Bedroom (User: jbwharris)
Band of Horses - No One's Gonna Love You (User: jbwharris)
Beach House - Dive (User: jbwharris)
AWOLNATION - Hollow Moon (Bad Wolf) (User: jbwharris)
YUNGBLUD - Tissues (User: jbwharris)
W3apons - Broken Promises (User: jbwharris)
Girls - Lust For Life (User: jbwharris)
Colony House - Silhouettes (User: jbwharris)
Adam Ant - Stand and Deliver (User: jbwharris)
Rancid - Ivory Coast (User: jbwharris)
Yuno - Sunlight (User: jbwharris)
July Talk - Push + Pull (User: jbwharris)
Ben Howard - Only Love (User: jbwharris)
Kasabian - Bless This Acid House (User: jbwharris)
Jesus Jones - International Bright Young Thing (User: jbwharris)
Benny Sings - Nobody's Fault (User: jbwharris)
Franz Ferdinand - Take Me Out (User: jbwharris)
Heavenward - Hole (User: jbwharris)
The Strokes - Under Cover of Darkness (User: jbwharris)
Jealous of the Birds - Plastic Skeletons (User: jbwharris)
The Offspring - Behind Your Walls (User: jbwharris)
Butterfinger - Fall (User: jbwharris)
Annette - Don't Give Up (User: jbwharris)
Indigo Joseph - Pills (User: jbwharris)
Wide Mouth Mason - The Game (User: jbwharris)
Northcote - Let Me Roar (User: jbwharris)
Too Soon Monsoon - Man On The Moon (User: jbwharris)
The Steadies - Two (User: jbwharris)
Natural Sympathies - Hard Line (User: jbwharris)
Queen City Kids - Follow you There (User: jbwharris)
Slow Down Molasses - Street Haunting (User: jbwharris)
Ripper And The Jesses - Masks (User: jbwharris)
Derwood - Walk Away (User: jbwharris)
Desert Island Classic - Time Machine (User: jbwharris)
Eldebrock - Release Me (User: jbwharris)
Shane Connery Volk - Shiver (User: jbwharris)
White Reaper - Real Long Time (User: jbwharris)
Cults - I Can Hardly Make You Mine (User: jbwharris)
Brave Shores - Dancing Underwater (User: jbwharris)
Royal Canoe - Somersault (User: jbwharris)
Vast - I Don't Have Anything (User: jbwharris)
All - Just Perfect (User: jbwharris)
White Lies - Falling Out Without Me (User: jbwharris)
Night Riots - Breaking Free (User: jbwharris)
Weyes Blood - Titanic Risen (User: jbwharris)
Pilot Speed - Put The Phone Down (User: jbwharris)
Empress Of - Love Is a Drug (User: jbwharris)
INXS - Elegantly Wasted (User: jbwharris)
Saint Motel - Cold Cold Man (User: jbwharris)
Your Smith - The Spot (User: jbwharris)
AJR - I Won't (User: jbwharris)
Gomez - See the World (User: jbwharris)
Calvin Harris - Pray to God (User: jbwharris)
bbno$ - i remember (User: jbwharris)
Kathleen Edwards - Change The Sheets (User: jbwharris)
Roxy Music - More Than This (User: jbwharris)
Rah Rah - Love That Sticks (User: jbwharris)
WARBLY JETS - Alive (User: jbwharris)
Metric - Combat Baby (User: jbwharris)
Cold Cave - Promised Land (User: jbwharris)
Bakar - Hell N Back (User: jbwharris)
Daughter - Burn It Down (User: jbwharris)
my bloody valentine - Only Shallow (User: jbwharris)
Hot Mulligan - Featuring Mark Hoppus (User: jbwharris)
Snow Patrol - Signal Fire (User: jbwharris)
Maximo Park - I Don't Know What I'm Doing (User: jbwharris)
Little Scream - Love as a Weapon (User: jbwharris)
boy pablo - Feeling Lonely (User: jbwharris)
Maggie Rogers - Want Want (User: jbwharris)
Billy Talent - Surrender (User: jbwharris)
Alfie Templeman - Everybody's Gonna Love Somebody (User: jbwharris)
Alkaline Trio - Help Me (User: jbwharris)
New Politics - West End Kids (User: jbwharris)
Twin Atlantic - No Sleep (User: jbwharris)
Kings of Convenience - I'd Rather Dance With You (User: jbwharris)
Charly Bliss - Hard To Believe (User: jbwharris)
Furniture - Brilliant Mind (User: jbwharris)
Jack Johnson - Upside Down (User: jbwharris)
Aaron Adair - Helpless (User: jbwharris)
Mavis Staples - If All I Was Was Black (User: jbwharris)
Wavves - Help is on the Way (User: jbwharris)
Bastille - Good Grief (User: jbwharris)
Beach Bunny - Cloud 9 (User: jbwharris)
Superchunk - Hyper Enough (User: jbwharris)
Joel Plaskett - Through & Through & Through (User: jbwharris)
LCD Soundsystem - (We Don't Need This) Fascist Groove Thang (User: jbwharris)
Wet Leg - Wet Dream (User: jbwharris)
Bonnie "Prince" Billy - In Good Faith (User: jbwharris)
Feist - I Feel It All (User: jbwharris)
Sharon Van Etten - Every Time the Sun Comes Up (User: jbwharris)
Siouxsie and the Banshees - Dazzle (User: jbwharris)
Alexandra and the Scott Benson Band - Paralyzed (User: jbwharris)
The Magnetic Fields - I Don't Believe You (User: jbwharris)
The Catching - The More I Say (User: jbwharris)
Dispatch - Only the Wild Ones (User: jbwharris)
A Tribe Called Quest - Check the Rhime (User: jbwharris)
Weezer - All My Favorite Songs (User: jbwharris)
Dr. Dog - Shadow People (User: jbwharris)
Jungle - GOOD TIMES (User: jbwharris)
Land of Talk - Weight of That Weekend (User: jbwharris)
Buck Owens - Buckaroo (User: jbwharris)
FIVE6ix - Better Late Than Never (User: jbwharris)
Grandaddy - Now It's On (User: jbwharris)
Gloria Estefan - Conga (User: jbwharris)
Deerhunter - Plains (User: jbwharris)
Pharoah Sanders - Astral Traveling (User: jbwharris)
Whitmer Thomas - Trevor (User: jbwharris)
M83 - Solitude - Felsmann + Tiley Reinterpretation (User: jbwharris)
The Story So Far - Loro (User: jbwharris)
Lykke Li - 5D (User: jbwharris)
Squirrel Flower - So Hot You're Hurting My Feelings (User: jbwharris)
Lucy Dacus - Night Shift (User: jbwharris)
Ryan Adams - Dear Chicago (User: jbwharris)
Julien Baker - Bite The Hand (User: jbwharris)
Elliott Smith - Everything Means Nothing to Me (User: jbwharris)
Phoebe Bridgers - Motion Sickness (User: jbwharris)
M83 - My Tears Are Becoming a Sea (User: jbwharris)
Oasis - Stop Crying Your Heart Out (User: jbwharris)
Great Grandpa - Digger (User: jbwharris)
Omar Apollo - Evergreen (You Didn’t Deserve Me At All) (User: jbwharris)
Caracara - Better (User: jbwharris)
Bon Iver - Rosyln (User: jbwharris)
Bartees Strange - Going Going (User: jbwharris)
Ryan Adams - Dear Chicago (User: jbwharris)
M83 - I Need You (User: jbwharris)
Hovvdy - Warning Sign (User: jbwharris)
Flock of Dimes - Price Of Blue (User: jbwharris)
Ducks Ltd. - 18 Cigarettes (User: jbwharris)
Alexalone - Electric Sickness (User: jbwharris)
Aeon Station - Fade (User: jbwharris)
Oceanator - I Would Find You (User: jbwharris)
Deep Sea Diver - Lights Out (User: jbwharris)
Phoebe Bridgers - Motion Sickness (User: jbwharris)
Bon Iver - Skinny Love (User: jbwharris)
Molly Parden & Hollow Hum - Landslide (User: jbwharris)
The Mesa - Days Gone By (User: jbwharris)
The Long Blondes - Only Lovers Left Alive (User: jbwharris)
X - The New World (User: jbwharris)
The Meters - Chicken Strut (User: jbwharris)
Iron & Wine - Naked as We Came (User: jbwharris)
MAALA - Breathe Out (User: jbwharris)
Coldplay - Mylo Xyloto (User: jbwharris)
Greentea Peng - Spells (User: jbwharris)
Lime Garden - Pulp (User: jbwharris)
The National - It Never Happened (User: jbwharris)
Charles Stepney - Funky Sci Fi (User: jbwharris)
Show & A.G. - Next Level (Nyte Time Mix) (User: jbwharris)
Danger Mouse & Black Thought - Close to Famous (User: jbwharris)
Open Mike Eagle - I'll Fight You (User: jbwharris)
Gorillaz feat. Tame Impala and Bootie Brown - New Gold (User: jbwharris)
Blondie - Hanging on the Telephone (User: jbwharris)
Vieux Farka Touré & Khruangbin - Mahine Me (User: jbwharris)
David Bowie - I’m Deranged (User: jbwharris)
Pavement - Brink of the Clouds (User: jbwharris)
Bikini Kill - Double Dare Ya (User: jbwharris)
Y La Bamba - Mujeres (User: jbwharris)
OutKast - My Favorite Things (User: jbwharris)
Bruno Berle - Só O Amor (User: jbwharris)
Kyle Kidd - Scars Alight (User: jbwharris)
The Amps - Tipp City (User: jbwharris)
Rocket from the Crypt - On a Rope (User: jbwharris)
Guerilla Toss & Neu! - Zum Herz (User: jbwharris)
Beyoncé - MOVE (User: jbwharris)
Mr. Jukes, Charles Bradley - Grant Green (User: jbwharris)
Tha Dogg Pound - Let's Play House (User: jbwharris)
Spacehog - In the Meantime (User: jbwharris)
Prince - Gold (User: jbwharris)
The Smashing Pumpkins - 1979 (User: jbwharris)
No Doubt - Don't Speak (User: jbwharris)
Grace Jones - Slave to the Rhythm (Hot-Blooded version) (User: jbwharris)
LL Cool J - Loungin (Who Do Ya Luv) (User: jbwharris)
Sampa the Great - Bona (User: jbwharris)
DOMi & JD Beck & Thundercat - BOWLiNG (User: jbwharris)
Bone Thugs-N-Harmony - Tha Crossroads (User: jbwharris)
Noise Reduction - The Jefferson Institute (User: jbwharris)
Alanis Morissette - Ironic (User: jbwharris)
Big Joanie - Happier Still (User: jbwharris)
Wet Leg - Wet Dream (User: jbwharris)
The Presidents of the United States of America - Lump (User: jbwharris)
ODESZA - The Last Goodbye (feat. Bettye LaVette) (User: jbwharris)
Arlo Parks - Softly (User: jbwharris)
Blondie - One Way or Another (User: jbwharris)
Blondie - Heart of Glass (User: jbwharris)
Danger Mouse & Black Thought feat. MF DOOM - Belize (User: jbwharris)
The Pharcyde - Runnin' (User: jbwharris)
Coolio - Gangsta’s Paradise (User: jbwharris)
Wombo - Backflip (User: jbwharris)
Sun Tunnels - Rust (User: jbwharris)
Frankie Cosmos - Aftershook (User: jbwharris)
Kraftwerk - Neon Lights (User: jbwharris)
Adina Howard - Freak Like Me (User: jbwharris)
Steve Moore - The Jefferson Institute (User: jbwharris)
Katie Gregson-MacLeod - complex (demo) (User: jbwharris)
Panda Bear & Sonic Boom - Go On (User: jbwharris)
M83 - StarWaves (User: jbwharris)
Charles Bradley - Changes (User: jbwharris)
Pig With The Face Of A Boy - A Complete History of the Soviet Union, Through the Eyes of a Humble Worker (User: jbwharris)
Phoebe Bridgers - If We Make It Through December (User: jbwharris)
Nada Surf - Blankest Year (User: jbwharris)
Crowded House - Whatever You Want (User: jbwharris)
The Isley Brothers - Here We Go Again, Pt. 1 & 2 (User: jbwharris)
Avalanches vs. Semisonic & Shawn Mullins - Untitled (User: jbwharris)
Willy Moon - Railroad Track (User: jbwharris)
Lizzo - About Damn Time (User: jbwharris)
Missing Persons - Destination Unknown (User: jbwharris)
Tortoise - TNT (User: jbwharris)
The Killers - Change Your Mind (User: jbwharris)
Girl Talk - Play Your Part (Pt. 1) (User: jbwharris)
Steve Moore & Bluetech - Memory Beta (User: jbwharris)
Bluetech - Entrain Light (User: jbwharris)
Steve Moore - Gutter Talk (User: jbwharris)
Ty Segall - Hit It and Quit it (User: jbwharris)
Charles Bradley - Stay Away (User: jbwharris)
Primal Scream - Slip Inside This House (User: jbwharris)
Q Lazzarus - Goodbye Horses (User: jbwharris)
Middle Kids - Mistake (User: jbwharris)
Alvvays - Belinda Says (User: jbwharris)
A Tribe Called Quest - We The People.... (User: jbwharris)
Yves Tumor - Jackie (User: jbwharris)
A Flock of Seagulls - Space Age Love Song (User: jbwharris)
Editors - Karma Climb (User: jbwharris)
Cults - Spit You Out (User: jbwharris)
Phantogram - Mister Impossible (User: jbwharris)
Sharon Van Etten - Comeback Kid (User: jbwharris)
Tears for Fears - My Girls (User: jbwharris)
Arlo Parks - Hope (User: jbwharris)
Mos Def - UMI Says (User: jbwharris)
Blind Melon - No Rain (User: jbwharris)
The Strumbellas - Spirits (User: jbwharris)
Kerson Leong - Romanian Folk Dances, Sz. 68: I. Jocul cu bâtă (User: jbwharris)
Johnny Hollow - Superhero (User: jbwharris)
Echo And The Bunnymen - The Killing Moon (User: jbwharris)
DNA - Tom's Diner (User: jbwharris)
Gorillaz - Cracker Island (User: jbwharris)
The Psychedelic Furs - Pretty in Pink (User: jbwharris)
Martha & The Muffins - Echo Beach (User: jbwharris)
Jamiroquai - Little L (User: jbwharris)
New Order - The Perfect Kiss (User: jbwharris)
Big Audio Dynamite - The Globe (User: jbwharris)
INXS - Never Tear Us Apart (User: jbwharris)
Dalbello - Tango (User: jbwharris)
Annie Lennox - Walking on Broken Glass (User: jbwharris)
Apollo 440 - Ain’t Talkin’ ’bout Dub (@440 edit) (User: jbwharris)
Hot Chip - Broken (User: jbwharris)
Nilüfer Yanya - Rid Of Me (User: jbwharris)
Everything But the Girl - Missing (Todd Terry club mix) (User: jbwharris)
Silk Sonic - Leave the Door Open (User: jbwharris)
Cassandra Lewis - Lost Cause (User: jbwharris)
Ziggy Marley & The Melody Makers - Tomorrow People (User: jbwharris)
Sudan Archives - Yellow Brick Road (User: jbwharris)
Mister T. - Americana (User: jbwharris)
The Mars Volta - Flash Burns From Flashbacks (User: jbwharris)
Janet Jackson - Escapade (User: jbwharris)
MC 900 Ft Jesus - Killer Inside Me (User: jbwharris)
Griz - On a High (User: jbwharris)
William Fitzsimmons - Your Song (User: jbwharris)
Death Cab for Cutie - Fragments From the Decade (User: jbwharris)
Opus III - It's a Fine Day (User: jbwharris)
Jamie xx - KILL DEM (User: jbwharris)
Spellspellspell - i wanna (User: jbwharris)
Stereolab & Nurse with Wound - Simple Headphone Mind (User: jbwharris)
Grynch feat. XOE - Didn't Mind (User: jbwharris)
Roosevelt feat. Nile Rodgers - Passion (Fred Falke Remix) (User: jbwharris)
LL Cool J - Doin’ It (User: jbwharris)
Grace Jones - My Jamaican Guy (12" version) (User: jbwharris)
Atrás Hay Truenos - Posguerra (User: jbwharris)
Atrás Hay Truenos - Viaje hasta mañana (User: jbwharris)
Atrás Hay Truenos - Para siempre (User: jbwharris)
Atrás Hay Truenos - Consuelo (User: jbwharris)
Atrás Hay Truenos - Cara de mapa (User: jbwharris)
The Dirtbombs - Underdog (User: jbwharris)
Fuzzy Haskins - The Fuz and Da Boog (User: jbwharris)
Boogie Down Productions - I'm Still #1 (User: jbwharris)
Tony Alvon & The Belairs - Sexy Coffee Pot (User: jbwharris)
The Bar-Kays - Humpin’ (User: jbwharris)
OutKast feat. B‐Real - Xplosion (User: jbwharris)
Cypress Hill - Pigs (User: jbwharris)
Chuck Cornish - Ali Funky Thing (User: jbwharris)
Boss - Deeper (User: jbwharris)
Cypress Hill - Killa Hill Niggas (User: jbwharris)
Gwen McCrae - 90% of Me Is You (User: jbwharris)
Ben Sidran - Don't Let Go (User: jbwharris)
Cypress Hill - Latin Lingo (User: jbwharris)
THE PAZANT BROTHERS & THE BEAUFORT EXPRESS - A Gritty Nitty (User: jbwharris)
Cypress Hill - Ilusiones (User: jbwharris)
Dalton & Dubarri - I'm Just A Rock 'n' Roller (User: jbwharris)
Henry Mancini - The Party (User: jbwharris)
ScHoolboy Q Feat. Raekwon - Blind Threats (User: jbwharris)
Big Pun feat. Mobb Deep’s Prodigy & Wu‐Tang’s Rebel INS - Tres Leches (Triboro Trilogy) (User: jbwharris)
Gary Burton - Las Vegas Tango (User: jbwharris)
Funkdoobiest - Wopbabalubop (User: jbwharris)
Cypress Hill - When The Shit Goes Down (User: jbwharris)
De La Soul - Eye Patch (User: jbwharris)
The White Stripes - Aluminum (User: jbwharris)
zack villere - FOR THE REST OF MY LIFE (User: jbwharris)
Leon Bridges - Sweeter (User: jbwharris)
Charley Crockett - I'm Just a Clown (User: jbwharris)
The Byrds - All I Really Want to Do (User: jbwharris)
Radiohead - Idioteque (Super Mario 64 Remix) (User: jbwharris)
Yo La Tengo - Sugarcube (User: jbwharris)
Rex Orange County - 10/10 (User: jbwharris)
Rex Orange County - 10/10 (User: jbwharris)
Aaliyah - Ladies In Da House (feat. Missy Elliott & Timbaland) (User: jbwharris)
Aaliyah - Ladies In Da House (feat. Missy Elliott & Timbaland) (User: jbwharris)
The Strokes - Life Is Simple in the Moonlight (User: jbwharris)
The Strokes - Life Is Simple in the Moonlight (User: jbwharris)
Vince Gill - That's All Right (User: jbwharris)
Vince Gill - That's All Right (User: jbwharris)
The Twistin' Tarantulas - Ace of Spades (User: jbwharris)
The Twistin' Tarantulas - Ace of Spades (User: jbwharris)
Plants and Animals - House On Fire (User: jbwharris)
Plants and Animals - House On Fire (User: jbwharris)
Grouplove - Wildflowers (User: jbwharris)
Grouplove - Wildflowers (User: jbwharris)
Air - All I Need (Edit) (User: jbwharris)
Air - All I Need (User: jbwharris)
Joel Plaskett - Just Passing Through (User: jbwharris)
Joel Plaskett - Just Passing Through (User: jbwharris)
Incubus - Drive (User: jbwharris)
Incubus - Drive (User: jbwharris)
Syd Dale - The Hell Raisers (User: jbwharris)
Syd Dale - The Hell Raisers (User: jbwharris)
10.4 rog - hear me out a couple (User: jbwharris)
10.4 rog - hear me out a couple (User: jbwharris)
A Perfect Circle - Wake the Dead (User: jbwharris)
A Perfect Circle - Wake the Dead (User: jbwharris)
Matthew Good - It's Been A While Since I Was Your Man (User: jbwharris)
Matthew Good - It's Been A While Since I Was Your Man (User: jbwharris)
King Princess & Mark Ronson - Happy Together (User: jbwharris)
Krizz Kaliko - Dead Wrong (User: jbwharris)
King Princess & Mark Ronson - Happy Together (User: jbwharris)
Beck - Cyanide Breath Mint (User: jbwharris)
Beck - Cyanide Breath Mint (User: jbwharris)
Joy Oladokun - My Girl (User: jbwharris)
Joy Oladokun - My Girl (User: jbwharris)
Youngr & The Temper Trap - Sweet Disposition (Bootleg) (User: jbwharris)
Youngr & The Temper Trap - Sweet Disposition (Bootleg) (User: jbwharris)
Doves - Jetstream (User: jbwharris)
Doves - Jetstream (User: jbwharris)
Lizz Wright - Old Man (User: jbwharris)
Lizz Wright - Old Man (User: jbwharris)
Rose Cousins - I Would Die 4 U (feat. Bear's Den & Christof van der Ven) (User: jbwharris)
Rose Cousins - I Would Die 4 U (feat. Bear's Den & Christof van der Ven) (User: jbwharris)
Béla Fleck - Help On The Way (User: jbwharris)
Béla Fleck - Help On The Way (User: jbwharris)
Split System - Climbing (User: jbwharris)
Split System - Climbing (User: jbwharris)
Rozalla - Everybody's Free (Single Version) (User: jbwharris)
Rozalla - Everybody's Free (User: jbwharris)
Blur - Girls and Boys (User: jbwharris)
Blur - Girls and Boys (User: jbwharris)
Royal Blood - Trouble’s Coming (User: jbwharris)
Royal Blood - Trouble’s Coming (User: jbwharris)
The Ghost Is Dancing - To French Ave. (User: jbwharris)
The Ghost Is Dancing - To French Ave. (User: jbwharris)
Sam Truth - All My Dogs (User: jbwharris)
Sam Truth - All My Dogs (User: jbwharris)
Jenn Grant - White Horses (User: jbwharris)
Jenn Grant - White Horses (User: jbwharris)
Jakob - Sunshine Girl (Demo) (User: jbwharris)
Jakob - Sunshine Girl (User: jbwharris)
The Verve - Slide Away (User: jbwharris)
The Verve - Slide Away (User: jbwharris)
Jessie Reyez - ROOF (User: jbwharris)
Jessie Reyez - ROOF (User: jbwharris)
Ween - Voodoo Lady (User: jbwharris)
Ween - Voodoo Lady (User: jbwharris)
Bakslash - Tainted Love (Minimal Chic Mix) (User: jbwharris)
Bakslash - Tainted Love (Minimal Chic Mix) (User: jbwharris)
Rex Orange County - KEEP IT UP (User: jbwharris)
Rex Orange County - KEEP IT UP (User: jbwharris)
Overcoats - Hold Me Close (User: jbwharris)
Overcoats - Hold Me Close (User: jbwharris)
Jonathan Richman - Circle I (User: jbwharris)
Jonathan Richman - Circle I (User: jbwharris)
The Wooden Sky - Oh My God (It Still Means a Lot to Me) (User: jbwharris)
The Wooden Sky - Oh My God (It Still Means a Lot to Me) (User: jbwharris)
Aidan Knight - Dream Team (User: jbwharris)
Aidan Knight - Dream Team (User: jbwharris)
Jeremy Messersmith - Dillinger Eyes (User: jbwharris)
Deerhunter - Sailing (User: jbwharris)
Cansei de Ser Sexy - Knife (User: jbwharris)
Hole - Sugar Coma (User: jbwharris)
The Stranglers - Peaches (User: jbwharris)
Foster the People - Pumped Up Kicks (User: jbwharris)
Sun Chenhao - My guitar (User: jbwharris)
The Tragically Hip - Poets (User: jbwharris)
Bedouin Soundclash - When the Night Feels My Song (User: jbwharris)
Peter Gabriel - Red Rain (User: jbwharris)
Big Audio Dynamite - Rush (User: jbwharris)
Crowded House - Something So Strong (User: jbwharris)
Melody's Echo Chamber - Emotional Eternal (User: jbwharris)
Sloan - D Is For Driver (Pier 21 demo) (User: jbwharris)
Kraftwerk - Computer World..2 (User: jbwharris)
Garbage - Only Happy When It Rains (User: jbwharris)
Chad VanGaalen - Mini TV's (User: jbwharris)
The Dandy Warhols - (You Come In) Burned (User: jbwharris)
Ladytron - International Dateline (User: jbwharris)
Kasabian - Days Are Forgotten (Z-Trip Remix) (feat. LL Cool J) (User: jbwharris)
The Shins - A Comet Appears (User: jbwharris)
The Passions - I'm in Love With a German Film Star (User: jbwharris)
The Maccabees - Heave (User: jbwharris)
Omar Apollo - Evergreen (You Didn’t Deserve Me At All) (User: jbwharris)
Lord Huron - The Night We Met (User: jbwharris)
Bon Iver - Rosyln (User: jbwharris)
Earth, Wind & Fire - September (User: jbwharris)
Lana Del Rey - Don't Let Me Be Misunderstood (User: jbwharris)
The Smiths - Rubber Ring (User: jbwharris)
Bryan Cheng - Suite for Cello: III. Intermezzo e Danza Finale (User: jbwharris)
Calgary Philharmonic Orchestra - Cosi fan tutte, K. 588 (User: jbwharris)
Queens of the Stone Age - Go With the Flow (User: jbwharris)
Down Low Tha B365t - Crawl Back (User: jbwharris)
Klô Pelgag - Umami (User: jbwharris)
Dutch Newman - Black Tux (User: jbwharris)
Helene Smith - Wrong Or Right He's My Baby (User: jbwharris)
Sloan - Spend the Day (User: jbwharris)
Billie Eilish - NDA (User: jbwharris)
Björk - It's Oh So Quiet (User: jbwharris)
Alvvays - Easy On Your Own? (User: jbwharris)
Tim Baker - Some Day (User: jbwharris)
Elise LeGrow - Who Do You Love (User: jbwharris)
Bo Diddley - Who Do You Love (User: jbwharris)
Doc & Sal - My Dream (User: jbwharris)
The Chicks - Gaslighter (User: jbwharris)
Crown Lands - End Of The Road (User: jbwharris)
Bo Diddley - Who Do You Love? (User: jbwharris)
Devon Cole - Uncall It (User: jbwharris)
David Strickland - Truth (User: jbwharris)
Anaïs Mitchell - On Your Way (User: jbwharris)
Marcus Mumford - Grace (User: jbwharris)
Lucinda Williams - Can't Let Go (User: jbwharris)
Dacey - SUMMERTIMEISDONE (User: jbwharris)
Bruno Mars - Skate (User: jbwharris)
Gorillaz - Cracker Island (User: jbwharris)
Yeah Yeah Yeahs - Burning (User: jbwharris)
The Beautiful South - Song For Whoever (User: jbwharris)
Strange Advance - We Run (User: jbwharris)
The Cars - Just What I Needed (User: jbwharris)
Crystal Castles - Not in Love (User: jbwharris)
Foo Fighters - This Is a Call (User: jbwharris)
Bif Naked - Lucky (User: jbwharris)
Fiona Apple - Criminal (User: jbwharris)
Flesh For Lulu - I Go Crazy (User: jbwharris)
U2 - Desire (Hollywood remix) (User: jbwharris)
Half Past Four - Mathematics (User: jbwharris)
Birth Control - Gamma Ray 2.0 (User: jbwharris)
Geddy Lee - The Present Tense (User: jbwharris)
Lady Lake - Patchouli Girls (User: jbwharris)
Bishop - River (User: jbwharris)
Live Lounge Allstars - Times Like These (User: jbwharris)
Our Lady Peace - Automatic Flowers (User: jbwharris)
Pink Floyd - Wish You Were Here (User: jbwharris)
Bush - Glycerine (User: jbwharris)
Butthole Surfers - Pepper (User: jbwharris)
The Killers - boy (User: jbwharris)
The Trews - Tired Of Waiting (User: jbwharris)
Pinback - Good To Sea (User: jbwharris)
Phantogram - Mouthful of Diamonds (User: jbwharris)
Animal Collective - My Girls (User: jbwharris)
Starfucker - Rawnald Gregory Erickson the Second (User: jbwharris)
LCD Soundsystem - Dance Yrself Clean (User: jbwharris)
Florence + the Machine - Dog Days Are Over (User: jbwharris)
Grizzly Bear - Two Weeks (User: jbwharris)
The Lowest of the Low - Subversives (User: jbwharris)
Wintersleep - Sore (User: jbwharris)
Jay Malinowski - Santa Monica (User: jbwharris)
Sloan - Follow The Leader (User: jbwharris)
Matthew Good - Alert Status Red (User: jbwharris)
Jason Collett - Love You Babe (User: jbwharris)
USS (Ubiquitous Synergy Seeker) - Laces Out (User: jbwharris)
Rheostatics - Aliens (Christmas 1988) (User: jbwharris)
Wintersleep - Archaeologists (User: jbwharris)
The Lowest of the Low - Eternal Fatalist (User: jbwharris)
Sloan - She Says What She Means (User: jbwharris)
Pilot Speed - Melt Into The Walls (User: jbwharris)
Jason Collett - I'll Bring the Sun (User: jbwharris)
USS (Ubiquitous Synergy Seeker) - Anti-Venom (User: jbwharris)
Matthew Good - Sicily (User: jbwharris)
Wintersleep - Astronaut (User: jbwharris)
Rheostatics - Record Body Count (User: jbwharris)
Sloan - Unkind (User: jbwharris)
Jeremy Parsons - Lillian (User: jbwharris)
The Lowest of the Low - Salesmen, Cheats and Liars (User: jbwharris)
Clark Nova - Death of the Distance (User: jbwharris)
Jason Collett - Hangover Days (User: jbwharris)
USS (Ubiquitous Synergy Seeker) - Alien (User: jbwharris)
Bentley Rhythm Ace - This Is Carbootechnoodiscotechnobooto (User: jbwharris)
Sam Roberts Band - Bridge to Nowhere (User: jbwharris)
Wintersleep - Amerika (User: jbwharris)
Joel Plaskett - Through & Through & Through (User: jbwharris)
Rheostatics - P.I.N. (User: jbwharris)
Sloan - Deeper than Beauty (User: jbwharris)
Jason Collett - Song And Dance Man (User: jbwharris)
The Lowest of the Low - Bleed A Little While Tonight (User: jbwharris)
Matt Mays - Tall Trees (User: jbwharris)
Wintersleep - Dead Letter & The Infinite Yes (User: jbwharris)
Hey Rosetta! - There's an Arc (User: jbwharris)
USS (Ubiquitous Synergy Seeker) - Pornostartrek (User: jbwharris)
Rheostatics - Vancouver (User: jbwharris)
Jason Collett - Love Is a Dirty Word (User: jbwharris)
Sloan - The Rest Of My Life (User: jbwharris)
The Lowest of the Low - 4 O'Clock Stop (User: jbwharris)
Wintersleep - More Than (User: jbwharris)
Pilot Speed - Into Your Hideout (User: jbwharris)
Sam Roberts Band - Bridge to Nowhere (User: jbwharris)
Wintersleep - Archaeologists (User: jbwharris)
Joel Plaskett - Through & Through & Through (User: jbwharris)
Jason Collett - I'll Bring the Sun (User: jbwharris)
Rheostatics - Vancouver (User: jbwharris)
All Get Out - The Season (User: jbwharris)
Matthew Good - Last Parade (User: jbwharris)
Sloan - Everything You've Done Wrong (User: jbwharris)
Wintersleep - More Than (User: jbwharris)
BROCKHAMPTON - TRIP (User: jbwharris)
PJ Harvey - You Said Something (User: jbwharris)
Swanes - Hikikomori In Love (User: jbwharris)
Dr. Dog - Listening In (User: jbwharris)
Supergrass - Moving (User: jbwharris)
The Cardigans - Sabbath Bloody Sabbath (User: jbwharris)
The Cardigans - Iron Man (User: jbwharris)
Iceage - All The Junk On The Outskirts (User: jbwharris)
The Minders - Hooray For Tuesday (User: jbwharris)
Beastie Boys - Gratitude (User: jbwharris)
Sonic Youth - Sugar Kane (User: jbwharris)
mclusky - Alan Is a Cowboy Killer (User: jbwharris)
Phosphorescent - Song for Zula (User: jbwharris)
Black Pumas - Sugar Man (User: jbwharris)
Leon Bridges & Keite Young - Like a Ship (User: jbwharris)
Swamp Dogg - Soul To Blessed Soul (User: jbwharris)
U.S. Girls - So Typically Now (User: jbwharris)
Disclosure - When a Fire Starts to Burn (User: jbwharris)
Sampa the Great feat. Witch - Can I Live? (User: jbwharris)
MorMor - Far Apart (User: jbwharris)
Lovage - To Catch a Thief (User: jbwharris)
Lauryn Hill - Lost Ones (User: jbwharris)
Lady Wray - They Won’t Hang Around (User: jbwharris)
Talking Heads - Burning Down the House (User: jbwharris)
Thievery Corporation feat. Sleepy Wonder & Gunjan - Warning Shots (User: jbwharris)
M.I.A. & A. R. Rahman - O… Saya (User: jbwharris)
Santigold - High Priestess (User: jbwharris)
Wet Leg - Wet Dream (User: jbwharris)
Gang of Four - Damaged Goods (User: jbwharris)
Horsegirl - Anti-glory (User: jbwharris)
Built to Spill - Understood (User: jbwharris)
The Avalanches - Since I Left You (Stereolab remix) (User: jbwharris)
Sault - Monsters (User: jbwharris)
Little Dragon - Frisco (User: jbwharris)
Lil Silva feat. Little Dragon - Be Cool (User: jbwharris)
Suede - She Still Leads Me On (User: jbwharris)
LCD Soundsystem - All My Friends (User: jbwharris)
Hot Chip - dancing in the dark (User: jbwharris)
ODESZA - Behind The Sun (User: jbwharris)
Compositeurs divers - I. Allegro (User: jbwharris)
Glenn Gould - Lord of Salisbury Pavan and Galliard (User: jbwharris)
Leonard Bernstein - Overture to Candide: Allegro molto con brio (User: jbwharris)
Leonard Bernstein - Candide Overture (User: jbwharris)
Leonard Bernstein - Overture to Candide: Allegro molto con brio (User: jbwharris)
Chris Isaak - Wicked Game (User: jbwharris)
Nation of Language - Automobile (User: jbwharris)
Aviv - Black Coffee (User: jbwharris)
Elisapie - Wolves Don't Live by the Rules (User: jbwharris)
Sloan - People Of The Sky (User: jbwharris)
Danny Michel - Don't Be so Hard on Yourself (User: jbwharris)
Baio - Dead Hand Control (User: jbwharris)
Joel Plaskett Emergency - Fashionable People (User: jbwharris)
Feist - Islands In The Stream (User: jbwharris)
Feist - Islands In The Stream (User: jbwharris)
Jessie Reyez - MUTUAL FRIEND (User: jbwharris)
Floetry - Floetic (User: jbwharris)
The Black Keys - It Ain't Over (User: jbwharris)
U.S. Girls - So Typically Now (User: jbwharris)
Daniel Caesar - Please Do Not Lean (User: jbwharris)
Danger Mouse - Aquamarine (User: jbwharris)
Neil Young - Heart of Gold (User: jbwharris)
Jennah Barry - The Real Moon (User: jbwharris)
Chiiild - Hold On Till We Get There (User: jbwharris)
Son Little - drummer (User: jbwharris)
Al Green - Tired of Being Alone (User: jbwharris)
Harry Styles - As It Was (User: jbwharris)
Pierre Kwenders - Papa Wemba (User: jbwharris)
Lizzy McAlpine - erase me (User: jbwharris)
Aysanabee - Nomads (User: jbwharris)
Ray LaMontagne - Beg Steal or Borrow (User: jbwharris)
Tracy Chapman - Give Me One Reason (User: jbwharris)
Grae - Soft (User: jbwharris)
MorMor - Far Apart (User: jbwharris)
Scritti Politti - Perfect Way (User: jbwharris)
Poppy Ajudha - NO! (User: jbwharris)
Cuco - Caution (User: jbwharris)
Michael Franti & Spearhead - Do Ya Love (User: jbwharris)
Bob Marley & The Wailers - Could You Be Loved (User: jbwharris)
Nine Inch Nails - Head Like a Hole (User: jbwharris)
Silversun Pickups - Scared Together (User: jbwharris)
mediopicky - quien te llamo (User: jbwharris)
beabadoobee - Pictures of Us (User: jbwharris)
Beach Bunny - Gravity (User: jbwharris)
Jessie Ware - Free Yourself (User: jbwharris)
Steve Lacy - Amber (User: jbwharris)
The Dandy Warhols - Love Is The New Feel Awful (User: jbwharris)
CCFX - The One To Wait (User: jbwharris)
Cocteau Twins - A Kissed Out Red Floatboat (User: jbwharris)
OutKast - B.O.B. (User: jbwharris)
Shabazz Palaces - Wet (User: jbwharris)
Sudan Archives - Selfish Soul (User: jbwharris)
Bartees Strange - Cosigns (User: jbwharris)
The Runaways - Cherry Bomb (User: jbwharris)
Cheekface - Friends (User: jbwharris)
Sango - Fire & Ice (User: jbwharris)
Kenny Beats - Hooper (User: jbwharris)
Charles Stepney - That’s the Way of the World (User: jbwharris)
Danger Mouse & Black Thought feat. MF DOOM - Belize (User: jbwharris)
Kali Uchis feat. Jorja Smith - Tyrant (User: jbwharris)
Margaritas Podridas - Púrpura (User: jbwharris)
Bandalos Chinos - Entrada (User: jbwharris)
Sara Hebe - Ho! (User: jbwharris)
Chic - Strike Up the Band (User: jbwharris)
Beyoncé - VIRGO’S GROOVE (User: jbwharris)
The Jimi Hendrix Experience - Spanish Castle Magic (User: jbwharris)
Japanese Breakfast feat. So!YoON! - Be Sweet (Korean Version) (User: jbwharris)
Johnny “Hammond” Smith - Fantasy (Faze Action Tape Edit) (User: jbwharris)
Ron Trent feat. Khruangbin - Flos Potentia (Sugar, Cotton, Tabacco) (User: jbwharris)
Roxy Music - End of the Line (User: jbwharris)
Kokoroko - Soul Searching (User: jbwharris)
Hot Chip - Down (User: jbwharris)
Universal Togetherness Band - More Than Enough (User: jbwharris)
The Staple Singers - Let's Do It Again (User: jbwharris)
Ice Cube - It Was A Good Day (Remix) (User: jbwharris)
Enumclaw - Cowboy Bepop (User: jbwharris)
franklin gothic - Carry Me Away (User: jbwharris)
Yves Jarvis - Bootstrap Jubilee (User: jbwharris)
Bruno Berle - É Preciso Ter Amor (User: jbwharris)
Terence Etc. - V O R T E X (User: jbwharris)
Isaiah Rashad feat. Iamdoechii & Kal Banx - Wat U Sed (User: jbwharris)
D’Angelo and The Vanguard - Sugah Daddy (User: jbwharris)
James Blake - The Wilhelm Scream (User: jbwharris)
James Litherland - Where to Turn (User: jbwharris)
Son Little - Playing Both Sides (User: jbwharris)
DOMi & JD Beck - SMiLE (User: jbwharris)
Dávila 666 - Dimelo Ya (User: jbwharris)
AJ Dávila - Ohhh (No Te Encantes) (User: jbwharris)
Buscabulla - Vámono (User: jbwharris)
Los Wálters, Alegría Rampante - Ciudad Fantasma (User: jbwharris)
Tricky - Black Steel (Radio Edit) (User: jbwharris)
Björk - Army of Me (User: jbwharris)
Delta 5 - Mind Your Own Business (User: jbwharris)
M.I.A. - Bad Girls (Leo Justi Remix) (User: jbwharris)
Santigold - High Priestess (User: jbwharris)
Kelela - Washed Away (User: jbwharris)
Wild Nothing - Paradise (User: jbwharris)
Blood Orange - Wish (User: jbwharris)
Bomba Estéreo & Manu Chao - Me Duele (User: jbwharris)
Dam & Brother Ali - Overdose (User: jbwharris)
Rina Sawayama - Enter Sandman (User: jbwharris)
Yeah Yeah Yeahs - Burning (User: jbwharris)
Suede - Outsiders (User: jbwharris)
ODESZA feat. MARO - Better Now (User: jbwharris)
Pulp - Disco 2000 (User: jbwharris)
IDLES - Danny Nedelko (User: jbwharris)
Metz feat. Joe Talbot - Come On Down (User: jbwharris)
Fred again.. & Swedish House Mafia feat. Future - Turn on the Lights Again... (User: jbwharris)
The Comet Is Coming - CODE (User: jbwharris)
U.S. Girls - So Typically Now (User: jbwharris)
The Isley Brothers - Fight The Power, Part 1 & 2 (User: jbwharris)
Young Fathers - Get Up (User: jbwharris)
Algiers - Bite Back (User: jbwharris)
ESG - Dance (User: jbwharris)
Lizzy Mercier Descloux - Fire (User: jbwharris)
Talking Heads - Once in a Lifetime (User: jbwharris)
David Bowie - Let’s Dance (User: jbwharris)
Duran Duran - Notorious (User: jbwharris)
INXS - Original Sin (User: jbwharris)
Beyoncé - CUFF IT (User: jbwharris)
Chic - I Want Your Love (User: jbwharris)
Sister Sledge - We Are Family (User: jbwharris)
PVA - Hero Man (User: jbwharris)
The Heavy - Sixteen (User: jbwharris)
Michael Kiwanuka - One More Night (User: jbwharris)
Danger Mouse & Black Thought feat. Michael Kiwanuka - Aquamarine (User: jbwharris)
Ladytron - Destroy Everything You Touch (User: jbwharris)
Ladyhawke - Magic (User: jbwharris)
PHOENIX Feat. EZRA KOENIG - Tonight (User: jbwharris)
The Beths - Knees Deep (User: jbwharris)
Ty Segall - My Sunshine (User: jbwharris)
Lemon Jelly - The Staunton Lick (User: jbwharris)
The Crystal Method - Keep Hope Alive (User: jbwharris)
Moby - Why Does My Heart Feel So Bad? (User: jbwharris)
Luke Vibert - Funky Acid Stuff (User: jbwharris)
Violent Femmes - Blister In The Sun (User: jbwharris)
Sarah McLachlan - Possession 1 (User: jbwharris)
Pet Shop Boys - Suburbia (User: jbwharris)
City and Colour - The Girl (User: jbwharris)
Porno for Pyros - Pets (User: jbwharris)
Elastica - Car Song (User: jbwharris)
Arcade Fire - The Suburbs (User: jbwharris)
Pearl Jam - Black (User: jbwharris)
Kate Bush - Hounds of Love (User: jbwharris)
INXS - The One Thing (User: jbwharris)
The Diodes - Tired of Waking Up Tired (User: jbwharris)
Crash Parallel - Rain Delays (User: jbwharris)
Weezer - Buddy Holly (User: jbwharris)
Men Without Hats - The Safety Dance (User: jbwharris)
Rheostatics - Claire (User: jbwharris)
Coldplay - Don't Panic (User: jbwharris)
Sloan - The Good In Everyone (User: jbwharris)
The La's - There She Goes (User: jbwharris)
BT - Love, Peace and Grease (BT's Puma Fila Mix) (User: jbwharris)
Juno Reactor - Conga Fury (User: jbwharris)
Meat Beat Manifesto - Radio Babylon (User: jbwharris)
Olive - You Are Not Alone (Coxswain Remix) (User: jbwharris)
Plastikman - Koma (Remastered) (User: jbwharris)
Junkie XL - Billy Club (User: jbwharris)
GusGus - Polyesterday (User: jbwharris)
Lemon Jelly - The Staunton Lick (User: jbwharris)
Autechre - Basscadet (User: jbwharris)
The Future Sound of London - Papua New Guinea (User: jbwharris)
LFO - LFO (Leeds Warehouse mix) (User: jbwharris)
Apollo 440 - Stop the Rock (User: jbwharris)
Thievery Corporation - Lebanese Blonde (User: jbwharris)
Freestylers - B-Boy Stance (User: jbwharris)
UNKLE - Rabbit in Your Headlights (User: jbwharris)
Layo & Bushwacka! - Love Story (radio edit) (User: jbwharris)
Boards of Canada - Turquoise Hexagon Sun (User: jbwharris)
Justice - On'n'on (User: jbwharris)
Gesaffelstein & The Weeknd - Lost in the Fire (User: jbwharris)
Cut Copy - Take Me Over (User: jbwharris)
Gorillaz - Feel Good Inc (User: jbwharris)
LCD Soundsystem - Daft Punk Is Playing at My House (User: jbwharris)
Justice - Pleasure x Newjack x Civilization (WWW) (User: jbwharris)
Hot Chip - Over and Over (User: jbwharris)
Justice - D.A.N.C.E (User: jbwharris)
Daft Punk - Doin' It Right (feat. Panda Bear) (User: jbwharris)
The Chemical Brothers - Setting Sun (User: jbwharris)
Sault - June 55 (User: jbwharris)
Princeton - By the Bear(Sleeping Souls) (User: jbwharris)
Beastie Boys vs. Happy Mondays - Beastie Bez (User: jbwharris)
Kelley Polar - Entropy Reigns (in the Celestial City) (User: jbwharris)
Usher - My Boo (User: jbwharris)
Fleetwood Mac - Seven Wonders (Remastered) (User: jbwharris)
Pink Floyd - Breathe (In the Air) (User: jbwharris)
The Rolling Stones - Paint It Black (User: jbwharris)
The Rolling Stones - Gimme Shelter (User: jbwharris)
Depeche Mode - Never Let Me Down Again (User: jbwharris)
Led Zeppelin - Heartbreaker (User: jbwharris)
Iggy Pop - Real Wild Child (Wild One) (User: jbwharris)
The Who - Magic Bus (Mono Version) (User: jbwharris)
Yes - Owner of a Lonely Heart (User: jbwharris)
Fleetwood Mac - Gypsy (User: jbwharris)
David Bowie - Space Oddity (User: jbwharris)
David Bowie - When I Live My Dream (2) (User: jbwharris)
David Bowie - Sell Me a Coat (remix) (User: jbwharris)
David Bowie - Ching-A-Ling (User: jbwharris)
David Bowie - In The Heat Of The Morning (Mono) (User: jbwharris)
David Bowie - Let Me Sleep Beside You (User: jbwharris)
David Bowie - Karma Man (Mono) (User: jbwharris)
David Bowie - Did You Ever Have a Dream (User: jbwharris)
David Bowie - Love You Till Tuesday (single version) (User: jbwharris)
David Bowie - Please Mr. Gravedigger (User: jbwharris)
David Bowie - Maid of Bond Street (User: jbwharris)
David Bowie - She's Got Medals (User: jbwharris)
David Bowie - Join the Gang (User: jbwharris)
David Bowie - Come and Buy My Toys (User: jbwharris)
David Bowie - Silly Boy Blue (User: jbwharris)
David Bowie - Little Bombardier (User: jbwharris)
David Bowie - When I Live My Dream (User: jbwharris)
David Bowie - We Are Hungry Men (User: jbwharris)
David Bowie - There Is a Happy Land (User: jbwharris)
David Bowie - Love You Till Tuesday (User: jbwharris)
David Bowie - Rubber Band (User: jbwharris)
David Bowie - Sell Me a Coat (User: jbwharris)
David Bowie - Uncle Arthur (User: jbwharris)
David Bowie - The Gospel According to Tony Day (User: jbwharris)
David Bowie - The Laughing Gnome (User: jbwharris)
David Bowie - The London Boys (User: jbwharris)
David Bowie - Rubber Band (single version) (User: jbwharris)
Panic! at the Disco - I Write Sins, Not Tragedies (User: jbwharris)
Childish Gambino - IV. Sweatpants (User: jbwharris)
Pixies - Gigantic (User: jbwharris)
Gorillaz - All Alone (User: jbwharris)
The White Stripes - Blue Orchid (User: jbwharris)
Radiohead - Let Down (Remastered) (User: jbwharris)
Daft Punk - Lose Yourself to Dance (feat. Pharrell Williams) (User: jbwharris)
Stuck in the Sound - Fred Mercure (User: jbwharris)
Arctic Monkeys - 505 (User: jbwharris)
Beck - Morning (User: jbwharris)
The Strokes - At the Door (User: jbwharris)
Kendrick Lamar - LOYALTY. (FEAT. RIHANNA.) (User: jbwharris)
Childish Gambino - This Is America (User: jbwharris)
Lil Nas X & Cardi B - Rodeo (User: jbwharris)
Radiohead - Everything in Its Right Place (User: jbwharris)
Gorillaz - On Melancholy Hill (User: jbwharris)
Sun Kil Moon - I Can't Live Without My Mother's Love (User: jbwharris)
Barrie - Jersey (User: jbwharris)
Yukon Blonde - I Wanna Be Your Man (User: jbwharris)
Massive Attack - Mezzanine (User: jbwharris)
Michael McCann - TF29 (User: jbwharris)
Roxy Music - Love Is the Drug (User: jbwharris)
Stars - Barricade (User: jbwharris)
Oh Pep! - The Race (User: jbwharris)
Sarah Menescal - Free (User: jbwharris)
The Verve - Life's An Ocean (User: jbwharris)
Mozart's Sister - Bow a Kiss (User: jbwharris)
Max Richter - In The Dark (User: jbwharris)
Ibibio Sound Machine - Wanna Come Down (User: jbwharris)
Flux Pavilion - I Believe (feat. Asha) (User: jbwharris)
Brenda Boykin - Wonderful (User: jbwharris)
Sloan - 10 - Take The Bench (User: jbwharris)
Anti-Flag - Brandenburg Gate (User: jbwharris)
Said the Whale - I Love You (User: jbwharris)
The Verve - So Sister (User: jbwharris)
Geese - Low Era (User: jbwharris)
Bartees Strange - Jealousy (User: jbwharris)
Royal Blood - Typhoons (User: jbwharris)
Tegan and Sara - Where Does the Good Go (User: jbwharris)
Silver Sphere - crowd (umru remix) (User: jbwharris)
Mac Ayres - Get to You Again (User: jbwharris)
Elastica - Line Up (User: jbwharris)
Caitlyn Smith - Fix You (User: jbwharris)
The Rakes - Terror! (User: jbwharris)
Cat Power - Sea of Love (User: jbwharris)
The Offspring - Let The Bad Times Roll (User: jbwharris)
Captain Tractor - The Last Saskatchewan Pirate (User: jbwharris)
Julia Jacklin - I Was Neon (User: jbwharris)
Yitaku - Comfort Song (feat. Underscores) (User: jbwharris)
Electric Light Orchestra - Can't Get It Out of My Head (User: jbwharris)
Ralph Castelli - Running (User: jbwharris)
Echo & the Bunnymen - Bring On The Dancing Horses (User: jbwharris)
Stella Starlight Trio - Sunrise (User: jbwharris)
David Myles - Leave Tonight (User: jbwharris)
Matt Mays - Take It On Faith (User: jbwharris)
The Verve - Velvet Morning (User: jbwharris)
Groove Armada - At the River (User: jbwharris)
Rakky Ripper, PUTOCHINOMARICÓN & eurosanto - Cyberpet (User: jbwharris)
Sarah Harmer - New Low (User: jbwharris)
Sweet Female Attitude - Flowers (User: jbwharris)
UNO stereo - TEXT (feat. Amindi) (User: jbwharris)
Sara Diamond - Sunday (User: jbwharris)
Kai - a little too much (User: jbwharris)
Orville Peck - C'mon Baby, Cry (User: jbwharris)
Foals - Looking High (User: jbwharris)
Built to Spill - Goin' Against Your Mind (User: jbwharris)
Bobby Womack - The Bravest Man in the Universe (User: jbwharris)
Flight of the Conchords - Bernard From EMI (User: jbwharris)
lovelytheband - broken (User: jbwharris)
Screamin' Jay Hawkins - I Put a Spell on You (User: jbwharris)
Beastie Boys - 14th St. Break (User: jbwharris)
Eve Owen - She Says (User: jbwharris)
No Age - Eraser (User: jbwharris)
Juliana Hatfield - Mouthful of Blood (User: jbwharris)
BossArt Ensemble & Nova Bossa Ltd. - Again (User: jbwharris)
Cam The Artisan - Brown Skin (User: jbwharris)
Mighty Sam McClain - Georgia Pines (User: jbwharris)
The New Pornographers - The Laws Have Changed (User: jbwharris)
The Cooltrane Quartet - Groove is in the Heart (User: jbwharris)
