Bring Me the Horizon - Teardrops (User: jbwharris)
The Woolen Men - Outta Reach (User: jbwharris)
Fuel - Daniel (User: jbwharris)
Oasis - Don't Look Back in Anger (User: jbwharris)
David Ellis - Misty Heights (User: jbwharris)
Mouth Of Ghosts - Downfall (User: jbwharris)
Brandy & Monica - The Boy Is Mine (User: jbwharris)
John Mayer - Heartbreak Warfare (User: jbwharris)
The Lawrence Arms - Quiet Storm (User: jbwharris)
Porter Robinson - Mirror (User: jbwharris)
Cyprine & Shake the Disease - Keep Aah (User: jbwharris)
Oranj Goodman - Vienna 1971 (User: jbwharris)
Broken Social Scene - 7/4 (Shoreline) (User: jbwharris)
Dead Ghosts - Drink it Dry (User: jbwharris)
Mozart's Sister - Mozart's Sister (User: jbwharris)
Madonna - This Used to Be My Playground (User: jbwharris)
Beach Fossils - Sleep Apnea (User: jbwharris)
Elliott Smith - Oh Well, Okay (User: jbwharris)
Lights & Myth - Batshit (User: jbwharris)
Brendan Hendry - Bratty (User: jbwharris)
Roe - Girls (1000 Beasts Remix) (User: jbwharris)
Broken Bells - Holding on for Life (User: jbwharris)
Cold War Kids - First (User: jbwharris)
Caracol - Hourglass (User: jbwharris)
Deep Blue Something - Breakfast at Tiffany's (User: jbwharris)
Bush - Glycerine (User: jbwharris)
The Head and the Heart - Honeybee (User: jbwharris)
Coldplay - Til Kingdom Come (User: jbwharris)
Anuka - Lose You (User: jbwharris)
Soccer Mommy - I'm on Fire (User: jbwharris)
Liars - The Other Side of Mt. Heart Attack (User: jbwharris)
Aretha Franklin - Spirit in the Dark (User: jbwharris)
Holly Humberstone - Deep End (User: jbwharris)
Aidan Knight - VVV (Veni Vidi Vici) (User: jbwharris)
Beem - RER (User: jbwharris)
Garbage - #1 Crush (Nellee Hooper Mix) (User: jbwharris)
Porridge Radio & Lala Lala - Good For You (User: jbwharris)
Mary Alouette - Angel (User: jbwharris)
Kito & Reija Lee - Starting Line (User: jbwharris)
Charles Mingus - Goodbye Pork Pie Hat (User: jbwharris)
The Primitives - Follow The Sun Down (User: jbwharris)
Neon Dreams - Sick of Feeling Useless (User: jbwharris)
Jamie Webster - This Place (User: jbwharris)
Dinah Eastwood - Freedom! (User: jbwharris)
William Basinski - dlp 1.1 (User: jbwharris)
Khalid - Saved (User: jbwharris)
Phoenix - Rome (User: jbwharris)
Bryan Adams - Have You Ever Really Loved A Woman? (from "Don Juan DeMarco") (User: jbwharris)
Hether - Pink Purple Blues (User: jbwharris)
Cloud Cult - Complicated Creation (User: jbwharris)
Craig David - 7 Days (User: jbwharris)
Porches - I Miss That (User: jbwharris)
The Streets - Dry Your Eyes (User: jbwharris)
Love and Rockets - Ball of Confusion (USA mix) (User: jbwharris)
Royal Blood - Typhoons (User: jbwharris)
Radiohead - True Love Waits (User: jbwharris)
Yuna - Creep (User: jbwharris)
The Hold Steady - Rock Problems (User: jbwharris)
Mutemath - Control (User: jbwharris)
Soccer Mommy - bloodstream (User: jbwharris)
Thom Yorke - Volk (User: jbwharris)
alt-J - Taro (User: jbwharris)
Bon Iver - Holocene (User: jbwharris)
The Velvet Underground & Nico - All Tomorrow's Parties (User: jbwharris)
Bone Thugs-N-Harmony - 1st of tha Month (User: jbwharris)
Leo Luxxxus - Gold Coast (User: jbwharris)
Pixies - Space (I Believe In) (User: jbwharris)
Soundgarden - Black Hole Sun (User: jbwharris)
Prodıgy - out of space (User: jbwharris)
The B-52's - Planet Claire (User: jbwharris)
Sun Kil Moon - Space Travel Is Boring (User: jbwharris)
The Smashing Pumpkins - Rocket (User: jbwharris)
A Flock of Seagulls - Space Age Love Song (User: jbwharris)
Metronomy - I'm Aquarius (User: jbwharris)
Kathleen Edwards - Who Rescued Who (User: jbwharris)
Heavenly Beat - Tradition (User: jbwharris)
Kevin Morby - City Music (User: jbwharris)
(Sandy) Alex G - Southern Sky (User: jbwharris)
Vampire Weekend - Rich Man (User: jbwharris)
Generationals - Dream Box (User: jbwharris)
The Lemon Twigs - Small Victories (User: jbwharris)
Haerts - Your Love (User: jbwharris)
Kurt Vile - Wakin On A Pretty Day (User: jbwharris)
Beirut - No No No (User: jbwharris)
The Zephyr Bones - HURRICANES (User: jbwharris)
Papooz - Downtown Babylon (User: jbwharris)
The Juan Maclean - A Simple Design (User: jbwharris)
Waxahatchee - Summer Of Love (User: jbwharris)
Noah Kahan - False Confidence (User: jbwharris)
Gruff Rhys - Limited Edition Heart (User: jbwharris)
okaywill - Starfinder (User: jbwharris)
Crumb - Ghostride (User: jbwharris)
Belle and Sebastian - Poor Boy (User: jbwharris)
Hot Chip - Spell (User: jbwharris)
Karen O & Danger Mouse - Turn the Light (User: jbwharris)
Slaughter Beach, Dog - Gold and Green (User: jbwharris)
My Chemical Romance - Welcome to the Black Parade (User: jbwharris)
James Bay - Trouble (Apple Music Home Session) (User: jbwharris)
Jackson Browne - The Night Inside Me (User: jbwharris)
Tyrone Davis - Can I Change My Mind (User: jbwharris)
The Offspring - She's Got Issues (User: jbwharris)
Lawrence Rothman - Kate's Not Here (feat. girl in red) [Day Wave & Lawrence Rothman Remix] (User: jbwharris)
Alec Shaw - Alone in My Bed (User: jbwharris)
Che Ecru - Wya (User: jbwharris)
TYCHO & rum.gold - Run Away (User: jbwharris)
Reverend and the Makers - Heavyweight Champion Of The World (User: jbwharris)
Trey Graves - new thang. (User: jbwharris)
Five Hundred Bucks - Spinal (User: jbwharris)
Isa Reyes - Whistles (User: jbwharris)
RAAHiiM - Peak (Fed Up) (User: jbwharris)
Hannah Georgas - Dreams (User: jbwharris)
Hootie & The Blowfish - Miss California (User: jbwharris)
Bastille - Pompeii (User: jbwharris)
Chaz Cardigan - Not OK! (User: jbwharris)
Yo La Tengo - For You Too (User: jbwharris)
Dory Previn - Atlantis (User: jbwharris)
Glacier - Neos (User: jbwharris)
Freezing Cold - Parentheses (User: jbwharris)
Daily J - Rocket (User: jbwharris)
Lala Lala & Grapetooth - Fantasy Movie (User: jbwharris)
Larkins - Hit and Run (User: jbwharris)
Alice in Chains - Man in the Box (User: jbwharris)
Myles Cameron - Prettysoon (User: jbwharris)
Lana Del Rey - The Greatest (User: jbwharris)
Gang of Four - The Dying Rays (2020) (User: jbwharris)
Honeymoan - Too Much (User: jbwharris)
Hangedup - New Blue Monday (User: jbwharris)
DJ Shadow & De La Soul - Rocket Fuel (feat. De La Soul) (User: jbwharris)
Pool Surfers - Indulge (User: jbwharris)
Gigi Lo - Undone (User: jbwharris)
Airstream Futures - Cemetery Sparrow (User: jbwharris)
Goat Girl - The Crack (User: jbwharris)
Love Mansuy - Mine (User: jbwharris)
Tatiana Hazel - IN MY ROOM! (User: jbwharris)
The Gossip - Standing in the Way of Control (User: jbwharris)
Memphis Bleek - Do My... (feat. Jay-Z) (User: jbwharris)
Michelle - away (User: jbwharris)
UNO stereo - TEXT (feat. Amindi) (User: jbwharris)
Fly Pan Am - Dans ses cheveux soixante circuits (User: jbwharris)
April + VISTA - How To Get By (User: jbwharris)
EL VY - Are These My Jets (30 Days, 30 Songs) (User: jbwharris)
Annette Funicello - Train of Love (User: jbwharris)
Murcof - Isaías IV (User: jbwharris)
Belle and Sebastian - It Could Have Been a Brilliant Career (User: jbwharris)
Keane - Your Eyes Open (User: jbwharris)
The War on Drugs - Accidentally Like a Martyr (User: jbwharris)
LEO BHANJI - Heathers (User: jbwharris)
Gone Gone Beyond, Moontricks & The Human Experience - Coast (User: jbwharris)
snny - Postmodern Black (User: jbwharris)
Cher - SOS (User: jbwharris)
Sharon Jones & The Dap-Kings - 100 Days, 100 Nights (User: jbwharris)
Shaun Jacobs - Worry (User: jbwharris)
Dagny - Landslide (User: jbwharris)
Sufjan Stevens & Lowell Brams - What It Takes (User: jbwharris)
Vivian Leva & Riley Calcagno - Will You (User: jbwharris)
Tears for Fears - Shout (User: jbwharris)
Dido - Thank You (User: jbwharris)
Missy Higgins - The Sound of White (User: jbwharris)
Drugstore - El President (User: jbwharris)
Oasis - Gas Panic! (User: jbwharris)
Underworld - Appleshine (All of the Lights) (User: jbwharris)
The National - Walk Off (User: jbwharris)
New Order - Blue Monday '88 (User: jbwharris)
The Verve - 02 - Lucky Man (User: jbwharris)
Stevie Wonder - Higher Ground (User: jbwharris)
Mumford & Sons - The Cave (User: jbwharris)
Taylor Swift - coney island (feat. The National) (User: jbwharris)
Richard Ashcroft - Good Lovin (User: jbwharris)
Matthew Good - We're So Heavy (User: jbwharris)
The Black Crowes - Good Friday (User: jbwharris)
Jeff Buckley - Grace (User: jbwharris)
DJ Shub - Smoke Dance Three (User: jbwharris)
Steelings - Stop Time (User: jbwharris)
The Reytons - Headache (User: jbwharris)
The English Beat - I Confess (User: jbwharris)
Yusuf / Cat Stevens - Father And Son (User: jbwharris)
Stephen Stills - Helplessly hoping (User: jbwharris)
City and Colour - Sam Malone (User: jbwharris)
Hand Habits - can’t calm down (User: jbwharris)
Childish Gambino - Summertime Magic (User: jbwharris)
Wilco - Dawned on Me (User: jbwharris)
Sharon Jones & The Dap-Kings - Better Things (User: jbwharris)
Arcade Fire - We Don't Deserve Love (User: jbwharris)
Shannon O'Hara - The Fire (User: jbwharris)
Trisha Yearwood - How Do I Live (User: jbwharris)
Catfish and the Bottlemen - Longshot (User: jbwharris)
Jesse Fellows - Lucky Numbers (User: jbwharris)
Suzi Quatro - Born To Run (User: jbwharris)
Stone Temple Pilots - Plush (User: jbwharris)
The Real Billy Keane - Never Give Up (Quarantine Demo) (User: jbwharris)
The River South - There's Nothing Beneath Us (User: jbwharris)
Mike McKenna Jr. - High Ground (User: jbwharris)
Rochelle Jordan - Fill Me In (User: jbwharris)
Mariano Yanani - (I Can't Get No) Satisfaction (User: jbwharris)
Prides - What's Love Got To Do With It (User: jbwharris)
Billy Joel - She's Always a Woman (User: jbwharris)
Madonna - The Power of Good-Bye (User: jbwharris)
Cold War Kids - Complainer (User: jbwharris)
Starflyer 59 - Messed Up Over You (User: jbwharris)
Daniel Powter - Bad Day (User: jbwharris)
Verzache - Look Away (User: jbwharris)
Jack Peñate - Spit at Stars (User: jbwharris)
The 1975 - TOOTIMETOOTIMETOOTIME (User: jbwharris)
Kevin Ross - Thing Called Love (User: jbwharris)
Alanis Morissette - You Learn (User: jbwharris)
Jack Johnson - The Captain Is Drunk (User: jbwharris)
ANOHNI - I WILL SURVIVE (User: jbwharris)
David Bowie - White Light/White Heat (ChangesNowBowie Version) (User: jbwharris)
The Corrs - Runaway (User: jbwharris)
Joan Shelley - The Push and Pull (User: jbwharris)
Israel Nash - Down in the Country (User: jbwharris)
Djo - Roddy (User: jbwharris)
Fugazi - Waiting Room (User: jbwharris)
Oasis - Don't Look Back in Anger (User: jbwharris)
Incubus - Drive (User: jbwharris)
PHNTMS - Back Burner (User: jbwharris)
Niall Horan - No Judgement (User: jbwharris)
Oasis - Supersonic (User: jbwharris)
The Killers - Mr. Brightside (User: jbwharris)
Justin Timberlake - SexyBack (User: jbwharris)
Nelly Furtado - Promiscuous (feat. Timbaland) (User: jbwharris)
The Black Crowes - Good Friday (User: jbwharris)
PJ Harvey - Good Fortune (User: jbwharris)
Flo Rida - Good Feeling (User: jbwharris)
Failure - Dark Speed (User: jbwharris)
King Princess - Upper West Side (User: jbwharris)
Pavement - Strings of Nashville (User: jbwharris)
wildes - Don't Think Twice, It's All Right (User: jbwharris)
Live - Selling The Drama (User: jbwharris)
Moon Duo - Dance, Part 3 (User: jbwharris)
MGMT - Little Dark Age (User: jbwharris)
Baby B - Do You Better (User: jbwharris)
The King's Parade - Mad (User: jbwharris)
Mad8 vs. Shawn Christopher - Just Another Sleepless Night (Out Of Office Remix) (User: jbwharris)
Tommee Profitt - Wake Me Up (feat. Fleurie) (User: jbwharris)
Smog - Let's Move to the Country (User: jbwharris)
Edwyn Collins - A Girl Like You (User: jbwharris)
The Postal Service - Such Great Heights (User: jbwharris)
Yaeji - Passionfruit (User: jbwharris)
Cory Henry - Don't Forget (User: jbwharris)
Underworld - Appleshine (All of the Lights) (User: jbwharris)
Steve Miller Band - Take the Money and Run (User: jbwharris)
Hujaboy - Creatures and Voices (User: jbwharris)
Betty Davis - Anti Love Song (User: jbwharris)
M. Ward - You've Changed (User: jbwharris)
Jim Croce - I'll Have to Say I Love You in a Song (User: jbwharris)
Gallus - Marmalade (User: jbwharris)
Nirvana - Jesus Doesn't Want Me For A Sunbeam (User: jbwharris)
Noble Oak - Derailed (User: jbwharris)
Birdy - The District Sleeps Alone Tonight (User: jbwharris)
Muse - Supermassive Black Hole (User: jbwharris)
Max Graef - Buchsenoffner (User: jbwharris)
Iron Maiden - The Number of the Beast (User: jbwharris)
Aidan Knight - Houston TX (User: jbwharris)
Smash Mouth - All Star (User: jbwharris)
The Persuaders - Thin Line Between Love And Hate (User: jbwharris)
Blu Detiger - Figure It Out (User: jbwharris)
Neon Waltz - Strung Up (User: jbwharris)
Faces - Maybe I'm Amazed (User: jbwharris)
Amy Shark - Psycho (feat. Mark Hoppus) (User: jbwharris)
Dirty Three - I Remember a Time When Once You Used to Love Me (User: jbwharris)
Endre Nordvik - Be the One (feat. Maesa Pullman) (User: jbwharris)
Forrest - Never Had (User: jbwharris)
Werner Bekker - Let It Go (User: jbwharris)
MonaLisa Twins - People Are Strange (User: jbwharris)
Kitty Coen - Dark Soul (User: jbwharris)
Haich Ber Na - 0594 Help (User: jbwharris)
Arctic Monkeys - 505 (User: jbwharris)
The Decemberists - Here I Dreamt I Was an Architect (User: jbwharris)
Mac Miller - Another Night (User: jbwharris)
The Casket Lottery - Another Holiday (User: jbwharris)
The Struts & Albert Hammond Jr. - Another Hit Of Showmanship (User: jbwharris)
Ashton McCreight - Million (feat. Love Mansuy & Kaiya Crawford) (User: jbwharris)
Arctic Monkeys vs The Killers - Scumbody Told Me (User: jbwharris)
Catherine Wheel - Black Metallic (User: jbwharris)
Sloan - People Of The Sky (User: jbwharris)
Björk - Human Behaviour (User: jbwharris)
Ela Minus - dominique (User: jbwharris)
Bon Iver - 22 Over Soon Bob Moose Extended Cab Version (User: jbwharris)
Hot Chip - Straight To The Morning feat. Jarvis Cocker (User: jbwharris)
R.E.M. - I Believe (User: jbwharris)
Baby Boys - Duke and the Cash (User: jbwharris)
SZA - Good Days (User: jbwharris)
Maggie Rogers - Light On (User: jbwharris)
Pearl Jam - Yellow Ledbetter (User: jbwharris)
Madlib - Road of the Lonely Ones (User: jbwharris)
Howlin' Wolf - I Ain't Superstitious (User: jbwharris)
Barry Gibb - Words of a Fool feat. Jason Isbell (User: jbwharris)
Big Thief - Not (User: jbwharris)
Jon Batiste - I NEED YOU (User: jbwharris)
D'Angelo - Untitled (How Does It Feel) (User: jbwharris)
Anjimile - Baby No More (User: jbwharris)
Michigander - Let Down (User: jbwharris)
Foals - Inhaler (User: jbwharris)
The Beths - Out of Sight (User: jbwharris)
Painted Shield - Knife Fight (User: jbwharris)
PJ Harvey - You Said Something (User: jbwharris)
Kaleo - Break My Baby (User: jbwharris)
The Lumineers - Gloria (User: jbwharris)
Kings of Leon - Echoing (User: jbwharris)
Kings of Leon - The Bandit (User: jbwharris)
Billie Eilish - all the good girls go to hell (User: jbwharris)
Arlo Parks - Black Dog (User: jbwharris)
Catfish and the Bottlemen - 7 (User: jbwharris)
Anderson Paak - Lockdown (User: jbwharris)
Maddie Medley - Coming of Age (User: jbwharris)
The Flaming Lips - Race for the Prize (remix) (User: jbwharris)
beabadoobee - Care (User: jbwharris)
Nathaniel Rateliff - Redemption (User: jbwharris)
Mavis Staples - All in It Together (User: jbwharris)
Beastie Boys - Pass the Mic (User: jbwharris)
Black Pumas - Strangers feat. Lucius (User: jbwharris)
Wilson Pickett - Mustang Sally (User: jbwharris)
The Hold Steady - Family Farm (User: jbwharris)
Hurray For The Riff Raff - Hungry Ghost (User: jbwharris)
Kid Dakota - Homesick (User: jbwharris)
Har Mar Superstar - Sleight of Hand (User: jbwharris)
Oasis - Morning Glory (User: jbwharris)
R.L. Burnside - Let My Baby Ride (User: jbwharris)
ONR - Must Stop feat. Sarah Barthel (User: jbwharris)
Buzzcocks - What Do I Get? (User: jbwharris)
Sloan - Witch's Wand (User: jbwharris)
Frances Forever - Space Girl (User: jbwharris)
The Shackletons - Exactly What It Looks Like (User: jbwharris)
Dylan Cartlidge - Molasses (Walk The Walk) (User: jbwharris)
John Parish and Polly Jean Harvey - Black Hearted Love (User: jbwharris)
The Sugarcubes - Birthday (User: jbwharris)
Kiwi Jr. - Cooler Returns (User: jbwharris)
Hank Williams - Half As Much (User: jbwharris)
Yuna - Dance Like Nobody's Watching (User: jbwharris)
Tommy Dorsey - Opus One (User: jbwharris)
Elvis Costello - Lipstick Vogue (User: jbwharris)
Ketch Harbour Wolves - Parkdale Night (User: jbwharris)
Fleet Foxes - Can I Believe You (User: jbwharris)
Kathleen Edwards - Hard On Everyone (User: jbwharris)
Black Sabbath - Paranoid (User: jbwharris)
Spoon - Do I Have To Talk You Into It (User: jbwharris)
The Jon Spencer Blues Explosion - Bag Of Bones (User: jbwharris)
Tash Sultana - Sweet and Dandy (User: jbwharris)
The Fall - Rollin' Danny (User: jbwharris)
Gorillaz - The Valley of The Pagans feat. Beck (User: jbwharris)
The Cure - Close to Me (User: jbwharris)
Middle Kids - Questions (User: jbwharris)
Ondara - Lockdown On Date Night Tuesday (User: jbwharris)
Eddie Cochran - C'mon Everybody (User: jbwharris)
Prince - Positivity (User: jbwharris)
Annie Humphrey - Sacred Rage (User: jbwharris)
Dessa - Rome (User: jbwharris)
KHRUANGBIN AND LEON BRIDGES - TEXAS SUN (User: jbwharris)
Buffalo Tom - Taillights Fade (User: jbwharris)
The Avalanches - The Divine Chord feat. MGMT and Johnny Marr (User: jbwharris)
Cage the Elephant - Spiderhead (User: jbwharris)
Elliott Smith - Memory Lane (User: jbwharris)
Jose Gonzalez - El Invento (User: jbwharris)
PJ Harvey - Good Fortune (User: jbwharris)
Remi Wolf - Hello Hello Hello (User: jbwharris)
David Bowie - Let's Dance (User: jbwharris)
Hippo Campus - Way It Goes (User: jbwharris)
The Magnetic Fields - Andrew In Drag (User: jbwharris)
Run Westy Run - Mop It Up (User: jbwharris)
Jazmine Sullivan - Pick Up Your Feelings (User: jbwharris)
The Staves - Trying (User: jbwharris)
The Verve - The Drugs Don't Work (User: jbwharris)
Tame Impala - Lost in Yesterday (User: jbwharris)
Nur-D - BandAid prod. Cxdy (User: jbwharris)
The M's - Plan of the Man (User: jbwharris)
Thao and the Get Down Stay Down - Temple (User: jbwharris)
Altin Gu¨n - Ordunun Dereleri (User: jbwharris)
Bruce Springsteen - Ghosts (User: jbwharris)
KAREN O and WILLIE NELSON - Under pressure (User: jbwharris)
Munson-Hicks Party Supplies - Only Smoke (User: jbwharris)
Barry Gibb - Run To Me Feat. Brandi Carlile (User: jbwharris)
Le Tigre - TKO (User: jbwharris)
Devo - Uncontrollable Urge (User: jbwharris)
Lucero - Back in Ohio (User: jbwharris)
Tegan and Sara - I'll Be Back Someday (User: jbwharris)
Samm Henshaw - All Good (User: jbwharris)
Beastie Boys - Johnny Ryall (User: jbwharris)
Manchester Orchestra - Bed Head (User: jbwharris)
SZA - Good Days (User: jbwharris)
Johnny Cash - Jackson (User: jbwharris)
Jade Bird - Headstart (User: jbwharris)
Puma Blue - Opiate (User: jbwharris)
My Morning Jacket - Big Decisions (User: jbwharris)
Nathaniel Rateliff and the Night Sweats - A Little Honey (User: jbwharris)
Gorillaz - Desole feat. Fatoumata Diawara (User: jbwharris)
Cherry Glazerr - Rabbit Hole (User: jbwharris)
PJ Harvey - Sheela-Na-Gig (User: jbwharris)
Dehd - Month (User: jbwharris)
Empire of the Sun - Walking on a Dream (User: jbwharris)
TV Priest - This Island (User: jbwharris)
The Avalanches - Wherever You Go feat. Jamie xx, Neneh Cherry and CLYPSO (User: jbwharris)
Bully - Running (User: jbwharris)
Talking Heads - Burning Down the House (User: jbwharris)
Black Pumas - Strangers feat. Lucius (User: jbwharris)
IDLES - Anxiety (User: jbwharris)
Blu Detiger - Figure It Out (User: jbwharris)
Nancy Sinatra - Bang Bang (My Baby Shot Me Down) (User: jbwharris)
Har Mar Superstar - Sleight of Hand (User: jbwharris)
Joni Mitchell - Big Yellow Taxi (User: jbwharris)
Patsy Cline - She's Got You (User: jbwharris)
Aretha Franklin - Do Right Woman, Do Right Man (User: jbwharris)
Madonna - Into the Groove (User: jbwharris)
Suzi Quatro - She's In Love With You (User: jbwharris)
Tracy Chapman - Fast Car (User: jbwharris)
Annie Lennox - Walking on Broken Glass (User: jbwharris)
Nina Simone - Feeling Good (User: jbwharris)
Linda Ronstadt - You're No Good (User: jbwharris)
The Magic Numbers - Love Me Like You (User: jbwharris)
Brittany Howard - He Loves Me (User: jbwharris)
Fleet Foxes - He Doesn't Know Why (User: jbwharris)
FKA twigs - Don't Judge Me feat. Headie One and Fred Again (User: jbwharris)
Weezer - All My Favorite Songs (User: jbwharris)
Andra Day - Strange Fruit (User: jbwharris)
Devon Gilfillian - Get Out And Get It (User: jbwharris)
The English Beat - Twist and Crawl (User: jbwharris)
Billie Eilish - everything i wanted (User: jbwharris)
The Hold Steady - Heavy Covenant (User: jbwharris)
Anjimile - Baby No More (User: jbwharris)
PJ Harvey - Man-Size (User: jbwharris)
Silversun Pickups - It Doesn't Matter Why (User: jbwharris)
Tune-Yards - hold yourself (User: jbwharris)
Elvis Costello - Alison (User: jbwharris)
Kaleo - Break My Baby (User: jbwharris)
Sturgill Simpson - Sing Along (User: jbwharris)
Arlo Parks - Hurt (User: jbwharris)
Houndmouth - Sedona (User: jbwharris)
The War on Drugs - Red Eyes (User: jbwharris)
Hawksley Workman - We Will Still Need a Song (User: jbwharris)
Rag N Bone Man - All You Ever Wanted (User: jbwharris)
The Tragically Hip - Music at Work (User: jbwharris)
The Dirty Nil - Blunt Force Concussion (User: jbwharris)
Dayglow - Close to You (User: jbwharris)
The Glorious Sons - Pink Motel (User: jbwharris)
The Strokes - Last Nite (User: jbwharris)
Daft Punk - Get Lucky (feat. Pharrell Williams) (User: jbwharris)
Queens of the Stone Age - No One Knows (User: jbwharris)
Powfu Ft. Beabadoobee - death bed (coffee for your head) (User: jbwharris)
Feist - My Moon My Man (User: jbwharris)
Royal Blood - Trouble's Coming (User: jbwharris)
Sam Soberts - Fixed to Ruin (User: jbwharris)
Sam Coffey And The Iron Lungs - Back with the Gang (User: jbwharris)
Walk the Moon - Shut Up and Dance (User: jbwharris)
The Strumbellas - Greatest Enemy (User: jbwharris)
Acres of Lions - Reaction (User: jbwharris)
Modest Mouse - Missed the Boat (User: jbwharris)
Loony - be cool (User: jbwharris)
Machine Gun Kelly - My Ex's Best Friend (User: jbwharris)
Ruby Waters - Supernatural (User: jbwharris)
Good Charlotte - The Anthem (User: jbwharris)
Death Cab for Cutie - Soul Meets Body (User: jbwharris)
Brave Shores - More Like You (User: jbwharris)
Arcade Fire - Afterlife (User: jbwharris)
Royal Blood - Typhoons (User: jbwharris)
Marshmello - Silence (User: jbwharris)
JJ Wilde - Mercy (User: jbwharris)
Tokyo Police Club - Nature Of The Experiment (User: jbwharris)
Bakar - 1st Time (User: jbwharris)
Arctic Monkeys - I Bet You Look Good on the Dancefloor (User: jbwharris)
Tuns - My Memories (User: jbwharris)
Glass Animals - Heat Waves (User: jbwharris)
July Talk - Governess Shadow (User: jbwharris)
Coldplay - Talk (User: jbwharris)
Florence + the Machine - Dog Days Are Over (User: jbwharris)
The Tragically Hip - Wheat Kings (User: jbwharris)
Foo Fighters - Waiting on a War (User: jbwharris)
Monowhales - All Or Nothing (User: jbwharris)
Garbage - #1 Crush (User: jbwharris)
Cold War Kids - First (User: jbwharris)
The Beaches - Lame (User: jbwharris)
Kiwi jr - Waiting in Line (User: jbwharris)
Tegan and Sara - Hell (User: jbwharris)
Machine Gun Kelly - bloody valentine (User: jbwharris)
Billie Eilish - Therefore I Am (User: jbwharris)
Mother Mother - Give Me Back The Night (User: jbwharris)
The New Pornographers - Sing Me Spanish Techno (User: jbwharris)
Grae - Permanent Maniac (User: jbwharris)
MGMT - Kids (User: jbwharris)
Broken Social Scene - 7/4 Shoreline (User: jbwharris)
The Zolas - Get Dark (User: jbwharris)
Kings of Leon - The Bandit (User: jbwharris)
Elbow - Grounds for Divorce (User: jbwharris)
JJ Wilde - Mercy (User: jbwharris)
Mumford & Sons - I Will Wait (User: jbwharris)
grandson - Dirty (User: jbwharris)
Cannons - Fire For You (User: jbwharris)
blink-182 - I Miss You (User: jbwharris)
Anyway Gang - Eyes of Green (User: jbwharris)
The Killers - My Own Soul's Warning (User: jbwharris)
Dan Mangan - Race To The Bottom (User: jbwharris)
K-0s - Sunday Morning (User: jbwharris)
Sam Roberts Band - Take Me Away (User: jbwharris)
Billie Eilish - all the good girls go to hell (User: jbwharris)
Panic! at the Disco - I Write Sins Not Tragedies (User: jbwharris)
The Weeknd - Blinding Lights (User: jbwharris)
Jahdan Blakkamoore - Play the Role (Big Slap Riddim) (User: jbwharris)
José James - It's All Over Your Body (User: jbwharris)
Kali Uchis - telepatía (User: jbwharris)
Farhot - Yak Sher (User: jbwharris)
Dawn Richard - Bussifame (User: jbwharris)
Duke Hugh feat. Renato Paris - Common Ground (User: jbwharris)
Jr. Thomas & The Volcanos - Sunk In The Mist (User: jbwharris)
Pasteur Lappé - Na Real Sekele Fo'Ya (User: jbwharris)
Nat King Cole - The Game of Love (User: jbwharris)
Loshh - É Beré (User: jbwharris)
Neon Dreams - Sick of Feeling Useless (User: jbwharris)
Gnarls Barkley - Crazy (User: jbwharris)
Rachel Platten - Fight Song (User: jbwharris)
Wallows - Are You Bored Yet? (feat. Clairo) (User: jbwharris)
Mogwai - Dry Fantasy (User: jbwharris)
Washed Out - You and I (User: jbwharris)
Spoon - The Underdog (User: jbwharris)
Kings of Leon - Sex on Fire (User: jbwharris)
Death Cab for Cutie - The New Year (User: jbwharris)
The Black Keys - Lonely Boy (User: jbwharris)
Radiohead - My Iron Lung (User: jbwharris)
Pink Floyd - Brain Damage (User: jbwharris)
David Bowie - Space Oddity (User: jbwharris)
Alessia Cara - Out of Love (User: jbwharris)
Tate McRae - you broke me first (User: jbwharris)
Sia - Lie to Me (User: jbwharris)
Ariana Grande - motive (User: jbwharris)
Taylor Swift - coney island (feat. The National) (User: jbwharris)
The Hold Steady - Hurricane J (User: jbwharris)
Mirah - Country Of The Future (User: jbwharris)
Neil Young - Harvest Moon (User: jbwharris)
Dirty Projectors - Hyperballad (User: jbwharris)
Matthew Sweet - Sick of Myself (User: jbwharris)
Jerry Douglas - The Boxer (feat. Mumford & Sons & Paul Simon) (User: jbwharris)
Simon & Garfunkel - The Boxer (User: jbwharris)
The Gaslight Anthem - Boxer (User: jbwharris)
Editors - The Boxer (User: jbwharris)
The Chemical Brothers - The Boxer (User: jbwharris)
The Rosebuds - Boxcar (User: jbwharris)
Orbital - The Box, Pt. 2 (User: jbwharris)
Kurt Vile & the Violators - Box of Rain (User: jbwharris)
Orbital - The Box (Parts 1-4) (User: jbwharris)
Flight of the Conchords - Bowie (User: jbwharris)
RYAN Playground - Better Off Alone (User: jbwharris)
Daryl Hall & John Oates - She's Gone (User: jbwharris)
Bill Jerpe - Another Day Goes Down (User: jbwharris)
Earl Sweatshirt - Chum (User: jbwharris)
The Band - Look Out Cleveland (User: jbwharris)
Parliament - Swing Down, Sweet Chariot (User: jbwharris)
Kathleen Edwards - Hard On Everyone (User: jbwharris)
Gavin Magnus & Jam Jr. - Circles (User: jbwharris)
Nic preen - I'm Not There (User: jbwharris)
Foo Fighters - Best of You (User: jbwharris)
Diamond Thug - Empty Streets (User: jbwharris)
Chastity - Drain the Bloodbath (User: jbwharris)
JOY. - Smoke Too Much (User: jbwharris)
Blossoms - The Keeper (User: jbwharris)
Laye - dancing (User: jbwharris)
Hangtime - My Only One (User: jbwharris)
Filous & The Kooks - Hey Love (User: jbwharris)
Florence + the Machine - Shake It Out (User: jbwharris)
m5k - Ice Cold Party Jam (User: jbwharris)
Pomrad - Dans (User: jbwharris)
Night Beats - Her Cold Cold Heart (User: jbwharris)
Into It. Over It. - Upstate Blues (User: jbwharris)
Sean Koch - Heartbreaker (User: jbwharris)
Wry - I Can Change (User: jbwharris)
Dolly Parton - Harper Valley PTA (User: jbwharris)
CamelPhat, Yannis & Foals - Hypercolour (User: jbwharris)
DJ Mehdi - Lucky Boy (Outlines remix) (User: jbwharris)
Prado - Men in Black (User: jbwharris)
The Ruby Suns - Ole Rinka (User: jbwharris)
Muzz - Broken Tambourine (User: jbwharris)
Ages and Ages - Ante Up (User: jbwharris)
The Postal Service - Nothing Better (User: jbwharris)
Grizzly Bear - Losing All Sense (User: jbwharris)
The Pack A.D. - Sirens (User: jbwharris)
PHABO - Apple Juice & Henny (User: jbwharris)
Greatest Hits - Phil, Slow It Down (User: jbwharris)
Lime Cordiale - On Our Own (User: jbwharris)
Bad Moves - Cape Henlopen (User: jbwharris)
Porches - Patience (User: jbwharris)
Mumford & Sons - Blind Leading the Blind (User: jbwharris)
Cat Power - Dark End of the Street (User: jbwharris)
Bob Dylan - Things Have Changed (User: jbwharris)
TV on the Radio - Wolf Like Me (User: jbwharris)
The Stone Roses - I Wanna Be Adored (User: jbwharris)
Miley Cyrus - Angels Like You (User: jbwharris)
Joan Osborne - Take It Any Way I Can Get It (User: jbwharris)
The Smashing Pumpkins - Anti-Hero (User: jbwharris)
Lila Tristram - Leaving Song (User: jbwharris)
Mad Hawkes - Face Pnch (User: jbwharris)
Oh No Oh My - The Party Punch (User: jbwharris)
Lana Del Rey - Fuck it I love you (User: jbwharris)
The Rescues - Losing my religion (User: jbwharris)
Twan Ray - We Could Start a Thing (User: jbwharris)
David Shaw - Shaken (User: jbwharris)
JJ Wilde - Mercy (User: jbwharris)
Boys Noize - Ich R U (Jacques Lu Cont remix) (User: jbwharris)
Robinson - Don't Trust Myself (User: jbwharris)
Henriette Sennenvaldt - Clumsy (User: jbwharris)
Phoenix - Rome (User: jbwharris)
Luluc - Small Window (User: jbwharris)
SG Lewis & Lucky Daye - Feed The Fire (User: jbwharris)
Sufjan Stevens - Sugar (User: jbwharris)
Doves - Broken Eyes (User: jbwharris)
Dave Matthews Band - Crush (User: jbwharris)
The Wild Feathers - Blue (User: jbwharris)
Sam Roberts - We're All in This Together (User: jbwharris)
Matt Berninger - One More Second (User: jbwharris)
James Blake - Before (User: jbwharris)
cerian - Our Love Is (feat. Robert Taira Wilson) (User: jbwharris)
Lou Reed & John Cale - A Dream (User: jbwharris)
Arctic Monkeys - R U Mine (User: jbwharris)
Tough Age - Penny Current Suppression Ring (User: jbwharris)
Thibault - See The World (User: jbwharris)
Raising the Fawn - The North Sea (User: jbwharris)
Sarah Harmer - Don't Get Your Back Up (User: jbwharris)
Marika Hackman - the one (User: jbwharris)
Ela Minus - they told us it was hard, but they were wrong. (User: jbwharris)
Crystal Fighters - Xtatic Truth (User: jbwharris)
Bob Dylan - I Contain Multitudes (User: jbwharris)
Fly Pan Am - Univoque/equivoque (User: jbwharris)
Chris Cornell - Nothing Compares 2 U (User: jbwharris)
Les Rythmes Digitales - (Hey You) What's That Sound? (User: jbwharris)
Les Rythmes Digitales - (Hey You) What's That Sound? (User: jbwharris)
Margaux - Cave In (User: jbwharris)
Zach Bryan - November Air (User: jbwharris)
Lenny Kravitz - It Ain't Over 'til It's Over (User: jbwharris)
Sophie - fall (User: jbwharris)
Ivy - Tess Don't Tell (User: jbwharris)
July Talk - The News (User: jbwharris)
TV on the Radio - Seeds (User: jbwharris)
Steely Dan - I Got The News (User: jbwharris)
The Chemical Brothers - Leave Home (User: jbwharris)
Loudon Wainwright III - The Man Who Couldn't Cry (User: jbwharris)
Helena Hauff - The First Time He Thought, He Died (User: jbwharris)
Vince Guaraldi Trio - Skating (User: jbwharris)
Emilyn Brodsky - Someone Belongs Here (User: jbwharris)
Wagon Christ - Toomorrow (User: jbwharris)
spill tab - Name (User: jbwharris)
Dan Mangan - Losing My Religion (User: jbwharris)
Mitski - Lonesome Love (User: jbwharris)
Victoria Victoria - Sanctuary (User: jbwharris)
Exmag - NuFunk Odyssey (User: jbwharris)
Yang - Therapy (User: jbwharris)
Mise en Scene - Love and War (User: jbwharris)
Curlybamm - Song to You (feat. Jayygoinup) (User: jbwharris)
Sault - Monsters (User: jbwharris)
Mint Field - Delicadeza (User: jbwharris)
Dua Saleh - Warm Pants (User: jbwharris)
Sturgill Simpson - In Bloom (User: jbwharris)
The Walkmen - Red Moon (User: jbwharris)
Pure - The Tip (User: jbwharris)
The Charlatans - One to Another (User: jbwharris)
Dan Mangan - In The Aeroplane Over The Sea (User: jbwharris)
Paul Simon - Duncan (User: jbwharris)
SASAMI - Toxicity (User: jbwharris)
Tommy James & The Shondells - Draggin' the Line (User: jbwharris)
Didirri - Raw Stuff (User: jbwharris)
Blur - Coffee & TV (User: jbwharris)
Francis Aud - Without You (User: jbwharris)
Ryan Adams - Voices (User: jbwharris)
Chloe Moriondo - dreams (User: jbwharris)
Machinedrum - Spin Blocks (feat. Father) (User: jbwharris)
Joni Mitchell - A Case of You (User: jbwharris)
Badflower - Promise Me (User: jbwharris)
The Novaks - I'll Give You A Ring (User: jbwharris)
Cold War Kids - First (User: jbwharris)
Yuno - Sunlight (User: jbwharris)
Matt Sperrazza - Happy Ever After (User: jbwharris)
Dream Boat - No Air (User: jbwharris)
Depeche Mode - Policy of Truth (User: jbwharris)
Zoon - Landscapes (User: jbwharris)
Jenny Kern - Slow Burn (User: jbwharris)
Bahamas - Trick To Happy (User: jbwharris)
Jewel - Who Will Save Your Soul (User: jbwharris)
Gram Parsons & Emmylou Harris - Love Hurts (User: jbwharris)
Pearl Jam - Better Man (User: jbwharris)
Tortoise - Tesseract (User: jbwharris)
The Sonder Bombs - k. (User: jbwharris)
Proper. - No Loitering (User: jbwharris)
Michael Jackson - Stranger in Moscow (User: jbwharris)
Amy Lilley - No Show (User: jbwharris)
Willy Mason - Hard Hand To Hold (User: jbwharris)
The Besnard Lakes - For Agent 13 (User: jbwharris)
Matthew Good - Black Helicopter (User: jbwharris)
Psychedelic Porn Crumpets - Tally-Ho (User: jbwharris)
Jeffrey Martin - Poor Man (User: jbwharris)
Frank Turner - Born to Run (User: jbwharris)
Brijean - Moody (User: jbwharris)
ZHU & Tinashe - Only (User: jbwharris)
Discotron - The Truth (User: jbwharris)
Winona Oak - Another Story (User: jbwharris)
R.E.M. - Orange Crush (User: jbwharris)
James Blake - Atmosphere (User: jbwharris)
Seeb, Goodboys & HRVY - Unfamiliar (User: jbwharris)
Danny Gatton - Funky Mama (User: jbwharris)
Jared & The Mill - Eliza (User: jbwharris)
Kasabian - Shoot the Runner (User: jbwharris)
Romy & Planningtorock - Lifetime (Planningtorock 'Let It Happen' Remix) (User: jbwharris)
Oasis - Stay Young (User: jbwharris)
We Are Animal - Black Magic (User: jbwharris)
Underworld - Appleshine (All of the Lights) (User: jbwharris)
Saint Etienne - Only Love Can Break Your Heart (User: jbwharris)
Golden - Sunburn (User: jbwharris)
grandson - Blood // Water (User: jbwharris)
The Glorious Sons - Closer to the Sky (User: jbwharris)
The OBGMs - Cash (User: jbwharris)
Oasis - Keep the Dream Alive (User: jbwharris)
The Verve - History (User: jbwharris)
Queens of the Stone Age - 3's & 7's (User: jbwharris)
Interpol - Public Pervert (User: jbwharris)
Penny & Sparrow - Don't Start Now (User: jbwharris)
The Jayhawks - Blue (User: jbwharris)
Scala & Kolacny Brothers - Champagne Supernova (User: jbwharris)
Merril Bainbridge - Under The Water (User: jbwharris)
Genesis - Robbery, Assault and Battery (User: jbwharris)
Caroline Spence - The Choir (User: jbwharris)
Goldfish - Sold My Soul (User: jbwharris)
Rhye - Beautiful (feat. Lewis OfMan) [Lewis Ofman Remix] (User: jbwharris)
Manchester Orchestra & Phoebe Bridgers - The Gold (User: jbwharris)
Modest Mouse - Float On (User: jbwharris)
Tegan and Sara - Nineteen (User: jbwharris)
Death Cab for Cutie - Title and Registration (User: jbwharris)
The Killers - Runaways (User: jbwharris)
Broken Social Scene - Stars and Sons (User: jbwharris)
Shad - Rose Garden (User: jbwharris)
Big Wreck - Under the Lighthouse (User: jbwharris)
Matthew Good - Empty's Theme Park (User: jbwharris)
Sloan - Everything You've Done Wrong (User: jbwharris)
Rusty - Misogyny (User: jbwharris)
Treble Charger - Brand New Low (User: jbwharris)
Matthew Good - Symbolistic White Walls (User: jbwharris)
Odds - I Would Be Your Man (User: jbwharris)
I Mother Earth - Another Sunday (User: jbwharris)
The Smashing Pumpkins - Landslide (User: jbwharris)
The Zolas - Knot In My Heart (User: jbwharris)
Crash Test Dummies - Afternoons & Coffeespoons (User: jbwharris)
Clementine & the Galaxy - Heart Shaped Box (User: jbwharris)
MAYE - My Love (User: jbwharris)
British Sea Power - It Ended on an Oily Stage (User: jbwharris)
The Only Ones - Another Girl Another Planet (User: jbwharris)
Thin Lear - Maniacs (User: jbwharris)
River Tiber - Taurus (User: jbwharris)
Collective Soul - December (User: jbwharris)
Perfume Genius - Jason (User: jbwharris)
Chet Faker - No Diggity (User: jbwharris)
Albany Lore - Gravity (User: jbwharris)
The Golden Dawn - I'll Be Around (User: jbwharris)
Solo Smith - Still In Love (feat. Trey Graves) (User: jbwharris)
Justice - Phantom, Pt. 1.5 (User: jbwharris)
Interpol - Specialist (User: jbwharris)
The Cribs - Hey Scenesters! (User: jbwharris)
J-Felix - Lady T (User: jbwharris)
Lee Hazlewood - If it's Monday Morning (User: jbwharris)
Cigarettes After Sex - Falling in Love (User: jbwharris)
Portformat - Mothership (feat. Dudley Perkins, Georgia Anne Muldrow) (User: jbwharris)
Nick De La Hoyde - Ghost (User: jbwharris)
Everlast - What It's Like (User: jbwharris)
The Copyrights - Welcome Wagon (User: jbwharris)
Billie Eilish - Therefore I Am (User: jbwharris)
Primal Scream - Loaded (User: jbwharris)
Cigarettes After Sex - Heavenly (User: jbwharris)
Iron & Wine - Half Moon (User: jbwharris)
C. James - Words That We Said (User: jbwharris)
The Russian Futurists - 2 Dots on a Map (User: jbwharris)
Rhye - Black Rain (User: jbwharris)
Cowboy Junkies - Rock And Bird (User: jbwharris)
Verzache - Life Inside (User: jbwharris)
Gold Spectacles - Reversing (User: jbwharris)
BENEE - Winter (feat. Mallrat) (User: jbwharris)
TV on the Radio - Wolf Like Me (User: jbwharris)
Deadsy - Tom Sawyer (User: jbwharris)
Ed Harcourt - She Fell Into My Arms (User: jbwharris)
Simple Minds - Don't You (Forget About Me) [2001 Remastered Version] (User: jbwharris)
Elliott Smith - Twilight (User: jbwharris)
Chloe Bodur - Reasons (User: jbwharris)
Molly Annelle - All In (User: jbwharris)
Suicide - Dream Baby Dream (User: jbwharris)
Nat Vazer - For A Moment (User: jbwharris)
Daniel Ellsworth & The Great Lakes - Waves (User: jbwharris)
Zola Jesus - Dangerous Days (User: jbwharris)
Niiice. - free earl (User: jbwharris)
PUP - Rot (User: jbwharris)
Red City Radio - Apocalypse, Please! (User: jbwharris)
Exitmusic - Space Oddity (User: jbwharris)
Barns Courtney - You And I (User: jbwharris)
Grimes - New Gods (User: jbwharris)
The Smashing Pumpkins - 1979 (User: jbwharris)
Father John Misty - Everyman Needs a Companion (User: jbwharris)
Us The Duo - Shake It Off (User: jbwharris)
David Bowie - I'm Afraid of Americans (V1) (User: jbwharris)
Wilco - I Must Be High (User: jbwharris)
Damien Rice - Chandelier (User: jbwharris)
Salem - Destroy Me (User: jbwharris)
Tristam - Violence (User: jbwharris)
Black Box - Everybody Everybody (User: jbwharris)
Equateur - Pélican (User: jbwharris)
Sixpence None the Richer - Don't Dream It's Over (User: jbwharris)
DMA's - Lay Down (User: jbwharris)
Simian Mobile Disco - Tangents (User: jbwharris)
Remy Zero - Fair (User: jbwharris)
Dream Nails - This Is the Summer (User: jbwharris)
Maxi Millz - Burning Ears (User: jbwharris)
St. Paul & The Broken Bones - Convex (User: jbwharris)
Radiohead - Nude (User: jbwharris)
Catherine Wheel - The Nude (User: jbwharris)
Sloan - The NS (User: jbwharris)
Rick Rubin - NR-G7 (User: jbwharris)
Eric Clapton - Change The World (User: jbwharris)
Eels - I Like The Way This Is Going (User: jbwharris)
Moses Sumney - Colouour (User: jbwharris)
Booba - Salade tomates oignons (feat. Djé) (User: jbwharris)
Wildwood Kin - Never Alone (User: jbwharris)
Gin Blossoms - Til I Hear It From You (User: jbwharris)
Tom Noble - Funk Mystikz (User: jbwharris)
Beath - Bright (User: jbwharris)
Nu Guinea Feat. Tony Allen - Phunkhysteria (User: jbwharris)
XL Middleton - Antislumper (FSQ Remix) (User: jbwharris)
Max Graef - Buchsenoffner (User: jbwharris)
E. Live - Feel You Up (User: jbwharris)
Onra - Don't Stop (User: jbwharris)
Reeno - Eternal Wisdom (User: jbwharris)
sauce81 - Bustin' (User: jbwharris)
Tony Ozier - Original Doo Doo (User: jbwharris)
Diamond Ortiz - Play It Kool (User: jbwharris)
Born Gold - End of Days (User: jbwharris)
Ramadanman - Glut (User: jbwharris)
X Ambassadors - Renegades (User: jbwharris)
grandson - Dirty (User: jbwharris)
Serena Ryder - Stompa (User: jbwharris)
The Killers - My Own Soul's Warning (User: jbwharris)
Crystal Castles - Not in Love (User: jbwharris)
The Strokes - The Adults Are Talking (User: jbwharris)
JJ Wilde - The Rush (User: jbwharris)
Coldplay - Yellow (User: jbwharris)
Tame Impala - Elephant (User: jbwharris)
July Talk - The News (User: jbwharris)
Brave Shores - More Like You (User: jbwharris)
Oasis - (What's The Story) Morning Glory? (User: jbwharris)
Glass Animals - Heat Waves (User: jbwharris)
Neon Dreams - Sick of Feeling Useless (User: jbwharris)
Radiohead - Karma Police (User: jbwharris)
Charlotte Cardin - Meaningless (User: jbwharris)
Simon & Garfunkel - Keep the Customer Satisfied (User: jbwharris)
Keane - Your Eyes Open (User: jbwharris)
Brooks Williams - Lizard Logic (User: jbwharris)
Joan Osborne - Take It Any Way I Can Get It (User: jbwharris)
Little Feat - All That You Dream (User: jbwharris)
Fleet Foxes - Can I Believe You (User: jbwharris)
Rockpile - When I Write the Book (User: jbwharris)
Tom Furse - Trans-Universal Express (User: jbwharris)
Early James - Blue Pill Blues (User: jbwharris)
Genesis - Robbery, Assault & Battery (User: jbwharris)
Karen O & Willie Nelson - Under Pressure (User: jbwharris)
David Bromberg - Kansas City (User: jbwharris)
Electric Light Orchestra - Rockaria! (User: jbwharris)
Sierra Ferrell - Why'd Ya Do It (User: jbwharris)
Anna Nalick - Breathe (2 A.M.) (User: jbwharris)
Xiu Xiu - Packard's Vibration (User: jbwharris)
The Amboy Dukes - Journey to the Center of the Mind (User: jbwharris)
Crosby, Stills & Nash - Guinnevere (User: jbwharris)
Fiona Apple - Shameika (User: jbwharris)
The Band - Look Out Cleveland (User: jbwharris)
Hall & Oates - She's Gone (User: jbwharris)
T. Rex - Metal Guru (User: jbwharris)
Raphael Saadiq - 100 Yard Dash (User: jbwharris)
Josiah Johnson - World's Not Gonna End (User: jbwharris)
Tycho - Montana (User: jbwharris)
Sly & The Family Stone - Stand (User: jbwharris)
Dylan LeBlanc - Cautionary Tale (User: jbwharris)
John Lee Hooker - Boom Boom (User: jbwharris)
Deep Sea Diver - Impossible Weight (feat. Sharon Van Etten) (User: jbwharris)
Tommy James & The Shondells - Draggin' the Line (User: jbwharris)
Bakar - 1st Time (User: jbwharris)
Coldplay - God Put a Smile on Your Face (User: jbwharris)
Los Lobos - Jenny's Got a Pony (User: jbwharris)
Shadowy Men on a Shadowy Planet - Popcorn (User: jbwharris)
EMF - Unbelieveable (User: jbwharris)
Toots Hibbert - Knock On Wood (User: jbwharris)
Caroline Spence - The Choir (User: jbwharris)
Marshall Crenshaw - Television Light (User: jbwharris)
Warren Zevon - Keep Me In Your Heart (User: jbwharris)
Phoenix - Identical (User: jbwharris)
Steve Forbert - It Isn't Gonna Be That Way (User: jbwharris)
The Ventures - Walk, Don't Run '64 (User: jbwharris)
Tori Amos - Up the Creek (User: jbwharris)
Strawbs - Benedictus (User: jbwharris)
Aaron Lee Tasjan - Up All Night (User: jbwharris)
Steely Dan - I Got The News (User: jbwharris)
Sea Level - Rain In Spain (User: jbwharris)
The Jayhawks - This Forgotten Town (User: jbwharris)
Rayland Baxter - Casanova (User: jbwharris)
Richard Leo Johnson - Where the Rivers Meet (User: jbwharris)
Melissa Etheridge - Like The Way I Do (User: jbwharris)
The Staves - Good Woman (User: jbwharris)
X - See How We Are (User: jbwharris)
Nilüfer Yanya - Crash (User: jbwharris)
Shovels & Rope - The Devil Is All Around (User: jbwharris)
Kississippi - Around Your Room (User: jbwharris)
Jane Siberry - Calling All Angels (User: jbwharris)
The T-Bones - No Matter What Shape (Your Stomach's In) (User: jbwharris)
Bob Marley & The Wailers - Iron Lion Zion (User: jbwharris)
HAIM - The Steps (User: jbwharris)
Prince - Kiss (User: jbwharris)
Blu Detiger - Figure It Out (User: jbwharris)
Wilson Pickett - Toe Hold (User: jbwharris)
Amy Ray - Sure Feels Good Anyway (User: jbwharris)
Kings of Leon - The Bandit (User: jbwharris)
Joe Jackson - Friend Better (User: jbwharris)
John Fahey - John Henry (2) (User: jbwharris)
Gorillaz - The Valley of the Pagans (feat. Beck) (User: jbwharris)
The Clash - Junco Partner (User: jbwharris)
Bailen - Your Love Is All I Know (User: jbwharris)
Sofia Valdes - Handful of Water (User: jbwharris)
Michaela Anne - Run Away With Me (User: jbwharris)
Brad - The Day Brings (User: jbwharris)
Tamar Aphek - Crossbow (User: jbwharris)
Yo La Tengo - Green Arrow (User: jbwharris)
UB40 - Here I Am (Come And Take Me) (User: jbwharris)
Nana Adjoa - She's Stronger (User: jbwharris)
Marvin Gaye - How Sweet It Is (User: jbwharris)
Low Cut Connie - Private Lives (User: jbwharris)
Kraftwerk - Computer Love (User: jbwharris)
Arlo Parks - Black Dog (User: jbwharris)
Santana - Everybody's Everything (User: jbwharris)
Weather Report - Black Market (User: jbwharris)
Grateful Dead - Jack Straw (User: jbwharris)
Erin McKeown - To the Stars (User: jbwharris)
sad13 - Ghost (of a Good Time) (User: jbwharris)
Los Super Seven - Teresa (User: jbwharris)
Rachael Yamagata - Even If I Don't (User: jbwharris)
Kathleen Edwards - Hard On Everyone (User: jbwharris)
Norman Greenbaum - Spirit in the Sky (User: jbwharris)
The Greyboy Allstars - Left Coast Boogaloo [instr] (User: jbwharris)
Tyrone Davis - Can I Change My Mind (User: jbwharris)
Paul McCartney - Find My Way (User: jbwharris)
Wilco - Dawned on Me (User: jbwharris)
The Shins - The Great Divide (User: jbwharris)
Counting Crows - Round Here (User: jbwharris)
Cordovas - High Feeling (User: jbwharris)
Hozier - Someone New (User: jbwharris)
Kurt Vile - Loading Zones (User: jbwharris)
Tortoise - Tesseract (User: jbwharris)
Boz Scaggs - Payday (User: jbwharris)
Elton John - Sixty Years On (User: jbwharris)
You're listening to WXPN HD2 - Public radio from the University of Pennsylvania    - (User: jbwharris)
David Shaw - Shaken (User: jbwharris)
The Sheepdogs - Let It All Show (User: jbwharris)
Filous & The Kooks - Hey Love (User: jbwharris)
Matt Maeson - Go Easy (User: jbwharris)
Big Nothing - Real Name (User: jbwharris)
Skinny Beats - My Best Life (User: jbwharris)
Candlebox - Far Behind (User: jbwharris)
LCD Soundsystem - Time to Get Away (User: jbwharris)
40 Winks - Outside the box (User: jbwharris)
The Streets - Fit But You Know It (User: jbwharris)
Perfume Genius - Longpig (User: jbwharris)
Francis and the Lights - Breaking Up (User: jbwharris)
Fenne Lily - Solipsism (User: jbwharris)
Roxy Caroline & Gourmet - Remember (User: jbwharris)
Live - Selling The Drama (User: jbwharris)
Peach Kelli Pop - Cut Me Off (User: jbwharris)
The 1975 - Chocolate (User: jbwharris)
Miami Horror - I Look To You (feat. Kimbra) (User: jbwharris)
Bad Religion - Sorrow (User: jbwharris)
Bow Anderson - Everybody Wants To Rule The World (User: jbwharris)
The Mesa - Days Gone By (User: jbwharris)
The Comet Is Coming - Timewave Zero (User: jbwharris)
The Fratellis - Chelsea Dagger (User: jbwharris)
Radiohead - Sit Down. Stand Up (User: jbwharris)
Vince Guaraldi Trio - Skating (User: jbwharris)
Donavon Frankenreiter - Fortunate Son (User: jbwharris)
Angel Olsen - Whole New Mess (User: jbwharris)
The Mountain Goats - New Monster Avenue (User: jbwharris)
Vance Joy - Saturday Sun (User: jbwharris)
Depeche Mode - Personal Jesus (User: jbwharris)
James Deacon - Rain On Me (User: jbwharris)
Moist - Underground (User: jbwharris)
Owl John - Cold Creeps (User: jbwharris)
Hot Hot Heat - Goodnight Goodnight (User: jbwharris)
Necklace - Main Street (User: jbwharris)
The Distillers - City of Angels (User: jbwharris)
Travis Scott - SICKO MODE (User: jbwharris)
Broken Social Scene - Anthems for a Seventeen Year-Old Girl (User: jbwharris)
Oasis - Stay Young (User: jbwharris)
Gustaf - Design (User: jbwharris)
Say Hi To Your Mom - Snowcones And Puppies (User: jbwharris)
Trashcan Sinatras - Only Tongue Can Tell (User: jbwharris)
Cat Power - Cross Bones Style (User: jbwharris)
Massive Attack - Teardrop (User: jbwharris)
dvsn - Use Somebody (User: jbwharris)
The Black Crowes - She Talks to Angels (User: jbwharris)
MANU GRACE - You’re in Rome (User: jbwharris)
Newton Faulkner - Teardrop (User: jbwharris)
Future Islands - I Knew You (User: jbwharris)
City and Colour - Rain (User: jbwharris)
Helena Deland - Someone New (User: jbwharris)
Clubhouse - Lucky Soul (User: jbwharris)
Mumford & Sons - Little Lion Man (User: jbwharris)
Hannah Georgas - That Emotion (User: jbwharris)
Mulherin - On Me (feat. Dijon) (User: jbwharris)
James Blunt - Goodbye My Lover (User: jbwharris)
Kurt Vile - Stranger Than Kindness (User: jbwharris)
