Morat - 23 (User: melons)
Tomas Bellucci, Rodri de Biedma - Running Up That Hill / Quevedo Session 52 (Medley) (User: melons)
Eliza Rose - B.O.T.A. (Baddest Of Them All) - Edit (User: melons)
Nicky Youre, Dazy - Sunroof (User: melons)
The Weeknd - Die for You (User: melons)
BLACKPINK - Shut Down (User: melons)
Harry Styles - Late Night Talking (User: melons)
Ckay - by now (User: melons)
Joeboy - CONTOUR (User: melons)
Zinoleesky - Jaiye Foreign (User: melons)
Rodríguez - Climb Up On My Music (User: melons)
Felt - Weepin' Mama Blues (User: melons)
LITTLE THIEF - Doctor (User: melons)
Nick Waterhouse - Stanyan Street (User: melons)
PJ Harvey - The Wind (User: melons)
Bror Gunnar Jansson - Body in a Bag (User: melons)
Charles Bradley - Ain't Gonna Give It Up (User: melons)
Junior Wells - Snatch It Back and Hold It (User: melons)
Diana Ross - Chain Reaction (User: melons)
Flamin' Groovies - Teenage Head (User: melons)
Tony Joe White - Hoochie Woman (User: melons)
Pops Staples - Somebody Was Watching (User: melons)
The Kills - Impossible Tracks (User: melons)
Dans Dans - Au Hasard (User: melons)
The Zombies - Time of the Season - Mono Version (User: melons)
Eric Burdon - Spirit (User: melons)
R.L. Burnside - Bad Luck City (User: melons)
Morphine - You Look Like Rain (User: melons)
Barrett Strong - Misery (User: melons)
The Weeknd - Die for You (User: melons)
Goldband - Noodgeval (User: melons)
Bad Bunny - Después de la Playa (User: melons)
Takaya Kawasaki - Magic carpet (User: melons)
Official HIGE DANdism - Pretender (User: melons)
Macaroni Empitsu - 恋人ごっこ (User: melons)
Capo Plaza - Capri Sun (User: melons)
thasup - s!r! (User: melons)
ROSALÍA - DESPECHÁ (User: melons)
Timber Timbre - Do I Have Power (User: melons)
NCT 127 - 질주 2 Baddies (User: melons)
Keisya Levronka - Tak Ingin Usai (User: melons)
Tom Odell - Another Love (Radio Edit) (User: melons)
Montez - Auf & Ab (User: melons)
Dr. John - Right Place Wrong Time (User: melons)
Pierre de Maere - Un jour je marierai un ange (User: melons)
WeRenoi - La League (User: melons)
Mora - TUS LÁGRIMAS (User: melons)
J Balvin - Azul (User: melons)
Feid - Feliz Cumpleaños Ferxxo (User: melons)
Alberto - Nuestro Regue (User: melons)
Bad Bunny - Tití Me Preguntó (User: melons)
Howlin' Wolf - Spoonful (User: melons)
Chris Brown - Under the Influence (User: melons)
The Cruel Sea - The Honeymoon Is Over (User: melons)
Post Malone - Circles (User: melons)
Paul Chambers - After Hours (User: melons)
Miles Davis - Milestones (User: melons)
Bud Powell - Bouncing with bud (User: melons)
Dua Lipa - IDGAF (User: melons)
Scott Walker - The Old Man's Back Again (Dedicated to the Neo-Stalinist Regime) (User: melons)
Maluma - Hawái (Amazon Original) (User: melons)
Becky G - MAMIII (User: melons)
Dua Lipa - Levitating (User: melons)
Harry Styles - As It Was (User: melons)
Beyoncé - COZY (User: melons)
Wu-Tang Clan - People Say (feat. Redman) (User: melons)
AZ - Mo Money Mo Murder (Homicide) (User: melons)
GZA/Genius - Knock, Knock (User: melons)
Kim Dracula - Unstoppable (from GRAN TURISMO 7) (User: melons)
C418 - Subwoofer Lullaby (User: melons)
Brian Tyler - Far Cry 3 (User: melons)
Bucks Fizz - Making Your Mind Up (User: melons)
Mocedades - Eres Tú (User: melons)
ZiBBZ - Stones (User: melons)
Madonna - Crazy for You (User: melons)
Chris Isaak - Wicked Game (User: melons)
Elton John - Goodbye Yellow Brick Road (User: melons)
Marvin Gaye - Sexual Healing (User: melons)
London Symphony Orchestra - Prelude a l'apres-midi d'un faune (User: melons)
Annelien Van Wauwe - Clarinet Concerto in A Major, K. 622 (Version for Basset Clarinet): II. Adagio (User: melons)
Pete Molinari - So Long Gone (User: melons)
1st Base Runner - Give Up the End (User: melons)
1st Base Runner - Give Up the End (User: melons)
Magic Sam - I Need You So Bad (User: melons)
The Coasters - Down In Mexico - Remastered (User: melons)
Hsin-ni Liu/Russian Philharmonic Orchestra/Dmitry Yablonsky - Piano Concerto in C-Sharp Minor, Op. 30 (User: melons)
Galocantô - Sempre Acesa (User: melons)
Grupo Revelação - Sina (User: melons)
João Martins - Lendas da Mata (User: melons)
Arzachel - Queen St. Gang (User: melons)
MC Leléto - Automaticamente (User: melons)
MC Davi - Bye Bye (User: melons)
Mc Pepeu & DJ Swat - Menina Se Prepara (User: melons)
RZO - Pirituba, Pt. 2 (User: melons)
Luiz Gonzaga - Forró nº 1 (User: melons)
Xand Avião - Decolou (Ao Vivo) (User: melons)
The Gentrys - Goddess of Love (User: melons)
Dolly Parton - Just as Good as Gone (User: melons)
UB40 - Food For Thought (User: melons)
Miles Davis - Perfect Way (User: melons)
Ol' Dirty Bastard - Shimmy Shimmy Ya (User: melons)
Mercury Rev - Chains (User: melons)
Waterparks - Turbulent (User: melons)
Pierce the Veil - King for a Day (User: melons)
Handsome Boy Modeling School - The Truth (User: melons)
Afrikan Boy - Lidl (User: melons)
NEU! - Hallogallo (User: melons)
System 7 - Interstate (User: melons)
Let Loose - Crazy for You (User: melons)
Wham! - Wake Me Up Before You Go-Go (User: melons)
Morgan - Miss Parker - The Dust Brothers Mix (User: melons)
Tyler Childers - Two Coats - Hallelujah Version (User: melons)
Rinôçérôse - Le Mobilier (User: melons)
Spearmint - Scottish Pop (User: melons)
16 Horsepower - Black Soul Choir (User: melons)
Fortran 5 - Heart On The Line (User: melons)
The Bob Leaper Orchestra - High Wire (Danger Man Theme) (User: melons)
Sinkane - U'Huh (User: melons)
Ween - Roses Are Free (User: melons)
David Guetta - Where Them Girls At (feat. Nicki Minaj & Flo Rida) (User: melons)
Magazine - The Light Pours Out Of Me (User: melons)
Mercury Rev - In A Funny Way (User: melons)
Jackson Sisters - I Believe In Miracles (User: melons)
Sweeping Promises - Pain Without a Touch (User: melons)
of Montreal - It's Easy to Sleep When You're Dead (User: melons)
The Beatles - Your Mother Should Know - Remastered 2009 (User: melons)
Tariverdiev - Dance at the Stadium (User: melons)
Bauhaus - She's in Parties (User: melons)
The Zombies - She's Not There (User: melons)
The Rolling Stones - She's A Rainbow (User: melons)
Pet Shop Boys - What Have I Done To Deserve This? (with Dusty Springfield) (User: melons)
Pet Shop Boys - Left To My Own Devices (User: melons)
Suede - The Wild Ones (Remastered) (User: melons)
Suede - She’s In Fashion (Remastered) (User: melons)
Queen - Killer Queen - Remastered 2011 (User: melons)
The Auteurs - Unsolved Child Murder (User: melons)
LCD Soundsystem - New York, I Love You But You're Bringing Me Down (User: melons)
The Icicle Works - Love Is a Wonderful Colour (User: melons)
Sneaks - True Killer (User: melons)
Bryan Ferry - It's My Party (User: melons)
The Human League - Open Your Heart - 2002 Mix (User: melons)
Chavez - Nailed To The Blank Spot - 2020 Remaster (User: melons)
The Afghan Whigs - I'll Make You See God (User: melons)
Buke & Gase - Medulla Oblongata (User: melons)
Sugar - If I Can't Change Your Mind (User: melons)
Sebadoh - Skull - Remastered (User: melons)
Heatmiser - Plainclothes Man (User: melons)
The Gun Club - Yellow Eyes (User: melons)
The Soft Pink Truth - We (User: melons)
The Bats - Treason (User: melons)
Portastatic - San Andreas (User: melons)
Air Miami - Airplane Rider (User: melons)
Frank Black - (I Want to Live on an) Abstract Plain (User: melons)
Velvet Crush - Hold Me Up (User: melons)
The Amps - Pacer (User: melons)
Mousey - The Bench (User: melons)
Father John Misty - I Went To the Store One Day (User: melons)
Purple Mountains - That’s Just the Way That I Feel (User: melons)
Dicaprio - Ectoslavia (User: melons)
Exene Cervenka - See How We Are (User: melons)
Purple Mountains - All My Happiness Is Gone (User: melons)
The Flying Burrito Brothers - Wild Horses (User: melons)
The Rolling Stones - Wild Horses (User: melons)
Silver Jews - Random Rules (User: melons)
Dean & Britta - Random Rules (User: melons)
First Aid Kit - Random Rules (User: melons)
Kevin Morby - Random Rules (User: melons)
Roosbeef - Baby, Ik Kom Eraan (User: melons)
Silver Jews - Honk If You're Lonely (User: melons)
Heatmiser - Get Lucky (User: melons)
Heatmiser - Low-Flying Jets (User: melons)
Heatmiser - Get Lucky (User: melons)
Heatmiser - Plainclothes Man (User: melons)
Songs: Ohia - Farewell Transmission (User: melons)
Scratch Acid - Cannibal (User: melons)
Songs: Ohia - Farewell Transmission (User: melons)
Here We Go Magic - Alone But Moving (User: melons)
Luna - Chinatown (User: melons)
The Vaselines - Jesus Wants Me For A Sunbeam (User: melons)
Silkworm - Nerves (User: melons)
Frank Black - I Burn Today (User: melons)
Frank Black - I Burn Today (User: melons)
The Chills - Pink Frost (User: melons)
3Ds - Outer Space (User: melons)
Unrest - Suki (User: melons)
Throwing Muses - Not Too Soon (User: melons)
Stephin Merritt - One April Day (User: melons)
The Olivia Tremor Control - Jumping Fences (User: melons)
The Verlaines - Death and the Maiden (User: melons)
Get Well Soon - Help To Prevent Forest Fires (User: melons)
Jonathan Bree - Roller Disco (User: melons)
Jonathan Bree - Say You Love Me Too (User: melons)
Quasi - I Never Want to See You Again (User: melons)
The Lemonheads - Different Drum (User: melons)
MILO CLARE - 20000 (User: melons)
Rino de Filippi - Insiemistica (User: melons)
Deuter - Phoenix (dancing, rhythmic, repetitive) (User: melons)
Ferkat Al Ard - Juma'a 6 Hziran (User: melons)
Har-You Percussion Group - Oua-Train (User: melons)
Attila Zoller Trio - You Stepped out of a Dream (User: melons)
Sabu Martinez - Nus (User: melons)
Quarteto Em Cy - Tudo Que Voce Podia Ser (User: melons)
Ayalew Mesfin - Libe Dil Temeta (My Heart Is Conquered) (User: melons)
Joakim Skogsberg - Offer-rota (User: melons)
Molly Lewis - Satin Curtains (User: melons)
Trish Toledo - Sin Control (User: melons)
Andrew Hill - Illusion - Alternate Take (User: melons)
Insólito Universo - Transmutada (User: melons)
Fresh Maggots - Rosemary Hill (User: melons)
Jade Warrior - Morning Hymn (User: melons)
Lalo Schifrin - Mission Blues (User: melons)
The Awakening - Mode for D.D. (User: melons)
Kenny Cox - Samba de Romance (User: melons)
Gilberto Sextet - Por Cada Minuto (User: melons)
Pucho & The Latin Soul Brothers - Got Myself a Good Man (User: melons)
Guelewar - Yaye Ramoutoulaye (User: melons)
Petalouda - What You Can Do In Your Life (User: melons)
Dia Prometido - The Sound of Silence (User: melons)
High Tide - Pushed, but Not Forgotten (User: melons)
Cortex - Chanson d'un jour d'hiver (User: melons)
Henri Texier - Varech (User: melons)
Barney Wilen - Bamako Koulikaro (User: melons)
Sound Providers - The Blessin (Featuring Blest) (User: melons)
Massinfluence - All Out (User: melons)
Missin' Linx - M.I.A. (User: melons)
Real Live - Real Live Sh*t (User: melons)
Cru - Nuthin' But (User: melons)
Group Home - Inna City Life (User: melons)
Mr. Voodoo - Lyrical Tactics (User: melons)
Michael Liggins & the Super Souls - Loaded to the Gills - Edit (User: melons)
Philip Cohran and the Artistic Heritage Ensemble - Ain't Nobody Gonna Treat Us Like They Used to Do - The Spencer Jackson Family (User: melons)
Herbie Hancock - Tell Me a Bedtime Story (User: melons)
Papo Felix And Ray Rodriguez - Bob And Bill In E Minor (User: melons)
Horace Silver - Baghdad Blues - Rudy Van Gelder Edition (User: melons)
East New York Ensemble de Music - Bent-El-Jerusalem (User: melons)
Cos - Oostend, Oostend (User: melons)
Stereolab - Come And Play In The Milky Night (User: melons)
Busta Rhymes - Show Me What You Got (User: melons)
Stark Reality - Blue Pillow (User: melons)
Red Box - Lean On Me (Ah-Li-Ayo) (User: melons)
Die Jury - Big In Japan (User: melons)
Benki - Kids (User: melons)
Andrew Lloyd Webber - The Phantom of the Opera (User: melons)
a-ha - Dark Is the Night (User: melons)
Lee "Scratch" Perry - Jungle Lion (User: melons)
Joe Smooth - Promised Land (club mix) (User: melons)
Donna - Uptown Top Ranking - Extended Edited Version (User: melons)
Betty Davis - He Was a Big Freak (User: melons)
Hugh Masekela - Night In Tunisia (User: melons)
King Tubby - Wood Roots (User: melons)
Funkadelic - Red Hot Mama (User: melons)
Bob Marley & The Wailers - Lively Up Yourself (User: melons)
Sweet Sensation - Sad Sweet Dreamer (User: melons)
The Love Unlimited Orchestra - Love's Theme (User: melons)
Chairmen Of The Board - Skin I'm In (User: melons)
Arlean Brown - I'm A Streaker Baby (User: melons)
Clara Nunes - Conto De Areia (User: melons)
Shirley Brown - Woman to Woman (User: melons)
Billy Preston - Nothing From Nothing (User: melons)
Pixies - Wild Honey Pie (User: melons)
The Beatles - Twist and Shout (User: melons)
The Flying Burrito Brothers - Wild Horses (User: melons)
Aretha Franklin - Satisfaction (User: melons)
The Magnetic Fields - Epitaph for My Heart (User: melons)
Yo La Tengo - Be Thankful For What You Got (User: melons)
Keith Hudson - Depth Charge (User: melons)
Marcus Belgrave - Space Odyssey (User: melons)
Sahara All Stars Band Jos - Enjoy Yourself (User: melons)
Commodores - Machine Gun (User: melons)
Rufus & Chaka Khan - Tell Me Something Good (User: melons)
Bobby "Blue" Bland - Ain't No Love In The Heart Of The City - Single Version (User: melons)
Mighty Sparrow - Sparrow Dead (User: melons)
Laura Lee - I Need It Just as Bad as You (User: melons)
Don Covay - It's Better To Have (And Don't Need) (User: melons)
Witch - Waile (User: melons)
Courting - Jumper (User: melons)
The TradeMark Experience - Around the World (User: melons)
I-Roy - Space Flight (User: melons)
Harold Budd - Steal Away - Remastered 2004 (User: melons)
Ronnie Dyson - I Don't Wanna Cry (User: melons)
The Masqueraders - One More Chance (User: melons)
Fred Hughes - Oo Wee Baby, I Love You (User: melons)
Barbara Mason - I Don't Want No Other Love (User: melons)
The Montclairs - Hung up on Your Love - Stereo (User: melons)
Kenny Gamble - Someday You'll Be My Love (User: melons)
The Main Ingredient - Happiness Is Just Around The Bend (User: melons)
The Meters - Hey Pocky A-Way (Remastered Version) (User: melons)
Cymande - Brothers On The Slide (User: melons)
Carl Douglas - Kung Fu Fighting (User: melons)
Lieve Hugo - Na foe sang èdè (User: melons)
O'Donel Levy - Bad Bad Simba (User: melons)
Brighter Side of Darkness - Because I Love You (User: melons)
Dry Bread - Yamar (User: melons)
Idris Muhammad - Loran's Dance (User: melons)
Bobby Womack - Lookin' for a Love (User: melons)
Ken Boothe - Everything I Own (Vibes Mix) (User: melons)
B.T. Express - Do It (Til You're Satisfied) (User: melons)
Patty & The Emblems - Gonna Love You A Long, Long Time (User: melons)
William Devaughn - Be Thankful for What You've Got (User: melons)
Swamp Dogg - When He Was No One (I Knew Jesus) (User: melons)
The Undisputed Truth - Help Yourself (User: melons)
Jorge Ben - Zumbi (User: melons)
Syreeta - Your Kiss Is Sweet (User: melons)
Bill Withers - The Same Love That Made Me Laugh (User: melons)
Shuggie Otis - Aht Uh Mi Hed (User: melons)
Johnny Bristol - Hang On In There Baby (User: melons)
The Commands - No Time For You (User: melons)
Labelle - Lady Marmalade (User: melons)
McCoy Tyner - Atlantis (User: melons)
Sugar Pie DeSanto - Git Back (User: melons)
Charley Pride - Mississippi Cotton Picking Delta Town (User: melons)
Andy Bey - Celestial Blues (User: melons)
Lyn Collins - Rock Me Again & Again & Again & Again & Again & Again (User: melons)
Minnie Riperton - Every Time He Comes Around (User: melons)
Bedotwater - Fire! (User: melons)
James Brown - Rock Me Again & Again & Again & Again & Again & Again (6 Times) (User: melons)
Al Green - Take Me To The River (User: melons)
The Knight Brothers - Temptation 'Bout To Get Me (User: melons)
George McCrae - Rock Your Baby (User: melons)
Junior Byles - Curly Locks (User: melons)
Cimarons - We Are Not the Same (User: melons)
Joy White - Dread Out Deh (User: melons)
Johnny Clarke - None Shall Escape the Judgement (User: melons)
Gregory Isaacs - Love Is Overdue (User: melons)
Shirley And Company - Shame Shame Shame (User: melons)
Barry White - You're the First, My Last, My Everything (User: melons)
Luiz Gonzaga - O Fole Roncou (User: melons)
Bessie Banks - Try to Leave Me If You Can (I Bet You Can't Do It) (User: melons)
Boscoe - Introduction (User: melons)
Billy Cobham - Stratus (User: melons)
Funkadelic - Cosmic Slop (User: melons)
Curtis Mayfield - Right on for the Darkness - 2019 Remaster (User: melons)
Barry White - I'm Gonna Love You Just A Little More Baby (User: melons)
Ace Spectrum - Don't Send Nobody Else (User: melons)
歐傑斯合唱團 - For the Love of Money (User: melons)
The Tennors - Weather Report (User: melons)
Rahsaan Roland Kirk - Celestial Bliss (User: melons)
Irma Thomas - She'll Never Be Your Wife (User: melons)
Betty Davis - If I'm In Luck I Might Get Picked Up (User: melons)
DJ Double R - Good Vibes (User: melons)
Quincy Jones - Summer in the City (User: melons)
The Staple Singers - If You're Ready (Come Go With Me) (User: melons)
Roberta Flack - Killing Me Softly With His Song (User: melons)
Margie Joseph - Punish Me (User: melons)
Sly & The Family Stone - If You Want Me To Stay (Album Version) (User: melons)
Sly & The Family Stone - If You Want Me To Stay (User: melons)
Willie Hutch - Theme Of The Mack (User: melons)
The Last Poets - Sport (User: melons)
Bobbi Humphrey - Harlem River Drive (User: melons)
The Soul Survivors - Explosion In Your Soul (User: melons)
Vic Simms - Stranger In My Country (User: melons)
MFSB - Love Is the Message (User: melons)
Dobie Gray - Drift Away (User: melons)
Al Green - Let's Get Married (User: melons)
Incredible Bongo Band - Apache (User: melons)
The Pointer Sisters - Jada (User: melons)
The Blossoms - Good, Good Lovin' (User: melons)
Executive Suite - when the fuel runs out (User: melons)
Donald Byrd - Where Are We Going? (User: melons)
Garland Jeffreys - Wild In The Streets (User: melons)
The Voices of East Harlem - Cashing In (User: melons)
Aaron Neville - Hercules (User: melons)
The Three Degrees - When Will I See You Again (User: melons)
Aretha Franklin - Angel (User: melons)
Stevie Wonder - Living for the City (User: melons)
Walter Jackson - It's an Uphill Climb to the Bottom (User: melons)
Ruby Andrews - Casanova (Your Playing Days Are Over) (User: melons)
Ghost - Devil Church (User: melons)
Tamiko Jones - Touch Me Baby (Reaching Out For Your Love) (User: melons)
Bunny Sigler - Love Train (User: melons)
The Radiants - (Don't It Make You) Feel Kinda Bad (User: melons)
The Fantastic Four - You Gave Me Something (And Everything's Alright) (User: melons)
Bessie Banks - Don't You Worry Baby The Best Is Yet To Come (User: melons)
Margie Joseph - I Can't Move No Mountains (User: melons)
The BPA - He's Frank (Slight Return) Radio Edit (User: melons)
Four Mints - Row My Boat (User: melons)
J.J. Barnes - Come on back (User: melons)
Jan Bradley - I'm Over You (User: melons)
The Commands - Hey It's Love (User: melons)
Gloria Scott - What Am I Gonna Do (User: melons)
J.J. Barnes - Chains Of Love (User: melons)
The Emotions - Somebody New (User: melons)
Sam Dees - Lonely for You Baby (User: melons)
Barbara George - Send for Me If You Need Some Lovin' - Bonus Track (User: melons)
The Modulations - I'm Hopelessly in Love (User: melons)
The Softones - Extra Ordinary People (User: melons)
Bobby Patterson - I'm In Love With You (User: melons)
Belma Haylee - Joint Probability Accredit Judged (User: melons)
Bill Frisell - Probability Cloud (User: melons)
Kristina Sacco - Event Probability (User: melons)
Jaan Manel - Evenhandedly Probability (User: melons)
Maude Latour - Probabilities (User: melons)
Joakim Berg - Barn av vår tid (User: melons)
Tim Maia - O Caminho Do Bem (User: melons)
Sébastien Tellier - Divine (User: melons)
The Nolans - I'm in the Mood for Dancing (User: melons)
Marc Bolan - I Love To Boogie (User: melons)
Marc Bolan - I Love To Boogie (User: melons)
Erasure - Love to Hate You (User: melons)
Tina Charles - I Love to Love (User: melons)
Michel Vedette - C'est possible (User: melons)
Alice Dona - C'est Pas Prudent (User: melons)
Ophiucus - C'est pour toi (User: melons)
Parcels - Tieduprightnow (User: melons)
Barbara Mason - Yes I'm Ready (User: melons)
La Féline - Où est passée ton âme ? (User: melons)
Paul McCartney - Où Est Le Soleil? - Remastered 2017 (User: melons)
All Them Witches - Open Passageways (User: melons)
Okay Kaya - Mother Nature's Bitch (User: melons)
Depeche Mode - Enjoy the Silence (User: melons)
The Fiery Furnaces - Tropical Ice-Land (User: melons)
Animal Collective - FloriDada (User: melons)
Ou Est Le Swimming Pool - Jackson's Last Stand - Radio Edit (User: melons)
John Grant - Black Belt (User: melons)
Rarity - Hollow (User: melons)
Willie Nelson - I Couldn't Believe It Was True (User: melons)
Marty Robbins - I Couldn't Keep from Crying (User: melons)
Nick Byrne - I Couldn't See the Devil Behind Me (User: melons)
Kacy Hill - I Couldn't Wait (User: melons)
The Smiths - I Started Something I Couldn't Finish - 2011 Remaster (User: melons)
The Invincibles - I Couldn't Stand It (User: melons)
Matching Mole - O'Caroline (User: melons)
Nick Drake - One of These Things First (User: melons)
John Martyn - May You Never (User: melons)
Deee-Lite - Groove Is in the Heart (User: melons)
The Fugs - I Couldn't Get High (User: melons)
Petula Clark - I Couldn't Live Without Your Love (User: melons)
Hayden Lloyd - Stolen Kisses (User: melons)
Charles Trenet - Que reste-t-il de nos amours ? (User: melons)
Dexys Midnight Runners - I Couldn't Help It If I Tried (User: melons)
Sputnik Weazel - Chicken In A Basket (User: melons)
Lee Hazlewood - Pray Them Bars Away (User: melons)
Werkha - Battered Mars Bar (User: melons)
Cólera - Deixe A Terra Em Paz (User: melons)
Olho Seco - Isto é olho seco (User: melons)
Inocentes - Pânico em S.P. (User: melons)
Taqbir - Sma3 (User: melons)
Betweenatna - Lay chafi (User: melons)
SS-20 - Capital Class (User: melons)
Massacre 68 - Crimen Capitalista (User: melons)
Atoxxxico - Punks De Mierda (User: melons)
Slant - Enemy (User: melons)
13 Steps - The Survivor (User: melons)
The Geeks - Do You, Too? (User: melons)
The Geeks - What We Believe (User: melons)
Bastard - Misery (User: melons)
G.I.S.M. - Endless Blockades for the Pussyfooter (User: melons)
G.I.S - Megarider (User: melons)
The Stalin - ロマンチスト (User: melons)
HANG YOUTH - BELASTINGDIENST (User: melons)
Bakfietsboys - Alle Bazen Zijn Hufters (User: melons)
Human Alert - I Hate People (User: melons)
B.G.K. - Holiday in Lebanon (User: melons)
Homomilitia - Policja (User: melons)
Siekiera - Nowa Aleksandria (User: melons)
Armia - Niezwyciężony (User: melons)
Dezerter - Tchórze (User: melons)
Frammenti - ricordi (User: melons)
Raw Power - State Oppression (User: melons)
Nerorgasmo - Giorno (User: melons)
Raw Power - State Oppression (User: melons)
Shocking Blue - Love Buzz (User: melons)
R.E.M. - Carnival Of Sorts (Boxcars) (User: melons)
Manic Street Preachers - Love's Sweet Exile - Remastered (User: melons)
Negazione - No Mi Dire (User: melons)
Nip Drivers - Nip Driver (User: melons)
Otoboke Beaver - Chu Chu Song (User: melons)
ミドリ - ゆきこさん (User: melons)
Béla Bartók - Romanian Folk Dances, Sz 56: I. Dance With Sticks - Allegro moderato (User: melons)
Ratos De Porão - Beber Até Morrer (User: melons)
Gouge Away - Ghost (User: melons)
Burnt Sugar - Only a Fool (Would Say Love Starts with a Kiss) (User: melons)
Youth of Today - Break Down the Walls (User: melons)
Madball - Set It Off (User: melons)
Soul Glo - Gold Chain Punk (whogonbeatmyass?) (User: melons)
Sick of It All - Step Down (User: melons)
Agnostic Front - Gotta Go (User: melons)
Gorilla Biscuits - Start Today (User: melons)
Cro-Mags - Hard Times (User: melons)
Fugazi - Waiting Room (User: melons)
NoMeansNo - It's Catching Up (User: melons)
D.R.I. - Thrashard (User: melons)
Adolescents - Amoeba (User: melons)
The Middle Class - Out of Vogue (User: melons)
Dave Holland - Conference of the Birds (User: melons)
François de Roubaix - Amour Sur Les Rails (User: melons)
Galt Macdermot - Come Away Death (User: melons)
Lightning Seeds - Emily Smiles (User: melons)
Dusty Springfield - Son of a Preacher Man (User: melons)
Whitney Houston - One Moment in Time (User: melons)
Shirley Bassey - Big Spender (User: melons)
Elton John - Circle of Life (User: melons)
Duran Duran - A View to a Kill (User: melons)
Los Del Rio - Macarena (Bayside Boys Remix) (User: melons)
Sam Bailey - Skyscraper (User: melons)
Racing Cars - They Shoot Horses Don't They (User: melons)
Wu-Tang Clan - C.R.E.A.M. (Cash Rules Everything Around Me) (Radio Edit) (User: melons)
EMF - Unbelievable (User: melons)
James & Bobby Purify - Let Love Come Between Us (User: melons)
The United States of America - Where Is Yesterday (User: melons)
Nolan Chance - Just Like The Weather (User: melons)
Slick Walk - Bird's Lament (User: melons)
Bis - Statement Of Intent (User: melons)
The Vibrations - 'Cause You're Mine (User: melons)
Barbara Stant - My Mind Holds On To Yesterday (User: melons)
Eloise Laws - Love Factory (User: melons)
Freda Payne - Band Of Gold (Single Mix) (User: melons)
Lorraine Chandler - I Can't Hold On (User: melons)
Bobby Hebb - Love, Love, Love (User: melons)
Yvonne Baker - You Didn't Say A Word (User: melons)
Darrell Banks - Open the Door to Your Heart (User: melons)
Rose Batiste - Hit and Run (User: melons)
Edwin Starr - Twenty Five Miles (User: melons)
Freddie Chavez - They'll Never Know Why (User: melons)
Al Wilson - The Snake (User: melons)
Timi Yuro - It'll Never Be Over for Me (User: melons)
R. Dean Taylor - There's A Ghost In My House (User: melons)
The Jades - I'm Where It's At (User: melons)
The Sapphires - Who Do You Love (User: melons)
The Isley Brothers - This Old Heart Of Mine (Is Weak For You) (User: melons)
Chairmen Of The Board - Give Me Just A Little More Time (User: melons)
Edwin Starr - Time (User: melons)
Roscoe Robinson - That's Enough (User: melons)
Showstoppers - Ain't Nothin But A Houseparty (User: melons)
Marvin Gaye - This Love Starved Heart Of Mine (It's Killing Me) - 1994 Love Starved Heart Version (Mono) (User: melons)
Larry Williams & Johnny Watson - Too Late (User: melons)
Marlena Shaw - Let's Wade In The Water (User: melons)
The M.V.P.'s - Turnin' My Heartbeat Up (User: melons)
Ella Fitzgerald - Get Ready (User: melons)
Jackie Wilson - The Who Who Song (Nobody But My Sweet Baby) (User: melons)
Dana Valery - You Don't Know Where Your Interest Lies - Single Version (User: melons)
Chuck Wood - Seven Days Too Long - Mono (User: melons)
Booker T. & The M.G.'s - Green Onions (User: melons)
Martha Reeves & The Vandellas - Nowhere to Run (User: melons)
Don Thomas - Come On Train - Original Mix (User: melons)
Terry Callier - Ordinary Joe (User: melons)
Shirley Ellis - Soul Time - Single Version (User: melons)
Just Brothers - Sliced Tomatoes (User: melons)
Joy Lovejoy - In Orbit (User: melons)
Lou Pride - I'm Com'un Home in the Morn'un (User: melons)
Sandi Sheldon - You're Gonna Make Me Love You (User: melons)
Gloria Jones - Tainted Love (User: melons)
Rita & The Tiaras - Gone With The Wind Is My Love (User: melons)
Frankie Valli & the Four Seasons - The Night - 1972 Version (User: melons)
Luther Ingram - If It's All the Same to You Babe (User: melons)
Nolan Porter - Keep On Keepin' On (User: melons)
The Flirtations - Nothing But A Heartache (User: melons)
The Supremes - Stop! In The Name Of Love - Single Version (User: melons)
Four Tops - Reach Out I'll Be There - Single Version / Mono (User: melons)
DeBarge - Rhythm of the Night (User: melons)
Lionel Richie - Hello (User: melons)
Marvin Gaye - I Heard It Through the Grapevine (User: melons)
The Prodigy - Ruff in the Jungle Bizness (User: melons)
Curve - Fait Accompli (User: melons)
Prince - Raspberry Beret (User: melons)
Subcircus - 86'd (User: melons)
Praga Khan Injected with a poison - Praga Khan Injected with a poison. (User: melons)
Jimmy Robins - I Can't Please You (User: melons)
Bobby Byrd - Ain't No Use (User: melons)
Simon Warner - Wake Up the Street (User: melons)
Scarfo - Eyesore (User: melons)
John Roberts - It's All Over (User: melons)
Buddy Ace - Hold On (To This Old Fool) (User: melons)
Tommy Ridgley - No One But Me (User: melons)
John Standberry - Help Me Now (User: melons)
Dolly & The Fashions - Absence Made My Heart Grow Fonder (User: melons)
The Cinnamons - I'm Not Gonna Worry (User: melons)
Royalston - Somethin' Ain't Right (User: melons)
Tootie & The Bouquets - The Conqueror (User: melons)
Ricky Allen - Nothing In The World Can Hurt Me (Except You) (User: melons)
Marlee Gray - Dopamine Rush - Abridged (User: melons)
The Fashions - I Just Got A Letter (User: melons)
Jay Lewis - Oh (User: melons)
The Ramsey Sisters - It's All Over Now But The Crying (User: melons)
Bettye Smith - My Love Is Gone (User: melons)
Jean Mays - He Make's Me Feel So Crazy (User: melons)
Betty Turner - Little Miss Misery (User: melons)
The Sonnets - I've Gotten Over You (User: melons)
Dolly & The Fashions - Waiting For My Man (User: melons)
Angelos - Lonely Hours (User: melons)
Laura Johnson - I Know How It Feels (User: melons)
The Versatiles - Bye Bye Baby (User: melons)
Billy Conn - I Promise You (I Won't Mention Your Name) (User: melons)
Cosha - Hot Tub (User: melons)
BONZAI - KBG (User: melons)
Fulgeance - LowDown (User: melons)
Elliphant - All Or Nothing (feat. Diplo & Bunji Garlin) (User: melons)
Vampire Boyfriend - Vampire Boyfriend - Demo (User: melons)
Dels - Petals Have Fallen (User: melons)
Slade - How Does It Feel (User: melons)
Dire Straits - Sultans of Swing (User: melons)
The very best of smooth Jazz - My one temptation (User: melons)
Mica Paris - My One Temptation (User: melons)
Brenton Wood - Gimme Little Sign (User: melons)
The KLF - 3 A.M. Eternal (Radio Freedom edit) (User: melons)
The Dust Brothers - Song To The Siren (Original Dust Brothers Mix) (User: melons)
Dan Fogelberg - Longer (User: melons)
The Drifters - Up On The Roof (User: melons)
The Lemonheads - Confetti - Remastered (User: melons)
The Lemonheads - Paint (User: melons)
Fuzzbox - Rules and Regulations (7" mix) (User: melons)
Prima Queen - Eclipse (User: melons)
Orbital - Chime (User: melons)
Richie Wallace - Darling, You've Done Me Wrong (User: melons)
Denny Denson - Too Long (User: melons)
The Premiers - I'm Better Off Now (Than I Was Before) (User: melons)
Jay & The Shufflers - Always Be Mine (User: melons)
Robert & Johnny - A Perfect Wife (User: melons)
The Whatnots - Instigating (User: melons)
Denise LaSalle - A Promise Is A Promise (User: melons)
Honey and the Bees - Love Can Turn to Hate (User: melons)
The Sierras - I SHould Have Loved You (User: melons)
Margie Alexander - Love Slave (User: melons)
Roy C - Stop What You're Doin' (User: melons)
Chuck Armstrong - She Had A Right (User: melons)
Jackie Day - I Can't Wait (User: melons)
Baby Jane & The Rockabyes - Hickory Dickory Dock (User: melons)
Linda Lyndell - I Don't Know (User: melons)
Ricky Allen - It's A Mess I Tell You (User: melons)
The Satisfactions - Give Me Your Love (User: melons)
Ray Pettis - Hello There, Pretty Baby (User: melons)
The Robins - White Cliffs Of Dover (User: melons)
Sherlock Holmes - What An Argument (User: melons)
The Four Sportsmen - If Your Heart Can Take It (User: melons)
Zip & The Zippers - Where Are You Goin' Little Boy (User: melons)
The Camelots - Pocahontas (User: melons)
Johnny McKinnley - If You Leave Me (User: melons)
Johnny McKinnley - If You Leave Me (User: melons)
The Presidents - Pots & Pans (User: melons)
Sir Joe & the Maidens - Jivin' Jean (User: melons)
The Lemonheads - Black Gown (User: melons)
The Lemonheads - The Outdoor Type (User: melons)
The Lemonheads - If I Could Talk I'd Tell You (User: melons)
The Lemonheads - I'll Do It Anyway (User: melons)
The Lemonheads - Being Around (User: melons)
The Lemonheads - Into Your Arms (User: melons)
The Lemonheads - Mallo Cup (User: melons)
The Lemonheads - Luka (User: melons)
The Olivia Tremor Control - Jumping Fences (User: melons)
The Lemonheads - Shaky Ground (User: melons)
The Lemonheads - Mrs. Robinson - Remastered (User: melons)
The Lemonheads - Frank Mills - Remastered (User: melons)
The Lemonheads - Ceiling Fan In My Spoon - Remastered (User: melons)
The Lemonheads - Kitchen - Remastered (User: melons)
The Lemonheads - Different Drum (User: melons)
The Lemonheads - Alison's Starting To Happen - Remastered (User: melons)
The Lemonheads - Bit Part - Remastered (User: melons)
The Lemonheads - The Turnpike Down - Remastered (User: melons)
The Lemonheads - My Drug Buddy - Remastered (User: melons)
The Lemonheads - Rudderless - Remastered (User: melons)
The Lemonheads - It's A Shame About Ray - Remastered (User: melons)
The Lemonheads - Confetti - Remastered (User: melons)
The Lemonheads - Rockin Stroll - Remastered (User: melons)
The Royalettes - Willie The Wolf (User: melons)
The Tear Garden - In Search of My Rose (User: melons)
Albert Williams - I'm In Your Corner (User: melons)
The Barons - Don't Go Away (Pretty Little Girl) (User: melons)
Gerald Sims - Mother Nature (User: melons)
The Du Tones - Done Got over It (User: melons)
Ruben Wright - I'm Walking Out On You (User: melons)
Monie Love - It's a Shame (My Sister) (User: melons)
The Vells - In-Laws (User: melons)
U.S. Girls - So Typically Now (User: melons)
Harvey Scales - Sun Won't Come Out (User: melons)
Sam Redmore - Nagu - Extended Mix (User: melons)
The Varnells - Day In Court (User: melons)
John Roberts - I'll Forget You (User: melons)
The Four Jokers - Uggaboo (User: melons)
Jackie Moore - Here I Am (User: melons)
Davey Summers - Calling All Cars (User: melons)
The Blisters - Shortnin' Bread (User: melons)
Darryl Carter - Begging You to Stay (User: melons)
The Chips - Party People (User: melons)
Dallas Frazier - Can't Go On (User: melons)
The Collegians - I Can't Get You out of My Mind (User: melons)
Teddy Phillips - My Foolish Ways (User: melons)
The Honeydews - Honey Dew (User: melons)
Snooks Eaglin - If I Could (User: melons)
Jerry Peyton - I Don't Care (User: melons)
The Blue Chips - Promise (User: melons)
Donna Loren - On The Good Ship Lollipop (User: melons)
The Trinkets - Fisherman (User: melons)
Patty McCoy & The Sensations - Double Trouble (User: melons)
The Pyramids - Cryin' (User: melons)
Loretta King - The Good Love, The Bad Love (User: melons)
Demonstrators - Sweet Violets (User: melons)
Trade Martin - Hula Hula Dancin' Doll (User: melons)
The Willows - It's Such A Shame (User: melons)
Sylvia Shemwell - Funny What Love Can Do (User: melons)
The Unforgettables - Oh, There He Goes (User: melons)
Carl Butler - Wonder Drug (User: melons)
Concords - Our Love Wasn't Meant To Be (User: melons)
Berna Dean - He's Mine (User: melons)
The El Capris - Ivy League Clean (User: melons)
combo kings - Mish-Mash (User: melons)
Little Alice - So What If I Can't Cook (User: melons)
The WestEnders - No Tears Left for Crying (User: melons)
Lonnie Russ - Tell Me How (User: melons)
The Chuck-A-Lucks - I'm Hospitalized (User: melons)
Elroy Peace - Yeah Baby (User: melons)
Dorothy Berry - I'm with You All the Way (User: melons)
Wilmar Walker - Stompin' Roaches (User: melons)
The Gainors - The Secret (User: melons)
Julian Glad - Landlord (User: melons)
Stan Robinson - N-U-T-H-I-N-G (User: melons)
The Sultans - You Got Me Goin' (User: melons)
Dee Dee Sharp - What Am I Gonna Do (User: melons)
S'Express - Hey Music Lover (User: melons)
Joyce Manor - Did You Ever Know? (User: melons)
The Chantels - Look in My Eyes (User: melons)
The Roebucks - Sable (User: melons)
Stone - Les Framboises (User: melons)
Annie Philippe - Baby Love (User: melons)
Patricia - Mes Rêves de Satin (User: melons)
Adele - J'Ai Peur Parfois (User: melons)
Cosette - Idéalisation (User: melons)
Christine Pilzer - Dracula (User: melons)
Elizabeth - Je Suis Sublime (User: melons)
Stone - Fille Ou Garçon (User: melons)
Jocelyne - Nitty Gritty (User: melons)
Michèle Arnaud - Les papillons noirs (User: melons)
Violaine - J'ai des Problèmes Décidément (User: melons)
Eileen - Ces Bottes Sont Faites Pour Marcher (User: melons)
Jacqueline Taieb - 7 heures du matin (From "Les Barbouzes se rebiffent") (User: melons)
Marie Laforêt - Marie Douceur, Marie Colère (User: melons)
7 Minutes in Heaven - Better Off (User: melons)
Cagney and Lacee - By The Way (I Still Love You) (User: melons)
Tindersticks - Marbles (User: melons)
Glue - You'll See (User: melons)
FORD - Lambaste (User: melons)
Vegetarian Meat - Hey (Electric Version) (User: melons)
Pork - Don't Cry No Tears (User: melons)
Dean Wareham - Anesthesia (User: melons)
King Carcass - Unbound Coil (User: melons)
The Bewitched - 409 (User: melons)
Dwarves - I'm In A Head (User: melons)
Ornament - Tonight (User: melons)
Simon Joyner - Bring Down Goliath (User: melons)
Franklin Bruno - Then Again, Maybe I Won't (User: melons)
Jenny Mae - Dairy Boy (User: melons)
People Under the Stairs - San Francisco Knights (User: melons)
Ron House - 5:00 (User: melons)
Jerry Wick - Love, Death + Photsynthesis (User: melons)
Smelt Daddy - How Low Can You Go (User: melons)
Simon Joyner - Hot Tears (User: melons)
Scotty Tabachnik - Stones and Noah's Bones (User: melons)
Paul Nini - Astronauts (User: melons)
Karl Hendricks - The Dress You Bought in Cleveland (User: melons)
Gilmore Tamny - Pit Bull (User: melons)
Mike Rep - Bulemia Blues (User: melons)
Don Howland - Rubber Boots (User: melons)
Chris Biester - Coolville (User: melons)
Waybald - Song (User: melons)
Earnest - Straight To Neil (User: melons)
Franklin Bruno - Shooting Past Me (User: melons)
Dan Spurgeon - Telling Secrets Forming Unions (User: melons)
Robert Griffin - Dream King (User: melons)
Dump - It's Not Awright (User: melons)
Lizard McGee - Cinema East (User: melons)
Jake Housh - Testament (User: melons)
Ted Hattemer - Background (User: melons)
Bill Fox - Eclectrocution (User: melons)
Deline Briscoe - Ngadijina (User: melons)
Jessie Lloyd - Like a Wave (User: melons)
Mission Songs Project - Hopkins River (User: melons)
Kankawa Nagarra - Yanany Parlipa (User: melons)
Casey Donovan - Proud (User: melons)
Ruby Hunter - I Am A Woman (User: melons)
Stiff Gins - Diamonds On the Water (User: melons)
Kate Bush - Moments of Pleasure (User: melons)
Darts - The Boy From New York City (User: melons)
The Manhattan Transfer - Chanson d'amour (User: melons)
The Strokes - When It Started (User: melons)
Australian Art Orchestra - Took the Children Away (User: melons)
Del Amitri - Always The Last To Know (User: melons)
Dave Edmunds - Queen Of Hearts (User: melons)
Ned Miller - From A Jack To A King (User: melons)
Phil Collins - Two Hearts (User: melons)
Wilma Reading - I Feel The Earth Move (User: melons)
Christine Anu - Sunshine on a Rainy Day (User: melons)
Shakaya - Sublime (User: melons)
Stiff Gins - Yandool (User: melons)
Barkaa - Blak Matriarchy (User: melons)
Deline Briscoe - Changing (User: melons)
Auriel Andrew - Number One Fool (User: melons)
Alice Skye - Grand Ideas (User: melons)
Georgia Lee - Yarra River Blues (User: melons)
Marlene Cummins - Koori Woman (User: melons)
Emily Wurramara - Lady Blue (User: melons)
Bumpy - Falling (User: melons)
Thelma Plum - Better In Blak (User: melons)
Kee'Ahn - Better Things (User: melons)
Pharoah Sanders - Colors (User: melons)
Pharoah Sanders - Love Is Everywhere (User: melons)
Wilma Reading - Play It Again - Single Version (User: melons)
Skull Snaps - It's A New Day (User: melons)
Osibisa - Fire (User: melons)
Marsha Hunt - Oh No! Not The Beast Day (User: melons)
Dionne Warwick - You're Gonna Need Me (User: melons)
Screamin' Jay Hawkins - Monkberry Moon Delight (User: melons)
Letta Mbulu - Kube (User: melons)
D.J. Rogers - Watch Out For The Riders (User: melons)
Bruse Wane - Love Taps (User: melons)
R Medley - Love Set Backs (User: melons)
James Brown - The Payback (User: melons)
Spinners - Mighty Love (Remastered) (User: melons)
Diana Ross - Touch Me In The Morning (User: melons)
The Isley Brothers - That Lady, Pts. 1& 2 (User: melons)
The Upsetters - Kaya Skank (User: melons)
Sun Ra - Rocket Number Nine (User: melons)
R.E.M. - King of Comedy (User: melons)
The Cure - It's Not You (User: melons)
Gorky's Zygotic Mynci - Wrong Turnings (User: melons)
The Beatles - She Came In Through The Bathroom Window (Take 27) (User: melons)
Ed Schrader's Music Beat - No Fascination (User: melons)
Soulwax - Proverbial Pants (User: melons)
Sonic Youth - Superstar (User: melons)
Kool & The Gang - Jungle Boogie (User: melons)
Bill Withers - I Can't Write Left-Handed (Live at Carnegie Hall, New York, NY - October 1972) (User: melons)
Toots & The Maytals - Funky Kingston (User: melons)
Harold Melvin & The Blue Notes - The Love I Lost (Album Version) (User: melons)
Herbie Hancock - Chameleon (User: melons)
Ofo The Black Company - Egwu Aja (User: melons)
E L U C I D - Honestly, Aight (User: melons)
Millie Jackson - Love Doctor (User: melons)
Luiz Melodia - Pérola Negra (User: melons)
Trio Ternura - A gira (User: melons)
Isaac Hayes - Joy (User: melons)
Herbie Hancock - Chameleon (User: melons)
Project Gemini - The Deserted Compound (Interlude) (User: melons)
Baba Stiltz - Showtime (User: melons)
Angelique Kidjo - Seen and Not Seen (User: melons)
Monobo Son - MPU (User: melons)
Caroline - desperately (User: melons)
Country Teasers - Thank You God for Making Me an Angel (User: melons)
Country Teasers - Golden Apples (User: melons)
The Yummy Fur - Plastic Cowboy (User: melons)
Fur - If You Know That I'm Lonely (User: melons)
Karen Black - I Wish I Knew The Man I Thought You Were (User: melons)
Jack Name - Watching the Willows Burn (User: melons)
John Maus - No Title (Molly) (2008) (User: melons)
John Lurie - Al Al Al Al (User: melons)
John Fahey - Sunflower River Blues (User: melons)
Scotty - Clean Race (User: melons)
The Avalanches - Since I Left You - Stereolab Remix (User: melons)
Alan Leach - Clouds Behind The Moon (User: melons)
Josephine Foster - Child of God (User: melons)
Peter Matthew Bauer - Philadelphia Raga (User: melons)
Shirley Collins - Space Girl - Bonus Track (User: melons)
Stevie Wonder - Love Having You Around (User: melons)
Fur Patrol - Beautiful (User: melons)
The Screaming Meemees - Till I Die - Remastered and Extended (User: melons)
The Front Lawn - Tomorrow Night (User: melons)
Dave McArtney and The Pink Flamingos - Virginia (User: melons)
Darcy Clay - Jesus I Was Evil (User: melons)
The Mutton Birds - Anchor Me (User: melons)
DD Smash - Whaling (User: melons)
Fur Patrol - Lydia (User: melons)
Headless Chickens - Cruise Control - 1994 (User: melons)
Citizen Band - I Feel Good (User: melons)
Greg Johnson - Isabelle (User: melons)
Citizen Band - I Feel Good (User: melons)
Hello Sailor - Gutter Black (User: melons)
Netherworld Dancing Toys - For Today (User: melons)
The Ruby Suns - Oh, Mojave (User: melons)
Pasha - Baffling (User: melons)
Lee "Scratch" Perry - Baffling Smoke Signal (User: melons)
John Watterson - The Pretty Goat (User: melons)
Cheryl Baker - Damn It, Janet (from "The Rocky Horror Show") (User: melons)
Blam Blam Blam - Don't Fight It Marsha, It's Bigger Than Both of Us (User: melons)
Blam Blam Blam - There Is No Depression in New Zealand (User: melons)
Sunny & The Sunglows - Talk to Me (User: melons)
Alex Lahey - Misery Guts (User: melons)
Daniel Vangarde - Montelimar (User: melons)
Georges Brassens - La mauvaise réputation (User: melons)
Tash Sultana - Can't Buy Happiness (User: melons)
The Sleep Phasers - Until The City Hums Specially For Your Regeneration (User: melons)
The Sleep Phasers - Until The City Hums Specially For Your Regeneration (User: melons)
Wyldest - You Could Be Happy (User: melons)
Night Flight - David (User: melons)
Yoste - How It Was (User: melons)
Thelonious Monk Quartet - Evidence - Live At Carnegie Hall, New York/1957 (User: melons)
Night Flight - David (User: melons)
Thelonious Monk Quartet - Evidence - Live At Carnegie Hall, New York/1957 (User: melons)
Tate McRae - chaotic (User: melons)
One Way - Cutie Pie (User: melons)
Jolé - Tie Dye Sky (User: melons)
Michael Baker - Lightly Looms - 7" Version (User: melons)
Lizzy McAlpine - Give Me A Minute (User: melons)
Mahalia - Letter To Ur Ex (User: melons)
Maren Morris - Background Music (User: melons)
Fats Domino - Blueberry Hill - Non Stop Edit (User: melons)
Tamzene - Called You Out (User: melons)
Jackie McLean - A Ballad for Doll (User: melons)
Wolfgang Muthspiel - Hüttengriffe (User: melons)
Zachary Knowles - slow summer (User: melons)
PJ Morton - How Deep Is Your Love (User: melons)
Cooza - Beige (User: melons)
PJ Morton - How Deep Is Your Love (User: melons)
A House In The Trees - To Adore (User: melons)
Sarya - i don't know where i'm going but that's okay (User: melons)
MAX - GUCCI BAG (User: melons)
des hume - Wild World (User: melons)
Mable John - Running Out (User: melons)
Conor Matthews - Older (User: melons)
Aretha Franklin - (You Make Me Feel Like) a Natural Woman (User: melons)
Deptford Goth - Never Hurt (User: melons)
The J.B.'s - Pass The Peas (User: melons)
Willie Bobo - Fried Neck Bones and Some Home Fries (User: melons)
The Beatles - Savoy Truffle - Remastered 2009 (User: melons)
The Beatles - Glass Onion - Remastered 2009 (User: melons)
Gang Green - Alcohol (User: melons)
Green Tangerines - Funk Detective (User: melons)
Jake Thackray - Lah-Di-Dah (User: melons)
Georges Brassens - Montélimar (User: melons)
Michel Petrucciani - Montelimar - 1994 - Remaster (User: melons)
Besombes - Montélimar (User: melons)
U.S. Girls - 4 American Dollars (User: melons)
The Byrds - Tribal Gathering (User: melons)
No-No Boy - Imperial Twist (User: melons)
Howling Bells - Setting Sun (User: melons)
Bobby McFerrin - The Pink Panther - Theme (User: melons)
Compulsion - Ariadne (User: melons)
Seam - Rafael (User: melons)
Robert Pollard - Pop Zeus (2019 Remaster) (User: melons)
Black Tambourine - For Ex-Lovers Only (User: melons)
Airport 5 - Stifled Man Casino (User: melons)
Tobin Sprout - All Used Up (User: melons)
The Spinanes - Kid in Candy (User: melons)
Silkworm - Nerves (User: melons)
Air Miami - Airplane Rider (User: melons)
Unrest - Suki (User: melons)
ABBA - When All Is Said and Done (User: melons)
Counting Crows - Mr. Jones (User: melons)
Kool & the Gang - Jones vs. Jones (User: melons)
Howard Jones - No One Is to Blame (User: melons)
Sonique - Alive (User: melons)
Paul Anka - Lonely Boy (User: melons)
Pussycat - Mississippi (User: melons)
Daniel Bedingfield - Gotta Get Thru This (Radio Edit) (User: melons)
The Five Stairsteps - O-o-h Child (User: melons)
Suede - Filmstar (User: melons)
St. Vincent - Bad Believer (User: melons)
Yo La Tengo - Autumn Sweater (User: melons)
azel phara - Good Coffee / the Shed Discovery / Fun and Games (User: melons)
UGK - Return (User: melons)
i saw them die - 978 (User: melons)
Da Beatfreakz - Swingin In Da Whip (User: melons)
Drop To Zero - Battle Hymn (User: melons)
Ten Past Seven - Horo (User: melons)
Tram 11 - '981 (User: melons)
Animal X - De Sase Ani (User: melons)
Octo Octa - RepPing (User: melons)
Conchita Wurst - The Sound of Music (User: melons)
Gemma - MIRO (Feat. Swervy) (User: melons)
BBR - Besame Mucho - Short Mix (User: melons)
Lil Crousby - Mj (User: melons)
Cex - My Head (User: melons)
Timmy Trumpet - Turn The Lights Down Low (with R3HAB & NINEONE#) [Chinese Version] (User: melons)
Oldeaf - Bataklık (User: melons)
Johnny Zero - A Rose by Any Other Name (User: melons)
The Auteurs - Lenny Valentino (User: melons)
2 Eivissa - Kalenbo (User: melons)
Betty Everett - It's In The Kiss (The Shoop Shoop Song) (User: melons)
Timo Krantz - 285 (User: melons)
Sarah Nathalié - Trust (User: melons)
Isla Vista Worship - Thank You (User: melons)
The For Carnation - On The Swing (User: melons)
Harmonia - When Shade Was Born (User: melons)
Mohd Rafi - Tu Is Tarah Se Mere Zindagi Main (User: melons)
The Supremes - Floy Joy (User: melons)
Ralph Sutton - Dinah (User: melons)
Razihel - Skybreaker (User: melons)
Ricky Remedy - Sluggin' (User: melons)
Antiserum - Let's Go (User: melons)
Aero Chord - Boundless (User: melons)
Mefjus - Sientelo (User: melons)
Zeds Dead - Gassed Up (User: melons)
Frankie Valli & the Four Seasons - The Night (User: melons)
Kenny Rogers - Just Dropped In (User: melons)
The Bangles - Going Down To Liverpool (User: melons)
Rotary Connection - I Am The Black Gold Of The Sun - Remastered (User: melons)
Gil Scott-Heron - Lady Day and John Coltrane (User: melons)
Funkadelic - Can You Get to That (User: melons)
Shuggie Otis - Strawberry Letter 23 (User: melons)
Arianna Vendittelli - Aure, voi più non siete, RV 652: II. Aria. Ti confido il pianto mio (User: melons)
Rocky Broadway Cast - Ain’t Down Yet (User: melons)
The Zombies - Care of Cell 44 (User: melons)
Elliott Smith - Pictures of Me (User: melons)
Wombo - Sour Sun (User: melons)
Paul Williams - Euroleague (User: melons)
Priests - JJ (User: melons)
Lutalo - Don't Mind Me (User: melons)
Samantha Crain - Oh Dear Louis (User: melons)
Sammy Virji - Poolside (feat. Katy Alex) (User: melons)
yunè pinku - Bluff - yeule & Kin Leonn Remix (User: melons)
Future Utopia - Never Gonna Get It (User: melons)
Clipz - No Time (feat. Nia Archives, Beenie Man, Cristale & ShaSimone) (User: melons)
Mura Masa - e-motions (with Erika de Casier) (User: melons)
VTSS - Make You Scream (User: melons)
